"","unitid","year","totcohortsize","w_cohortsize","m_cohortsize","tot4yrgrads","m_4yrgrads","w_4yrgrads","women_gradrate_4yr","womengradrate4yr","gradrate4yr","mengradrate4yr"
"1","100654",1991,1010,527,483,152,32,120,22.77,0.2277,0.15,0.066
"2","100663",1991,937,500,437,82,33,49,9.8,0.098,0.088,0.076
"3","100751",1991,2511,1348,1163,630,213,417,30.93,0.3093,0.251,0.183
"4","100858",1991,3024,1496,1528,846,312,534,35.7,0.357,0.28,0.204
"5","101435",1991,189,101,88,60,25,35,34.65,0.3465,0.317,0.284
"6","101480",1991,1100,567,533,109,42,67,11.82,0.1182,0.099,0.079
"7","101675",1991,365,144,221,73,41,32,22.22,0.2222,0.2,0.186
"8","101879",1991,755,387,368,66,23,43,11.11,0.1111,0.087,0.062
"9","102049",1991,569,337,232,217,89,128,37.98,0.3798,0.381,0.384
"10","102094",1991,1245,653,592,117,32,85,13.02,0.1302,0.094,0.054
"11","102234",1991,279,158,121,106,42,64,40.51,0.4051,0.38,0.347
"12","102368",1991,793,437,356,205,70,135,30.89,0.3089,0.259,0.197
"13","102377",1991,837,469,368,167,70,97,20.68,0.2068,0.2,0.19
"14","104151",1991,2447,1214,1233,442,174,268,22.08,0.2208,0.181,0.141
"15","104179",1991,3970,2063,1907,786,297,489,23.7,0.237,0.198,0.156
"16","105330",1991,1881,1064,817,294,97,197,18.52,0.1852,0.156,0.119
"17","106245",1991,941,536,405,45,14,31,5.78,0.0578,0.048,0.035
"18","106342",1991,121,79,42,48,17,31,39.24,0.3924,0.397,0.405
"19","106397",1991,2327,1080,1247,381,170,211,19.54,0.1954,0.164,0.136
"20","106412",1991,650,393,257,55,15,40,10.18,0.1018,0.085,0.058
"21","106458",1991,1521,833,688,147,44,103,12.36,0.1236,0.097,0.064
"22","106467",1991,761,403,358,103,32,71,17.62,0.1762,0.135,0.089
"23","106485",1991,478,256,222,33,13,20,7.81,0.0781,0.069,0.059
"24","106704",1991,1961,1129,832,171,46,125,11.07,0.1107,0.087,0.055
"25","107044",1991,673,383,290,192,65,127,33.16,0.3316,0.285,0.224
"26","107080",1991,281,146,135,141,67,74,50.68,0.5068,0.502,0.496
"27","107141",1991,219,123,96,65,29,36,29.27,0.2927,0.297,0.302
"28","107512",1991,338,182,156,115,44,71,39.01,0.3901,0.34,0.282
"29","107558",1991,90,52,38,9,4,5,9.62,0.0962,0.1,0.105
"30","110097",1991,391,256,135,155,45,110,42.97,0.4297,0.396,0.333
"31","110404",1991,225,73,152,146,99,47,64.38,0.6438,0.649,0.651
"32","110422",1991,1526,717,809,121,36,85,11.85,0.1185,0.079,0.044
"33","110486",1991,363,200,163,26,16,10,5,0.05,0.072,0.098
"34","110495",1991,273,164,109,39,8,31,18.9,0.189,0.143,0.073
"35","110510",1991,815,505,310,58,17,41,8.12,0.0812,0.071,0.055
"36","110529",1991,1583,650,933,96,28,68,10.46,0.1046,0.061,0.03
"37","110538",1991,1284,731,553,171,35,136,18.6,0.186,0.133,0.063
"38","110547",1991,337,227,110,9,2,7,3.08,0.0308,0.027,0.018
"39","110556",1991,1648,902,746,173,61,112,12.42,0.1242,0.105,0.082
"40","110565",1991,1847,1094,753,137,30,107,9.78,0.0978,0.074,0.04
"41","110574",1991,649,445,204,87,22,65,14.61,0.1461,0.134,0.108
"42","110583",1991,2142,1283,859,88,25,63,4.91,0.0491,0.041,0.029
"43","110592",1991,1491,938,553,41,9,32,3.41,0.0341,0.027,0.016
"44","110617",1991,1210,694,516,108,28,80,11.53,0.1153,0.089,0.054
"45","113698",1991,66,50,16,22,3,19,38,0.38,0.333,0.188
"46","115755",1991,862,468,394,61,19,42,8.97,0.0897,0.071,0.048
"47","119173",1991,190,190,0,32,0,32,16.84,0.1684,0.168,NA
"48","120184",1991,71,51,20,25,6,19,37.25,0.3725,0.352,0.3
"49","121309",1991,317,194,123,103,34,69,35.57,0.3557,0.325,0.276
"50","121345",1991,359,164,195,294,155,139,84.76,0.8476,0.819,0.795
"51","122409",1991,2479,1440,1039,151,39,112,7.78,0.0778,0.061,0.038
"52","122436",1991,882,528,354,471,181,290,54.92,0.5492,0.534,0.511
"53","122597",1991,1219,774,445,72,28,44,5.68,0.0568,0.059,0.063
"54","122612",1991,459,299,160,205,72,133,44.48,0.4448,0.447,0.45
"55","122931",1991,928,457,471,675,335,340,74.4,0.744,0.727,0.711
"56","123554",1991,437,241,196,247,101,146,60.58,0.6058,0.565,0.515
"57","123572",1991,680,429,251,95,18,77,17.95,0.1795,0.14,0.072
"58","126562",1991,262,152,110,25,7,18,11.84,0.1184,0.095,0.064
"59","126580",1991,319,183,136,36,12,24,13.11,0.1311,0.113,0.088
"60","126614",1991,3421,1631,1790,1268,550,718,44.02,0.4402,0.371,0.307
"61","126818",1991,2155,1144,1011,516,173,343,29.98,0.2998,0.239,0.171
"62","127060",1991,504,265,239,280,123,157,59.25,0.5925,0.556,0.515
"63","127185",1991,935,424,511,67,30,37,8.73,0.0873,0.072,0.059
"64","127565",1991,1357,669,688,35,12,23,3.44,0.0344,0.026,0.017
"65","127741",1991,1639,937,702,258,78,180,19.21,0.1921,0.157,0.111
"66","128106",1991,579,287,292,59,23,36,12.54,0.1254,0.102,0.079
"67","128744",1991,208,110,98,12,5,7,6.36,0.0636,0.058,0.051
"68","128771",1991,1088,627,461,115,34,81,12.92,0.1292,0.106,0.074
"69","129020",1991,2904,1464,1440,977,359,618,42.21,0.4221,0.336,0.249
"70","129242",1991,749,429,320,597,255,342,79.72,0.7972,0.797,0.797
"71","129941",1991,320,84,236,60,42,18,21.43,0.2143,0.188,0.178
"72","130253",1991,485,196,289,93,41,52,26.53,0.2653,0.192,0.142
"73","130314",1991,104,104,0,54,0,54,51.92,0.5192,0.519,NA
"74","130493",1991,1002,539,463,188,49,139,25.79,0.2579,0.188,0.106
"75","130590",1991,481,226,255,387,192,195,86.28,0.8628,0.805,0.753
"76","130697",1991,663,347,316,501,223,278,80.12,0.8012,0.756,0.706
"77","130776",1991,349,187,162,96,32,64,34.22,0.3422,0.275,0.198
"78","130794",1991,1290,592,698,1127,608,519,87.67,0.8767,0.874,0.871
"79","130934",1991,585,330,255,53,12,41,12.42,0.1242,0.091,0.047
"80","130943",1991,3170,1871,1299,1592,524,1068,57.08,0.5708,0.502,0.403
"81","131159",1991,1027,633,394,622,223,399,63.03,0.6303,0.606,0.566
"82","131283",1991,532,308,224,309,124,185,60.06,0.6006,0.581,0.554
"83","131450",1991,227,129,98,15,2,13,10.08,0.1008,0.066,0.02
"84","131469",1991,1151,622,529,686,282,404,64.95,0.6495,0.596,0.533
"85","131496",1991,1369,710,659,1133,547,586,82.54,0.8254,0.828,0.83
"86","131520",1991,1089,687,402,261,64,197,28.68,0.2868,0.24,0.159
"87","132471",1991,301,179,122,85,34,51,28.49,0.2849,0.282,0.279
"88","132602",1991,619,348,271,134,25,109,31.32,0.3132,0.216,0.092
"89","132903",1991,1577,813,764,332,89,243,29.89,0.2989,0.211,0.116
"90","133492",1991,336,187,149,186,80,106,56.68,0.5668,0.554,0.537
"91","133553",1991,875,134,741,190,158,32,23.88,0.2388,0.217,0.213
"92","133650",1991,1608,945,663,188,36,152,16.08,0.1608,0.117,0.054
"93","133669",1991,651,358,293,93,29,64,17.88,0.1788,0.143,0.099
"94","133711",1991,290,169,121,133,50,83,49.11,0.4911,0.459,0.413
"95","133881",1991,350,78,272,98,67,31,39.74,0.3974,0.28,0.246
"96","133951",1991,1021,600,421,198,62,136,22.67,0.2267,0.194,0.147
"97","134079",1991,378,210,168,147,53,94,44.76,0.4476,0.389,0.315
"98","134097",1991,2899,1702,1197,1131,410,721,42.36,0.4236,0.39,0.343
"99","134130",1991,4364,2116,2248,1284,490,794,37.52,0.3752,0.294,0.218
"100","134945",1991,388,147,241,102,56,46,31.29,0.3129,0.263,0.232
"101","135726",1991,1832,826,1006,775,383,392,47.46,0.4746,0.423,0.381
"102","136172",1991,406,240,166,71,24,47,19.58,0.1958,0.175,0.145
"103","136950",1991,401,227,174,233,92,141,62.11,0.6211,0.581,0.529
"104","137546",1991,460,256,204,237,89,148,57.81,0.5781,0.515,0.436
"105","138354",1991,380,215,165,40,16,24,11.16,0.1116,0.105,0.097
"106","138716",1991,541,292,249,39,7,32,10.96,0.1096,0.072,0.028
"107","138789",1991,567,340,227,50,14,36,10.59,0.1059,0.088,0.062
"108","139144",1991,429,253,176,220,85,135,53.36,0.5336,0.513,0.483
"109","139366",1991,509,312,197,30,9,21,6.73,0.0673,0.059,0.046
"110","139393",1991,136,73,63,56,21,35,47.95,0.4795,0.412,0.333
"111","139658",1991,1415,772,643,950,430,520,67.36,0.6736,0.671,0.669
"112","139719",1991,464,276,188,48,22,26,9.42,0.0942,0.103,0.117
"113","139755",1991,1750,415,1335,484,335,149,35.9,0.359,0.277,0.251
"114","139764",1991,322,190,132,70,35,35,18.42,0.1842,0.217,0.265
"115","139861",1991,770,476,294,126,35,91,19.12,0.1912,0.164,0.119
"116","139931",1991,2737,1457,1280,508,172,336,23.06,0.2306,0.186,0.134
"117","139940",1991,1007,598,409,103,34,69,11.54,0.1154,0.102,0.083
"118","139959",1991,3408,1927,1481,1191,429,762,39.54,0.3954,0.349,0.29
"119","140447",1991,670,347,323,230,100,130,37.46,0.3746,0.343,0.31
"120","140960",1991,737,394,343,75,28,47,11.93,0.1193,0.102,0.082
"121","140988",1991,139,96,43,59,18,41,42.71,0.4271,0.424,0.419
"122","141185",1991,218,113,105,51,25,26,23.01,0.2301,0.234,0.238
"123","141264",1991,994,614,380,225,78,147,23.94,0.2394,0.226,0.205
"124","141334",1991,1178,664,514,157,43,114,17.17,0.1717,0.133,0.084
"125","141486",1991,122,73,49,23,9,14,19.18,0.1918,0.189,0.184
"126","141565",1991,198,100,98,10,2,8,8,0.08,0.051,0.02
"127","141574",1991,1462,794,668,117,35,82,10.33,0.1033,0.08,0.052
"128","142276",1991,1091,569,522,47,14,33,5.8,0.058,0.043,0.027
"129","142285",1991,1273,524,749,140,72,68,12.98,0.1298,0.11,0.096
"130","142461",1991,237,129,108,51,17,34,26.36,0.2636,0.215,0.157
"131","143084",1991,526,296,230,337,145,192,64.86,0.6486,0.641,0.63
"132","143288",1991,116,44,72,23,6,17,38.64,0.3864,0.198,0.083
"133","144005",1991,614,414,200,7,3,4,0.97,0.0097,0.011,0.015
"134","144281",1991,846,439,407,21,8,13,2.96,0.0296,0.025,0.02
"135","144740",1991,1047,593,454,388,147,241,40.64,0.4064,0.371,0.324
"136","144892",1991,1493,911,582,577,185,392,43.03,0.4303,0.386,0.318
"137","144962",1991,247,130,117,99,38,61,46.92,0.4692,0.401,0.325
"138","144971",1991,129,70,59,54,21,33,47.14,0.4714,0.419,0.356
"139","145600",1991,2356,1233,1123,197,83,114,9.25,0.0925,0.084,0.074
"140","145619",1991,246,117,129,87,37,50,42.74,0.4274,0.354,0.287
"141","145637",1991,5649,2615,3034,2770,1300,1470,56.21,0.5621,0.49,0.428
"142","145691",1991,241,117,124,85,39,46,39.32,0.3932,0.353,0.315
"143","145813",1991,3055,1757,1298,849,286,563,32.04,0.3204,0.278,0.22
"144","146481",1991,234,124,110,123,53,70,56.45,0.5645,0.526,0.482
"145","146612",1991,387,166,221,122,59,63,37.95,0.3795,0.315,0.267
"146","146719",1991,922,593,329,347,119,228,38.45,0.3845,0.376,0.362
"147","146825",1991,185,89,96,83,28,55,61.8,0.618,0.449,0.292
"148","147013",1991,132,79,53,46,15,31,39.24,0.3924,0.348,0.283
"149","147244",1991,422,242,180,245,94,151,62.4,0.624,0.581,0.522
"150","147341",1991,252,117,135,113,48,65,55.56,0.5556,0.448,0.356
"151","147703",1991,3161,1646,1515,651,251,400,24.3,0.243,0.206,0.166
"152","147767",1991,1945,955,990,1601,782,819,85.76,0.8576,0.823,0.79
"153","147776",1991,724,447,277,17,5,12,2.68,0.0268,0.023,0.018
"154","147828",1991,376,209,167,140,42,98,46.89,0.4689,0.372,0.251
"155","148131",1991,296,153,143,105,44,61,39.87,0.3987,0.355,0.308
"156","148496",1991,152,124,28,58,11,47,37.9,0.379,0.382,0.393
"157","148584",1991,171,81,90,58,22,36,44.44,0.4444,0.339,0.244
"158","148627",1991,160,109,51,50,11,39,35.78,0.3578,0.312,0.216
"159","149222",1991,2376,1018,1358,302,139,163,16.01,0.1601,0.127,0.102
"160","149231",1991,948,539,409,107,30,77,14.29,0.1429,0.113,0.073
"161","149772",1991,1685,877,808,354,155,199,22.69,0.2269,0.21,0.192
"162","149781",1991,544,277,267,373,164,209,75.45,0.7545,0.686,0.614
"163","150066",1991,460,245,215,123,47,76,31.02,0.3102,0.267,0.219
"164","150136",1991,3447,1976,1471,1555,602,953,48.23,0.4823,0.451,0.409
"165","150145",1991,116,61,55,29,17,12,19.67,0.1967,0.25,0.309
"166","150163",1991,622,363,259,252,94,158,43.53,0.4353,0.405,0.363
"167","150400",1991,475,258,217,367,157,210,81.4,0.814,0.773,0.724
"168","150534",1991,694,403,291,281,101,180,44.67,0.4467,0.405,0.347
"169","150668",1991,194,106,88,83,30,53,50,0.5,0.428,0.341
"170","150941",1991,154,76,78,55,30,25,32.89,0.3289,0.357,0.385
"171","151102",1991,1134,607,527,34,17,17,2.8,0.028,0.03,0.032
"172","151111",1991,1536,862,674,54,24,30,3.48,0.0348,0.035,0.036
"173","151306",1991,1078,611,467,86,24,62,10.15,0.1015,0.08,0.051
"174","151324",1991,1919,969,950,276,114,162,16.72,0.1672,0.144,0.12
"175","151333",1991,315,199,116,8,1,7,3.52,0.0352,0.025,0.009
"176","151342",1991,554,352,202,40,15,25,7.1,0.071,0.072,0.074
"177","151351",1991,5208,3013,2195,2205,881,1324,43.94,0.4394,0.423,0.401
"178","151360",1991,614,396,218,35,14,21,5.3,0.053,0.057,0.064
"179","151379",1991,589,343,246,23,6,17,4.96,0.0496,0.039,0.024
"180","151388",1991,222,146,76,2,0,2,1.37,0.0137,0.009,0
"181","151777",1991,277,146,131,121,48,73,50,0.5,0.437,0.366
"182","151786",1991,217,154,63,53,13,40,25.97,0.2597,0.244,0.206
"183","152080",1991,1880,717,1163,1635,988,647,90.24,0.9024,0.87,0.85
"184","152248",1991,921,466,455,17,6,11,2.36,0.0236,0.018,0.013
"185","152363",1991,252,94,158,95,51,44,46.81,0.4681,0.377,0.323
"186","152530",1991,466,248,218,247,94,153,61.69,0.6169,0.53,0.431
"187","152600",1991,615,340,275,327,114,213,62.65,0.6265,0.532,0.415
"188","153001",1991,273,110,163,107,57,50,45.45,0.4545,0.392,0.35
"189","153108",1991,414,239,175,224,95,129,53.97,0.5397,0.541,0.543
"190","153269",1991,744,424,320,398,154,244,57.55,0.5755,0.535,0.481
"191","153384",1991,324,184,140,248,104,144,78.26,0.7826,0.765,0.743
"192","153603",1991,3228,1368,1860,665,281,384,28.07,0.2807,0.206,0.151
"193","153834",1991,578,349,229,368,134,234,67.05,0.6705,0.637,0.585
"194","154095",1991,1949,1181,768,470,151,319,27.01,0.2701,0.241,0.197
"195","155089",1991,165,99,66,44,12,32,32.32,0.3232,0.267,0.182
"196","155317",1991,3287,1755,1532,749,291,458,26.1,0.261,0.228,0.19
"197","155335",1991,82,61,21,15,3,12,19.67,0.1967,0.183,0.143
"198","155399",1991,2670,1322,1348,480,158,322,24.36,0.2436,0.18,0.117
"199","155520",1991,200,112,88,51,15,36,32.14,0.3214,0.255,0.17
"200","155627",1991,120,48,72,19,11,8,16.67,0.1667,0.158,0.153
"201","155937",1991,131,55,76,42,20,22,40,0.4,0.321,0.263
"202","156213",1991,250,144,106,78,31,47,32.64,0.3264,0.312,0.292
"203","156286",1991,267,157,110,122,42,80,50.96,0.5096,0.457,0.382
"204","156295",1991,436,246,190,147,58,89,36.18,0.3618,0.337,0.305
"205","156365",1991,255,122,133,29,6,23,18.85,0.1885,0.114,0.045
"206","156541",1991,460,240,220,77,29,48,20,0.2,0.167,0.132
"207","156745",1991,309,161,148,103,38,65,40.37,0.4037,0.333,0.257
"208","157058",1991,390,215,175,33,9,24,11.16,0.1116,0.085,0.051
"209","157076",1991,204,75,129,48,24,24,32,0.32,0.235,0.186
"210","157085",1991,2817,1434,1383,389,138,251,17.5,0.175,0.138,0.1
"211","157289",1991,2050,1007,1043,105,28,77,7.65,0.0765,0.051,0.027
"212","157386",1991,1261,674,587,99,32,67,9.94,0.0994,0.079,0.055
"213","157401",1991,1147,633,514,120,34,86,13.59,0.1359,0.105,0.066
"214","157447",1991,1282,698,584,42,14,28,4.01,0.0401,0.033,0.024
"215","157535",1991,181,134,47,25,6,19,14.18,0.1418,0.138,0.128
"216","157951",1991,2263,1267,996,259,77,182,14.36,0.1436,0.114,0.077
"217","158477",1991,207,124,83,87,29,58,46.77,0.4677,0.42,0.349
"218","159009",1991,1325,741,584,121,30,91,12.28,0.1228,0.091,0.051
"219","159391",1991,3342,1779,1563,579,201,378,21.25,0.2125,0.173,0.129
"220","159647",1991,1834,827,1007,278,108,170,20.56,0.2056,0.152,0.107
"221","159717",1991,1253,652,601,83,23,60,9.2,0.092,0.066,0.038
"222","159966",1991,1204,698,506,57,13,44,6.3,0.063,0.047,0.026
"223","160038",1991,1179,710,469,110,24,86,12.11,0.1211,0.093,0.051
"224","160612",1991,1898,1075,823,53,9,44,4.09,0.0409,0.028,0.011
"225","160621",1991,1907,985,922,59,10,49,4.97,0.0497,0.031,0.011
"226","160658",1991,2383,1300,1083,88,26,62,4.77,0.0477,0.037,0.024
"227","161004",1991,398,185,213,341,182,159,85.95,0.8595,0.857,0.854
"228","161226",1991,457,337,120,157,30,127,37.69,0.3769,0.344,0.25
"229","161235",1991,86,53,33,11,3,8,15.09,0.1509,0.128,0.091
"230","161244",1991,146,91,55,11,4,7,7.69,0.0769,0.075,0.073
"231","161253",1991,1589,710,879,324,140,184,25.92,0.2592,0.204,0.159
"232","161554",1991,763,419,344,68,23,45,10.74,0.1074,0.089,0.067
"233","162007",1991,310,189,121,37,7,30,15.87,0.1587,0.119,0.058
"234","162210",1991,78,45,33,19,6,13,28.89,0.2889,0.244,0.182
"235","162283",1991,311,195,116,29,6,23,11.79,0.1179,0.093,0.052
"236","162584",1991,762,381,381,187,67,120,31.5,0.315,0.245,0.176
"237","162654",1991,203,142,61,121,31,90,63.38,0.6338,0.596,0.508
"238","162760",1991,145,143,2,70,1,69,48.25,0.4825,0.483,0.5
"239","162928",1991,846,304,542,707,444,263,86.51,0.8651,0.836,0.819
"240","163046",1991,700,400,300,475,171,304,76,0.76,0.679,0.57
"241","163268",1991,910,467,443,185,71,114,24.41,0.2441,0.203,0.16
"242","163286",1991,3069,1406,1663,928,361,567,40.33,0.4033,0.302,0.217
"243","163453",1991,919,552,367,139,29,110,19.93,0.1993,0.151,0.079
"244","163462",1991,320,170,150,195,85,110,64.71,0.6471,0.609,0.567
"245","163851",1991,711,387,324,293,99,194,50.13,0.5013,0.412,0.306
"246","163912",1991,227,132,95,147,51,96,72.73,0.7273,0.648,0.537
"247","164076",1991,1237,735,502,335,78,257,34.97,0.3497,0.271,0.155
"248","164173",1991,269,233,36,44,6,38,16.31,0.1631,0.164,0.167
"249","164216",1991,182,99,83,105,40,65,65.66,0.6566,0.577,0.482
"250","164270",1991,278,132,146,160,71,89,67.42,0.6742,0.576,0.486
"251","164447",1991,250,110,140,84,43,41,37.27,0.3727,0.336,0.307
"252","164492",1991,116,87,29,54,9,45,51.72,0.5172,0.466,0.31
"253","164562",1991,447,286,161,298,110,188,65.73,0.6573,0.667,0.683
"254","165015",1991,745,392,353,546,247,299,76.28,0.7628,0.733,0.7
"255","165024",1991,982,568,414,265,67,198,34.86,0.3486,0.27,0.162
"256","165334",1991,561,307,254,344,137,207,67.43,0.6743,0.613,0.539
"257","165662",1991,399,269,130,217,89,128,47.58,0.4758,0.544,0.685
"258","165671",1991,138,138,0,51,0,51,36.96,0.3696,0.37,NA
"259","165820",1991,759,462,297,183,55,128,27.71,0.2771,0.241,0.185
"260","165866",1991,385,251,134,114,22,92,36.65,0.3665,0.296,0.164
"261","165936",1991,282,171,111,122,41,81,47.37,0.4737,0.433,0.369
"262","166027",1991,1601,669,932,1347,759,588,87.89,0.8789,0.841,0.814
"263","166124",1991,728,344,384,631,329,302,87.79,0.8779,0.867,0.857
"264","166513",1991,1075,386,689,276,146,130,33.68,0.3368,0.257,0.212
"265","166629",1991,3435,1665,1770,1271,511,760,45.65,0.4565,0.37,0.289
"266","166638",1991,529,270,259,68,27,41,15.19,0.1519,0.129,0.104
"267","166683",1991,1048,367,681,825,516,309,84.2,0.842,0.787,0.758
"268","167288",1991,423,211,212,81,26,55,26.07,0.2607,0.191,0.123
"269","167987",1991,989,515,474,285,109,176,34.17,0.3417,0.288,0.23
"270","167996",1991,518,279,239,359,160,199,71.33,0.7133,0.693,0.669
"271","168005",1991,421,214,207,137,55,82,38.32,0.3832,0.325,0.266
"272","168148",1991,1155,640,515,870,378,492,76.88,0.7688,0.753,0.734
"273","168254",1991,428,166,262,165,81,84,50.6,0.506,0.386,0.309
"274","168281",1991,319,210,109,222,62,160,76.19,0.7619,0.696,0.569
"275","168342",1991,517,246,271,467,238,229,93.09,0.9309,0.903,0.878
"276","168546",1991,548,266,282,349,179,170,63.91,0.6391,0.637,0.635
"277","168786",1991,231,134,97,65,26,39,29.1,0.291,0.281,0.268
"278","169080",1991,858,489,369,412,168,244,49.9,0.499,0.48,0.455
"279","169798",1991,2232,1255,977,176,65,111,8.84,0.0884,0.079,0.067
"280","169910",1991,2377,889,1488,90,47,43,4.84,0.0484,0.038,0.032
"281","170082",1991,1545,941,604,240,63,177,18.81,0.1881,0.155,0.104
"282","170301",1991,554,317,237,278,99,179,56.47,0.5647,0.502,0.418
"283","170532",1991,336,179,157,192,86,106,59.22,0.5922,0.571,0.548
"284","170639",1991,492,221,271,60,28,32,14.48,0.1448,0.122,0.103
"285","170976",1991,4908,2299,2609,2841,1363,1478,64.29,0.6429,0.579,0.522
"286","171100",1991,6314,3456,2858,1480,535,945,27.34,0.2734,0.234,0.187
"287","171128",1991,1283,319,964,234,145,89,27.9,0.279,0.182,0.15
"288","171137",1991,597,308,289,50,22,28,9.09,0.0909,0.084,0.076
"289","171146",1991,485,286,199,32,7,25,8.74,0.0874,0.066,0.035
"290","171599",1991,162,55,107,30,18,12,21.82,0.2182,0.185,0.168
"291","172051",1991,564,296,268,26,6,20,6.76,0.0676,0.046,0.022
"292","172699",1991,2778,1543,1235,432,162,270,17.5,0.175,0.156,0.131
"293","173160",1991,272,183,89,157,49,108,59.02,0.5902,0.577,0.551
"294","173258",1991,471,247,224,387,175,212,85.83,0.8583,0.822,0.781
"295","173328",1991,151,94,57,31,10,21,22.34,0.2234,0.205,0.175
"296","173647",1991,624,336,288,464,210,254,75.6,0.756,0.744,0.729
"297","173902",1991,403,206,197,284,126,158,76.7,0.767,0.705,0.64
"298","174066",1991,1979,917,1062,318,134,184,20.07,0.2007,0.161,0.126
"299","174233",1991,1091,567,524,196,69,127,22.4,0.224,0.18,0.132
"300","174251",1991,462,272,190,155,55,100,36.76,0.3676,0.335,0.289
"301","174491",1991,267,165,102,84,24,60,36.36,0.3636,0.315,0.235
"302","174792",1991,415,0,415,247,247,0,NA,NA,0.595,0.595
"303","174844",1991,733,391,342,534,246,288,73.66,0.7366,0.729,0.719
"304","174899",1991,276,206,70,114,28,86,41.75,0.4175,0.413,0.4
"305","174914",1991,854,457,397,393,174,219,47.92,0.4792,0.46,0.438
"306","175342",1991,899,520,379,108,25,83,15.96,0.1596,0.12,0.066
"307","175421",1991,43,27,16,5,2,3,11.11,0.1111,0.116,0.125
"308","175616",1991,445,283,162,111,33,78,27.56,0.2756,0.249,0.204
"309","175856",1991,1081,615,466,113,34,79,12.85,0.1285,0.105,0.073
"310","175980",1991,273,140,133,170,73,97,69.29,0.6929,0.623,0.549
"311","176017",1991,1690,892,798,484,169,315,35.31,0.3531,0.286,0.212
"312","176035",1991,339,282,57,99,10,89,31.56,0.3156,0.292,0.175
"313","176044",1991,386,223,163,34,7,27,12.11,0.1211,0.088,0.043
"314","176080",1991,1569,715,854,320,134,186,26.01,0.2601,0.204,0.157
"315","176406",1991,317,205,112,61,16,45,21.95,0.2195,0.192,0.143
"316","176628",1991,88,53,35,27,8,19,35.85,0.3585,0.307,0.229
"317","176947",1991,240,109,131,52,22,30,27.52,0.2752,0.217,0.168
"318","176965",1991,1952,1038,914,273,107,166,15.99,0.1599,0.14,0.117
"319","177418",1991,114,87,27,38,9,29,33.33,0.3333,0.333,0.333
"320","178059",1991,102,61,41,63,22,41,67.21,0.6721,0.618,0.537
"321","178341",1991,758,397,361,71,24,47,11.84,0.1184,0.094,0.066
"322","178387",1991,806,435,371,71,27,44,10.11,0.1011,0.088,0.073
"323","178396",1991,3368,1820,1548,959,356,603,33.13,0.3313,0.285,0.23
"324","178402",1991,494,270,224,55,26,29,10.74,0.1074,0.111,0.116
"325","178411",1991,711,135,576,58,43,15,11.11,0.1111,0.082,0.075
"326","178420",1991,637,341,296,72,28,44,12.9,0.129,0.113,0.095
"327","178615",1991,1375,784,591,459,153,306,39.03,0.3903,0.334,0.259
"328","179043",1991,228,142,86,121,44,77,54.23,0.5423,0.531,0.512
"329","179159",1991,914,479,435,355,121,234,48.85,0.4885,0.388,0.278
"330","179557",1991,1487,815,672,222,70,152,18.65,0.1865,0.149,0.104
"331","179566",1991,2895,1571,1324,676,241,435,27.69,0.2769,0.234,0.182
"332","179867",1991,1131,544,587,863,417,446,81.99,0.8199,0.763,0.71
"333","179894",1991,187,110,77,65,24,41,37.27,0.3727,0.348,0.312
"334","179946",1991,194,83,111,99,56,43,51.81,0.5181,0.51,0.505
"335","180179",1991,248,168,80,17,4,13,7.74,0.0774,0.069,0.05
"336","180461",1991,1445,652,793,156,60,96,14.72,0.1472,0.108,0.076
"337","180522",1991,188,86,102,27,18,9,10.47,0.1047,0.144,0.176
"338","180984",1991,204,117,87,58,17,41,35.04,0.3504,0.284,0.195
"339","181002",1991,750,445,305,430,170,260,58.43,0.5843,0.573,0.557
"340","181020",1991,230,116,114,117,42,75,64.66,0.6466,0.509,0.368
"341","181127",1991,255,111,144,102,55,47,42.34,0.4234,0.4,0.382
"342","181215",1991,1230,665,565,141,54,87,13.08,0.1308,0.115,0.096
"343","181394",1991,1275,635,640,70,31,39,6.14,0.0614,0.055,0.048
"344","181446",1991,343,192,151,170,72,98,51.04,0.5104,0.496,0.477
"345","181464",1991,3386,1641,1745,379,121,258,15.72,0.1572,0.112,0.069
"346","181534",1991,235,129,106,24,7,17,13.18,0.1318,0.102,0.066
"347","181783",1991,681,357,324,103,38,65,18.21,0.1821,0.151,0.117
"348","182281",1991,1172,604,568,125,47,78,12.91,0.1291,0.107,0.083
"349","182290",1991,966,482,484,101,43,58,12.03,0.1203,0.105,0.089
"350","182634",1991,215,137,78,99,29,70,51.09,0.5109,0.46,0.372
"351","182795",1991,429,192,237,124,57,67,34.9,0.349,0.289,0.241
"352","183062",1991,731,444,287,159,41,118,26.58,0.2658,0.218,0.143
"353","183080",1991,729,377,352,219,83,136,36.07,0.3607,0.3,0.236
"354","183239",1991,545,303,242,365,155,210,69.31,0.6931,0.67,0.64
"355","183822",1991,267,179,88,18,6,12,6.7,0.067,0.067,0.068
"356","183974",1991,89,66,23,22,3,19,28.79,0.2879,0.247,0.13
"357","184348",1991,269,166,103,188,70,118,71.08,0.7108,0.699,0.68
"358","184603",1991,908,436,472,78,32,46,10.55,0.1055,0.086,0.068
"359","184612",1991,93,79,14,9,3,6,7.59,0.0759,0.097,0.214
"360","184782",1991,892,511,381,212,77,135,26.42,0.2642,0.238,0.202
"361","185129",1991,618,322,296,34,17,17,5.28,0.0528,0.055,0.057
"362","185572",1991,387,216,171,74,23,51,23.61,0.2361,0.191,0.135
"363","185590",1991,913,564,349,101,31,70,12.41,0.1241,0.111,0.089
"364","185828",1991,541,96,445,30,18,12,12.5,0.125,0.055,0.04
"365","186131",1991,1122,474,648,1002,582,420,88.61,0.8861,0.893,0.898
"366","186201",1991,423,205,218,55,17,38,18.54,0.1854,0.13,0.078
"367","186283",1991,653,351,302,259,98,161,45.87,0.4587,0.397,0.325
"368","186584",1991,984,474,510,429,184,245,51.69,0.5169,0.436,0.361
"369","186876",1991,683,364,319,194,64,130,35.71,0.3571,0.284,0.201
"370","187134",1991,860,560,300,445,108,337,60.18,0.6018,0.517,0.36
"371","187444",1991,967,551,416,100,19,81,14.7,0.147,0.103,0.046
"372","187985",1991,1716,915,801,147,61,86,9.4,0.094,0.086,0.076
"373","188030",1991,1656,846,810,127,45,82,9.69,0.0969,0.077,0.056
"374","188429",1991,658,417,241,259,74,185,44.36,0.4436,0.394,0.307
"375","188641",1991,256,110,146,132,67,65,59.09,0.5909,0.516,0.459
"376","190044",1991,634,134,500,338,266,72,53.73,0.5373,0.533,0.532
"377","190099",1991,694,330,364,554,265,289,87.58,0.8758,0.798,0.728
"378","190150",1991,1085,464,621,851,481,370,79.74,0.7974,0.784,0.775
"379","190248",1991,85,43,42,29,10,19,44.19,0.4419,0.341,0.238
"380","190415",1991,2949,1345,1604,2336,1218,1118,83.12,0.8312,0.792,0.759
"381","190512",1991,1170,746,424,56,19,37,4.96,0.0496,0.048,0.045
"382","190549",1991,1475,843,632,135,42,93,11.03,0.1103,0.092,0.066
"383","190558",1991,1153,599,554,16,4,12,2,0.02,0.014,0.007
"384","190567",1991,1126,505,621,19,11,8,1.58,0.0158,0.017,0.018
"385","190594",1991,808,617,191,30,3,27,4.38,0.0438,0.037,0.016
"386","190637",1991,711,470,241,15,8,7,1.49,0.0149,0.021,0.033
"387","190664",1991,1603,889,714,165,49,116,13.05,0.1305,0.103,0.069
"388","190691",1991,431,276,155,22,10,12,4.35,0.0435,0.051,0.065
"389","190725",1991,244,164,80,40,14,26,15.85,0.1585,0.164,0.175
"390","191241",1991,952,507,445,641,292,349,68.84,0.6884,0.673,0.656
"391","191515",1991,462,207,255,384,204,180,86.96,0.8696,0.831,0.8
"392","191533",1991,370,217,153,201,74,127,58.53,0.5853,0.543,0.484
"393","191630",1991,503,211,292,334,174,160,75.83,0.7583,0.664,0.596
"394","191649",1991,1338,747,591,567,190,377,50.47,0.5047,0.424,0.321
"395","191676",1991,244,152,92,119,46,73,48.03,0.4803,0.488,0.5
"396","191931",1991,1046,526,520,290,122,168,31.94,0.3194,0.277,0.235
"397","191968",1991,1638,831,807,1036,477,559,67.27,0.6727,0.632,0.591
"398","192192",1991,139,112,27,65,15,50,44.64,0.4464,0.468,0.556
"399","192323",1991,404,212,192,261,118,143,67.45,0.6745,0.646,0.615
"400","192439",1991,665,436,229,30,12,18,4.13,0.0413,0.045,0.052
"401","192703",1991,548,258,290,298,137,161,62.4,0.624,0.544,0.472
"402","192749",1991,192,143,49,96,22,74,51.75,0.5175,0.5,0.449
"403","192819",1991,881,489,392,441,166,275,56.24,0.5624,0.501,0.423
"404","192925",1991,143,79,64,23,6,17,21.52,0.2152,0.161,0.094
"405","193016",1991,619,329,290,19,5,14,4.26,0.0426,0.031,0.017
"406","193292",1991,123,100,23,55,6,49,49,0.49,0.447,0.261
"407","193353",1991,248,188,60,96,16,80,42.55,0.4255,0.387,0.267
"408","193399",1991,188,147,41,91,20,71,48.3,0.483,0.484,0.488
"409","193584",1991,246,177,69,124,27,97,54.8,0.548,0.504,0.391
"410","193645",1991,645,563,82,93,2,91,16.16,0.1616,0.144,0.024
"411","193654",1991,265,182,83,81,25,56,30.77,0.3077,0.306,0.301
"412","193900",1991,2338,1279,1059,1173,508,665,51.99,0.5199,0.502,0.48
"413","193973",1991,447,272,175,176,53,123,45.22,0.4522,0.394,0.303
"414","194161",1991,108,77,31,26,4,22,28.57,0.2857,0.241,0.129
"415","194310",1991,510,290,220,178,56,122,42.07,0.4207,0.349,0.255
"416","194824",1991,971,193,778,428,334,94,48.7,0.487,0.441,0.429
"417","195003",1991,1265,370,895,287,162,125,33.78,0.3378,0.227,0.181
"418","195030",1991,1215,537,678,805,440,365,67.97,0.6797,0.663,0.649
"419","195164",1991,479,236,243,267,117,150,63.56,0.6356,0.557,0.481
"420","195173",1991,353,207,146,68,26,42,20.29,0.2029,0.193,0.178
"421","195216",1991,421,213,208,322,142,180,84.51,0.8451,0.765,0.683
"422","195234",1991,207,152,55,106,24,82,53.95,0.5395,0.512,0.436
"423","195243",1991,198,113,85,95,28,67,59.29,0.5929,0.48,0.329
"424","195304",1991,228,168,60,125,34,91,54.17,0.5417,0.548,0.567
"425","195474",1991,584,307,277,455,220,235,76.55,0.7655,0.779,0.794
"426","195526",1991,652,392,260,401,139,262,66.84,0.6684,0.615,0.535
"427","195544",1991,65,47,18,41,9,32,68.09,0.6809,0.631,0.5
"428","195809",1991,2483,1282,1201,612,253,359,28,0.28,0.246,0.211
"429","196413",1991,2513,1294,1219,1388,596,792,61.21,0.6121,0.552,0.489
"430","196592",1991,503,330,173,37,15,22,6.67,0.0667,0.074,0.087
"431","197045",1991,328,169,159,96,42,54,31.95,0.3195,0.293,0.264
"432","197133",1991,592,364,228,460,167,293,80.49,0.8049,0.777,0.732
"433","197869",1991,1916,1025,891,562,185,377,36.78,0.3678,0.293,0.208
"434","197984",1991,174,92,82,56,21,35,38.04,0.3804,0.322,0.256
"435","198385",1991,397,179,218,339,178,161,89.94,0.8994,0.854,0.817
"436","198464",1991,2338,1288,1050,386,124,262,20.34,0.2034,0.165,0.118
"437","198507",1991,402,217,185,135,48,87,40.09,0.4009,0.336,0.259
"438","198516",1991,780,461,319,381,121,260,56.4,0.564,0.488,0.379
"439","198835",1991,279,153,126,113,33,80,52.29,0.5229,0.405,0.262
"440","198969",1991,254,86,168,59,35,24,27.91,0.2791,0.232,0.208
"441","199102",1991,1469,803,666,275,63,212,26.4,0.264,0.187,0.095
"442","199111",1991,336,199,137,77,18,59,29.65,0.2965,0.229,0.131
"443","199120",1991,3133,1941,1192,1966,672,1294,66.67,0.6667,0.628,0.564
"444","199139",1991,1552,876,676,347,86,261,29.79,0.2979,0.224,0.127
"445","199148",1991,1345,890,455,358,82,276,31.01,0.3101,0.266,0.18
"446","199157",1991,531,336,195,93,21,72,21.43,0.2143,0.175,0.108
"447","199193",1991,3296,1290,2006,773,370,403,31.24,0.3124,0.235,0.184
"448","199218",1991,1545,923,622,385,111,274,29.69,0.2969,0.249,0.178
"449","199281",1991,379,195,184,58,21,37,18.97,0.1897,0.153,0.114
"450","199306",1991,166,82,84,45,17,28,34.15,0.3415,0.271,0.202
"451","199412",1991,144,102,42,47,9,38,37.25,0.3725,0.326,0.214
"452","199582",1991,418,237,181,44,10,34,14.35,0.1435,0.105,0.055
"453","199643",1991,579,330,249,190,82,108,32.73,0.3273,0.328,0.329
"454","199847",1991,857,425,432,659,299,360,84.71,0.8471,0.769,0.692
"455","199962",1991,371,181,190,93,28,65,35.91,0.3591,0.251,0.147
"456","199999",1991,431,287,144,59,7,52,18.12,0.1812,0.137,0.049
"457","200004",1991,1011,522,489,210,84,126,24.14,0.2414,0.208,0.172
"458","200059",1991,315,165,150,30,12,18,10.91,0.1091,0.095,0.08
"459","200156",1991,288,134,154,68,21,47,35.07,0.3507,0.236,0.136
"460","200217",1991,317,179,138,96,33,63,35.2,0.352,0.303,0.239
"461","200226",1991,162,83,79,21,3,18,21.69,0.2169,0.13,0.038
"462","200253",1991,546,363,183,52,14,38,10.47,0.1047,0.095,0.077
"463","200280",1991,1288,588,700,161,78,83,14.12,0.1412,0.125,0.111
"464","200332",1991,1192,491,701,134,58,76,15.48,0.1548,0.112,0.083
"465","200572",1991,186,100,86,21,2,19,19,0.19,0.113,0.023
"466","201104",1991,542,238,304,145,52,93,39.08,0.3908,0.268,0.171
"467","201371",1991,193,93,100,85,30,55,59.14,0.5914,0.44,0.3
"468","201548",1991,370,218,152,232,87,145,66.51,0.6651,0.627,0.572
"469","201645",1991,647,245,402,327,173,154,62.86,0.6286,0.505,0.43
"470","201690",1991,661,327,334,92,34,58,17.74,0.1774,0.139,0.102
"471","202134",1991,959,435,524,70,34,36,8.28,0.0828,0.073,0.065
"472","202480",1991,1499,744,755,758,322,436,58.6,0.586,0.506,0.426
"473","202523",1991,501,271,230,351,150,201,74.17,0.7417,0.701,0.652
"474","202763",1991,342,152,190,95,46,49,32.24,0.3224,0.278,0.242
"475","203085",1991,252,100,152,100,56,44,44,0.44,0.397,0.368
"476","203128",1991,287,148,139,159,69,90,60.81,0.6081,0.554,0.496
"477","203368",1991,765,386,379,465,212,253,65.54,0.6554,0.608,0.559
"478","203517",1991,2692,1609,1083,579,168,411,25.54,0.2554,0.215,0.155
"479","203535",1991,420,218,202,347,167,180,82.57,0.8257,0.826,0.827
"480","203580",1991,61,49,12,18,3,15,30.61,0.3061,0.295,0.25
"481","203775",1991,312,206,106,89,21,68,33.01,0.3301,0.285,0.198
"482","203845",1991,215,108,107,102,41,61,56.48,0.5648,0.474,0.383
"483","204024",1991,3241,1858,1383,2040,736,1304,70.18,0.7018,0.629,0.532
"484","204185",1991,417,194,223,189,80,109,56.19,0.5619,0.453,0.359
"485","204194",1991,231,145,86,82,31,51,35.17,0.3517,0.355,0.36
"486","204617",1991,205,108,97,54,24,30,27.78,0.2778,0.263,0.247
"487","204796",1991,5502,2705,2797,1061,375,686,25.36,0.2536,0.193,0.134
"488","204857",1991,3187,1819,1368,1308,448,860,47.28,0.4728,0.41,0.327
"489","206330",1991,188,66,122,16,9,7,10.61,0.1061,0.085,0.074
"490","206589",1991,466,219,247,290,135,155,70.78,0.7078,0.622,0.547
"491","206604",1991,2111,1061,1050,199,66,133,12.54,0.1254,0.094,0.063
"492","206622",1991,719,380,339,383,193,190,50,0.5,0.533,0.569
"493","206695",1991,1904,981,923,88,31,57,5.81,0.0581,0.046,0.034
"494","206914",1991,466,220,246,23,9,14,6.36,0.0636,0.049,0.037
"495","207209",1991,525,295,230,19,2,17,5.76,0.0576,0.036,0.009
"496","207306",1991,356,176,180,43,18,25,14.2,0.142,0.121,0.1
"497","207324",1991,304,160,144,76,37,39,24.38,0.2438,0.25,0.257
"498","207388",1991,2092,1038,1054,399,144,255,24.57,0.2457,0.191,0.137
"499","207500",1991,2249,1082,1167,277,101,176,16.27,0.1627,0.123,0.087
"500","207722",1991,203,143,60,16,2,14,9.79,0.0979,0.079,0.033
"501","207847",1991,537,291,246,55,21,34,11.68,0.1168,0.102,0.085
"502","207865",1991,867,502,365,70,24,46,9.16,0.0916,0.081,0.066
"503","208822",1991,258,154,104,91,33,58,37.66,0.3766,0.353,0.317
"504","209056",1991,357,213,144,191,72,119,55.87,0.5587,0.535,0.5
"505","209065",1991,429,242,187,234,89,145,59.92,0.5992,0.545,0.476
"506","209542",1991,1543,696,847,403,184,219,31.47,0.3147,0.261,0.217
"507","209551",1991,1919,1068,851,683,238,445,41.67,0.4167,0.356,0.28
"508","209612",1991,261,154,107,93,38,55,35.71,0.3571,0.356,0.355
"509","209807",1991,670,330,340,86,34,52,15.76,0.1576,0.128,0.1
"510","209922",1991,292,146,146,139,71,68,46.58,0.4658,0.476,0.486
"511","210146",1991,553,303,250,66,26,40,13.2,0.132,0.119,0.104
"512","210401",1991,390,221,169,253,99,154,69.68,0.6968,0.649,0.586
"513","210429",1991,576,367,209,98,22,76,20.71,0.2071,0.17,0.105
"514","210571",1991,236,120,116,143,58,85,70.83,0.7083,0.606,0.5
"515","210669",1991,606,289,317,354,173,181,62.63,0.6263,0.584,0.546
"516","210775",1991,194,128,66,56,16,40,31.25,0.3125,0.289,0.242
"517","211088",1991,140,110,30,92,13,79,71.82,0.7182,0.657,0.433
"518","211158",1991,1080,664,416,443,132,311,46.84,0.4684,0.41,0.317
"519","211291",1991,907,410,497,776,408,368,89.76,0.8976,0.856,0.821
"520","211352",1991,137,93,44,73,19,54,58.06,0.5806,0.533,0.432
"521","211361",1991,1107,565,542,141,48,93,16.46,0.1646,0.127,0.089
"522","211431",1991,144,138,6,59,2,57,41.3,0.413,0.41,0.333
"523","211440",1991,1170,335,835,657,464,193,57.61,0.5761,0.562,0.556
"524","211468",1991,120,120,0,62,0,62,51.67,0.5167,0.517,NA
"525","211556",1991,100,100,0,52,0,52,52,0.52,0.52,NA
"526","211583",1991,111,111,0,54,0,54,48.65,0.4865,0.486,NA
"527","211608",1991,324,139,185,33,14,19,13.67,0.1367,0.102,0.076
"528","211644",1991,973,584,389,232,64,168,28.77,0.2877,0.238,0.165
"529","211981",1991,332,140,192,98,43,55,39.29,0.3929,0.295,0.224
"530","212009",1991,557,317,240,433,184,249,78.55,0.7855,0.777,0.767
"531","212054",1991,1207,364,843,115,31,84,23.08,0.2308,0.095,0.037
"532","212106",1991,870,475,395,381,166,215,45.26,0.4526,0.438,0.42
"533","212115",1991,699,382,317,129,31,98,25.65,0.2565,0.185,0.098
"534","212133",1991,134,87,47,55,16,39,44.83,0.4483,0.41,0.34
"535","212160",1991,1456,853,603,243,65,178,20.87,0.2087,0.167,0.108
"536","212197",1991,455,309,146,265,78,187,60.52,0.6052,0.582,0.534
"537","212577",1991,504,228,276,355,173,182,79.82,0.7982,0.704,0.627
"538","212601",1991,465,264,201,186,79,107,40.53,0.4053,0.4,0.393
"539","212832",1991,89,79,10,25,1,24,30.38,0.3038,0.281,0.1
"540","212911",1991,295,147,148,256,124,132,89.8,0.898,0.868,0.838
"541","213020",1991,2516,1452,1064,604,180,424,29.2,0.292,0.24,0.169
"542","213251",1991,261,129,132,164,78,86,66.67,0.6667,0.628,0.591
"543","213321",1991,359,164,195,232,115,117,71.34,0.7134,0.646,0.59
"544","213349",1991,1427,813,614,295,59,236,29.03,0.2903,0.207,0.096
"545","213358",1991,120,76,44,34,10,24,31.58,0.3158,0.283,0.227
"546","213367",1991,594,293,301,331,152,179,61.09,0.6109,0.557,0.505
"547","213385",1991,519,243,276,426,212,214,88.07,0.8807,0.821,0.768
"548","213507",1991,180,77,103,98,50,48,62.34,0.6234,0.544,0.485
"549","213543",1991,1117,411,706,749,435,314,76.4,0.764,0.671,0.616
"550","213613",1991,737,447,290,187,52,135,30.2,0.302,0.254,0.179
"551","213668",1991,374,190,184,153,67,86,45.26,0.4526,0.409,0.364
"552","213783",1991,461,283,178,168,50,118,41.7,0.417,0.364,0.281
"553","213826",1991,281,237,44,95,12,83,35.02,0.3502,0.338,0.273
"554","213996",1991,560,343,217,361,136,225,65.6,0.656,0.645,0.627
"555","214041",1991,1089,672,417,429,127,302,44.94,0.4494,0.394,0.305
"556","214069",1991,246,187,59,86,23,63,33.69,0.3369,0.35,0.39
"557","214157",1991,288,143,145,192,92,100,69.93,0.6993,0.667,0.634
"558","214175",1991,463,258,205,336,140,196,75.97,0.7597,0.726,0.683
"559","214272",1991,84,58,26,30,5,25,43.1,0.431,0.357,0.192
"560","214777",1991,3615,1712,1903,2808,1417,1391,81.25,0.8125,0.777,0.745
"561","215062",1991,2286,986,1300,1791,981,810,82.15,0.8215,0.783,0.755
"562","215743",1991,279,144,135,97,38,59,40.97,0.4097,0.348,0.281
"563","215798",1991,228,118,110,129,51,78,66.1,0.661,0.566,0.464
"564","215929",1991,897,457,440,646,294,352,77.02,0.7702,0.72,0.668
"565","216010",1991,1163,631,532,474,153,321,50.87,0.5087,0.408,0.288
"566","216038",1991,1191,690,501,232,76,156,22.61,0.2261,0.195,0.152
"567","216287",1991,319,148,171,266,138,128,86.49,0.8649,0.834,0.807
"568","216339",1991,2084,1071,1013,287,115,172,16.06,0.1606,0.138,0.114
"569","216524",1991,234,124,110,155,69,86,69.35,0.6935,0.662,0.627
"570","216694",1991,317,185,132,112,33,79,42.7,0.427,0.353,0.25
"571","216764",1991,1467,960,507,337,79,258,26.88,0.2688,0.23,0.156
"572","216807",1991,319,175,144,223,99,124,70.86,0.7086,0.699,0.688
"573","216852",1991,464,206,258,172,81,91,44.17,0.4417,0.371,0.314
"574","216931",1991,395,170,225,154,71,83,48.82,0.4882,0.39,0.316
"575","217059",1991,697,396,301,265,88,177,44.7,0.447,0.38,0.292
"576","217156",1991,1358,658,700,1048,543,505,76.75,0.7675,0.772,0.776
"577","217402",1991,963,529,434,764,330,434,82.04,0.8204,0.793,0.76
"578","217536",1991,400,281,119,196,49,147,52.31,0.5231,0.49,0.412
"579","217776",1991,78,41,37,16,6,10,24.39,0.2439,0.205,0.162
"580","217819",1991,1434,943,491,483,104,379,40.19,0.4019,0.337,0.212
"581","217882",1991,2474,1120,1354,871,321,550,49.11,0.4911,0.352,0.237
"582","217998",1991,101,64,37,66,21,45,70.31,0.7031,0.653,0.568
"583","218061",1991,735,388,347,79,23,56,14.43,0.1443,0.107,0.066
"584","218229",1991,421,286,135,83,18,65,22.73,0.2273,0.197,0.133
"585","218238",1991,232,126,106,17,5,12,9.52,0.0952,0.073,0.047
"586","218399",1991,196,135,61,38,6,32,23.7,0.237,0.194,0.098
"587","218414",1991,189,77,112,45,21,24,31.17,0.3117,0.238,0.188
"588","218663",1991,2591,1398,1193,643,242,401,28.68,0.2868,0.248,0.203
"589","218724",1991,584,328,256,84,26,58,17.68,0.1768,0.144,0.102
"590","218733",1991,888,486,402,85,17,68,13.99,0.1399,0.096,0.042
"591","218742",1991,485,277,208,58,13,45,16.25,0.1625,0.12,0.062
"592","218973",1991,295,117,178,217,124,93,79.49,0.7949,0.736,0.697
"593","219000",1991,323,221,102,151,41,110,49.77,0.4977,0.467,0.402
"594","219046",1991,492,285,207,23,5,18,6.32,0.0632,0.047,0.024
"595","219082",1991,209,110,99,9,2,7,6.36,0.0636,0.043,0.02
"596","219198",1991,126,95,31,38,8,30,31.58,0.3158,0.302,0.258
"597","219259",1991,511,258,253,45,15,30,11.63,0.1163,0.088,0.059
"598","219356",1991,1306,657,649,189,77,112,17.05,0.1705,0.145,0.119
"599","219471",1991,1150,661,489,223,78,145,21.94,0.2194,0.194,0.16
"600","219602",1991,771,492,279,70,14,56,11.38,0.1138,0.091,0.05
"601","219709",1991,238,146,92,68,21,47,32.19,0.3219,0.286,0.228
"602","219718",1991,107,68,39,12,6,6,8.82,0.0882,0.112,0.154
"603","219949",1991,165,88,77,26,13,13,14.77,0.1477,0.158,0.169
"604","220075",1991,1599,950,649,149,47,102,10.74,0.1074,0.093,0.072
"605","220215",1991,295,147,148,80,38,42,28.57,0.2857,0.271,0.257
"606","220613",1991,368,185,183,62,24,38,20.54,0.2054,0.168,0.131
"607","220631",1991,311,209,102,126,40,86,41.15,0.4115,0.405,0.392
"608","220710",1991,154,80,74,50,16,34,42.5,0.425,0.325,0.216
"609","221351",1991,379,208,171,258,108,150,72.12,0.7212,0.681,0.632
"610","221519",1991,327,159,168,236,118,118,74.21,0.7421,0.722,0.702
"611","221731",1991,90,38,52,18,6,12,31.58,0.3158,0.2,0.115
"612","221847",1991,1362,637,725,185,57,128,20.09,0.2009,0.136,0.079
"613","221892",1991,193,113,80,46,23,23,20.35,0.2035,0.238,0.288
"614","222178",1991,656,338,318,176,75,101,29.88,0.2988,0.268,0.236
"615","222983",1991,307,173,134,187,77,110,63.58,0.6358,0.609,0.575
"616","223232",1991,2150,1240,910,947,347,600,48.39,0.4839,0.44,0.381
"617","224004",1991,116,72,44,26,7,19,26.39,0.2639,0.224,0.159
"618","224323",1991,280,163,117,138,50,88,53.99,0.5399,0.493,0.427
"619","225432",1991,570,299,271,10,6,4,1.34,0.0134,0.018,0.022
"620","225548",1991,266,125,141,42,14,28,22.4,0.224,0.158,0.099
"621","225627",1991,330,246,84,35,4,31,12.6,0.126,0.106,0.048
"622","226231",1991,207,26,181,51,44,7,26.92,0.2692,0.246,0.243
"623","226833",1991,708,332,376,14,8,6,1.81,0.0181,0.02,0.021
"624","227216",1991,2085,1169,916,210,62,148,12.66,0.1266,0.101,0.068
"625","227331",1991,361,278,83,38,6,32,11.51,0.1151,0.105,0.072
"626","227526",1991,1116,534,582,91,24,67,12.55,0.1255,0.082,0.041
"627","227757",1991,625,257,368,437,239,198,77.04,0.7704,0.699,0.649
"628","227845",1991,347,198,149,67,22,45,22.73,0.2273,0.193,0.148
"629","227863",1991,170,114,56,64,22,42,36.84,0.3684,0.376,0.393
"630","228042",1991,156,79,77,27,15,12,15.19,0.1519,0.173,0.195
"631","228149",1991,429,260,169,131,43,88,33.85,0.3385,0.305,0.254
"632","228246",1991,1229,652,577,671,289,382,58.59,0.5859,0.546,0.501
"633","228343",1991,324,173,151,191,89,102,58.96,0.5896,0.59,0.589
"634","228431",1991,2047,1234,813,353,74,279,22.61,0.2261,0.172,0.091
"635","228459",1991,2916,1634,1282,201,61,140,8.57,0.0857,0.069,0.048
"636","228501",1991,335,123,212,19,9,10,8.13,0.0813,0.057,0.042
"637","228529",1991,924,421,503,88,35,53,12.59,0.1259,0.095,0.07
"638","228705",1991,979,465,514,49,16,33,7.1,0.071,0.05,0.031
"639","228723",1991,6034,2816,3218,1454,510,944,33.52,0.3352,0.241,0.158
"640","228769",1991,1608,759,849,116,45,71,9.35,0.0935,0.072,0.053
"641","228778",1991,5850,2743,3107,1722,723,999,36.42,0.3642,0.294,0.233
"642","228787",1991,99,50,49,21,10,11,22,0.22,0.212,0.204
"643","228796",1991,1897,1005,892,45,16,29,2.89,0.0289,0.024,0.018
"644","228875",1991,1212,745,467,417,128,289,38.79,0.3879,0.344,0.274
"645","228981",1991,241,156,85,63,20,43,27.56,0.2756,0.261,0.235
"646","229018",1991,46,26,20,5,4,1,3.85,0.0385,0.109,0.2
"647","229027",1991,1479,799,680,69,27,42,5.26,0.0526,0.047,0.04
"648","229115",1991,2838,1439,1399,468,167,301,20.92,0.2092,0.165,0.119
"649","229780",1991,133,79,54,28,9,19,24.05,0.2405,0.211,0.167
"650","229814",1991,767,434,333,76,16,60,13.82,0.1382,0.099,0.048
"651","230603",1991,550,370,180,59,11,48,12.97,0.1297,0.107,0.061
"652","230728",1991,1359,857,502,1,1,0,0,0,0.001,0.002
"653","230764",1991,1924,914,1010,268,107,161,17.61,0.1761,0.139,0.106
"654","230782",1991,1403,810,593,100,32,68,8.4,0.084,0.071,0.054
"655","231059",1991,485,253,232,329,145,184,72.73,0.7273,0.678,0.625
"656","231174",1991,1821,929,892,884,385,499,53.71,0.5371,0.485,0.432
"657","231420",1991,106,67,39,7,2,5,7.46,0.0746,0.066,0.051
"658","231554",1991,126,61,65,35,15,20,32.79,0.3279,0.278,0.231
"659","231624",1991,1222,609,613,920,413,507,83.25,0.8325,0.753,0.674
"660","231712",1991,443,287,156,44,14,30,10.45,0.1045,0.099,0.09
"661","232025",1991,143,78,65,82,36,46,58.97,0.5897,0.573,0.554
"662","232043",1991,201,129,72,95,29,66,51.16,0.5116,0.473,0.403
"663","232089",1991,339,122,217,58,29,29,23.77,0.2377,0.171,0.134
"664","232186",1991,1678,927,751,348,106,242,26.11,0.2611,0.207,0.141
"665","232265",1991,1188,718,470,445,112,333,46.38,0.4638,0.375,0.238
"666","232423",1991,2121,1223,898,1105,381,724,59.2,0.592,0.521,0.424
"667","232557",1991,849,451,398,146,53,93,20.62,0.2062,0.172,0.133
"668","232566",1991,634,465,169,223,43,180,38.71,0.3871,0.352,0.254
"669","232609",1991,327,200,127,142,47,95,47.5,0.475,0.434,0.37
"670","232681",1991,712,496,216,458,123,335,67.54,0.6754,0.643,0.569
"671","232706",1991,211,159,52,81,21,60,37.74,0.3774,0.384,0.404
"672","232937",1991,1543,920,623,95,24,71,7.72,0.0772,0.062,0.039
"673","232982",1991,1363,685,678,161,48,113,16.5,0.165,0.118,0.071
"674","233277",1991,1857,1122,735,365,88,277,24.69,0.2469,0.197,0.12
"675","233374",1991,805,409,396,623,294,329,80.44,0.8044,0.774,0.742
"676","233426",1991,421,267,154,188,58,130,48.69,0.4869,0.447,0.377
"677","233541",1991,180,104,76,35,10,25,24.04,0.2404,0.194,0.132
"678","233897",1991,326,155,171,52,16,36,23.23,0.2323,0.16,0.094
"679","233921",1991,4407,1878,2529,1566,697,869,46.27,0.4627,0.355,0.276
"680","234030",1991,1318,799,519,216,65,151,18.9,0.189,0.164,0.125
"681","234085",1991,351,0,351,127,127,0,NA,NA,0.362,0.362
"682","234155",1991,1161,692,469,107,12,95,13.73,0.1373,0.092,0.026
"683","234164",1991,382,196,186,53,9,44,22.45,0.2245,0.139,0.048
"684","235097",1991,730,421,309,114,40,74,17.58,0.1758,0.156,0.129
"685","235167",1991,445,263,182,173,59,114,43.35,0.4335,0.389,0.324
"686","236230",1991,489,291,198,215,63,152,52.23,0.5223,0.44,0.318
"687","236328",1991,696,395,301,401,162,239,60.51,0.6051,0.576,0.538
"688","236577",1991,370,253,117,95,27,68,26.88,0.2688,0.257,0.231
"689","236595",1991,390,229,161,133,51,82,35.81,0.3581,0.341,0.317
"690","236896",1991,282,132,150,55,26,29,21.97,0.2197,0.195,0.173
"691","236939",1991,1852,982,870,470,171,299,30.45,0.3045,0.254,0.197
"692","236948",1991,3484,1788,1696,1287,482,805,45.02,0.4502,0.369,0.284
"693","237011",1991,1547,921,626,288,86,202,21.93,0.2193,0.186,0.137
"694","237057",1991,319,167,152,201,82,119,71.26,0.7126,0.63,0.539
"695","237066",1991,240,141,99,94,29,65,46.1,0.461,0.392,0.293
"696","237215",1991,305,163,142,9,2,7,4.29,0.0429,0.03,0.014
"697","237330",1991,401,229,172,87,32,55,24.02,0.2402,0.217,0.186
"698","237358",1991,141,80,61,13,4,9,11.25,0.1125,0.092,0.066
"699","237367",1991,1034,567,467,83,35,48,8.47,0.0847,0.08,0.075
"700","237792",1991,395,208,187,46,16,30,14.42,0.1442,0.116,0.086
"701","237899",1991,475,227,248,15,7,8,3.52,0.0352,0.032,0.028
"702","237932",1991,437,227,210,75,25,50,22.03,0.2203,0.172,0.119
"703","237969",1991,363,195,168,155,44,111,56.92,0.5692,0.427,0.262
"704","238032",1991,3307,1550,1757,796,325,471,30.39,0.3039,0.241,0.185
"705","238333",1991,261,147,114,135,50,85,57.82,0.5782,0.517,0.439
"706","238430",1991,125,89,36,24,7,17,19.1,0.191,0.192,0.194
"707","238458",1991,275,168,107,132,35,97,57.74,0.5774,0.48,0.327
"708","238476",1991,401,227,174,183,65,118,51.98,0.5198,0.456,0.374
"709","238616",1991,205,104,101,64,27,37,35.58,0.3558,0.312,0.267
"710","238661",1991,126,96,30,17,1,16,16.67,0.1667,0.135,0.033
"711","239080",1991,146,105,41,52,10,42,40,0.4,0.356,0.244
"712","239105",1991,1598,852,746,870,349,521,61.15,0.6115,0.544,0.468
"713","239628",1991,164,84,80,86,35,51,60.71,0.6071,0.524,0.438
"714","239716",1991,442,262,180,288,95,193,73.66,0.7366,0.652,0.528
"715","240107",1991,201,145,56,63,14,49,33.79,0.3379,0.313,0.25
"716","240189",1991,1765,990,775,200,60,140,14.14,0.1414,0.113,0.077
"717","240277",1991,775,506,269,75,21,54,10.67,0.1067,0.097,0.078
"718","240329",1991,1648,959,689,159,57,102,10.64,0.1064,0.096,0.083
"719","240338",1991,71,45,26,20,8,12,26.67,0.2667,0.282,0.308
"720","240365",1991,1411,787,624,136,31,105,13.34,0.1334,0.096,0.05
"721","240374",1991,627,333,294,29,11,18,5.41,0.0541,0.046,0.037
"722","240417",1991,1158,606,552,77,19,58,9.57,0.0957,0.066,0.034
"723","240426",1991,443,220,223,24,10,14,6.36,0.0636,0.054,0.045
"724","240444",1991,4582,2387,2195,1516,589,927,38.84,0.3884,0.331,0.268
"725","240453",1991,1392,730,662,145,53,92,12.6,0.126,0.104,0.08
"726","240462",1991,986,339,647,110,56,54,15.93,0.1593,0.112,0.087
"727","240471",1991,1022,557,465,122,48,74,13.29,0.1329,0.119,0.103
"728","240480",1991,1494,763,731,183,62,121,15.86,0.1586,0.122,0.085
"729","240727",1991,1257,534,723,174,73,101,18.91,0.1891,0.138,0.101
"730","243443",1991,518,370,148,1,0,1,0.27,0.0027,0.002,0
"731","243780",1991,5754,2516,3238,1682,790,892,35.45,0.3545,0.292,0.244
"732","100654",1992,876,444,432,157,46,111,25,0.25,0.179,0.106
"733","100663",1992,898,479,419,54,19,35,7.31,0.0731,0.06,0.045
"734","100751",1992,2436,1310,1126,684,240,444,33.89,0.3389,0.281,0.213
"735","100858",1992,3141,1621,1520,927,295,632,38.99,0.3899,0.295,0.194
"736","101435",1992,166,91,75,53,14,39,42.86,0.4286,0.319,0.187
"737","101480",1992,1106,615,491,116,34,82,13.33,0.1333,0.105,0.069
"738","101675",1992,226,108,118,107,52,55,50.93,0.5093,0.473,0.441
"739","101879",1992,554,321,233,74,24,50,15.58,0.1558,0.134,0.103
"740","102049",1992,662,405,257,295,108,187,46.17,0.4617,0.446,0.42
"741","102094",1992,1170,668,502,123,38,85,12.72,0.1272,0.105,0.076
"742","102234",1992,295,167,128,144,58,86,51.5,0.515,0.488,0.453
"743","102368",1992,935,460,475,217,73,144,31.3,0.313,0.232,0.154
"744","102377",1992,612,311,301,123,36,87,27.97,0.2797,0.201,0.12
"745","104151",1992,2901,1503,1398,452,162,290,19.29,0.1929,0.156,0.116
"746","104179",1992,3803,1926,1877,814,302,512,26.58,0.2658,0.214,0.161
"747","105330",1992,2095,1203,892,315,104,211,17.54,0.1754,0.15,0.117
"748","106245",1992,1092,600,492,61,23,38,6.33,0.0633,0.056,0.047
"749","106342",1992,138,80,58,51,21,30,37.5,0.375,0.37,0.362
"750","106397",1992,2327,1066,1261,394,165,229,21.48,0.2148,0.169,0.131
"751","106412",1992,592,341,251,27,9,18,5.28,0.0528,0.046,0.036
"752","106458",1992,1607,855,752,164,48,116,13.57,0.1357,0.102,0.064
"753","106467",1992,812,438,374,112,33,79,18.04,0.1804,0.138,0.088
"754","106485",1992,581,302,279,53,15,38,12.58,0.1258,0.091,0.054
"755","106704",1992,1948,1150,798,352,116,236,20.52,0.2052,0.181,0.145
"756","107044",1992,818,434,384,238,91,147,33.87,0.3387,0.291,0.237
"757","107080",1992,335,183,152,174,76,98,53.55,0.5355,0.519,0.5
"758","107141",1992,196,109,87,70,31,39,35.78,0.3578,0.357,0.356
"759","107512",1992,296,148,148,121,36,85,57.43,0.5743,0.409,0.243
"760","107558",1992,120,53,67,11,7,4,7.55,0.0755,0.092,0.104
"761","110097",1992,464,290,174,176,64,112,38.62,0.3862,0.379,0.368
"762","110404",1992,233,60,173,165,119,46,76.67,0.7667,0.708,0.688
"763","110422",1992,1295,566,729,136,37,99,17.49,0.1749,0.105,0.051
"764","110486",1992,323,181,142,32,11,21,11.6,0.116,0.099,0.077
"765","110495",1992,307,191,116,33,11,22,11.52,0.1152,0.107,0.095
"766","110510",1992,737,449,288,59,23,36,8.02,0.0802,0.08,0.08
"767","110529",1992,1358,551,807,84,34,50,9.07,0.0907,0.062,0.042
"768","110538",1992,1325,758,567,148,34,114,15.04,0.1504,0.112,0.06
"769","110547",1992,485,336,149,16,6,10,2.98,0.0298,0.033,0.04
"770","110556",1992,1559,860,699,165,52,113,13.14,0.1314,0.106,0.074
"771","110565",1992,1589,926,663,108,27,81,8.75,0.0875,0.068,0.041
"772","110574",1992,572,394,178,76,17,59,14.97,0.1497,0.133,0.096
"773","110583",1992,1565,961,604,79,27,52,5.41,0.0541,0.05,0.045
"774","110592",1992,1206,738,468,45,16,29,3.93,0.0393,0.037,0.034
"775","110617",1992,922,513,409,71,20,51,9.94,0.0994,0.077,0.049
"776","113698",1992,65,45,20,24,8,16,35.56,0.3556,0.369,0.4
"777","115755",1992,779,421,358,45,16,29,6.89,0.0689,0.058,0.045
"778","119173",1992,217,217,0,64,0,64,29.49,0.2949,0.295,NA
"779","120184",1992,85,54,31,34,14,20,37.04,0.3704,0.4,0.452
"780","121309",1992,374,248,126,94,27,67,27.02,0.2702,0.251,0.214
"781","121345",1992,382,192,190,316,148,168,87.5,0.875,0.827,0.779
"782","122409",1992,1974,1129,845,154,45,109,9.65,0.0965,0.078,0.053
"783","122436",1992,929,524,405,462,175,287,54.77,0.5477,0.497,0.432
"784","122597",1992,1125,693,432,73,19,54,7.79,0.0779,0.065,0.044
"785","122612",1992,492,319,173,233,75,158,49.53,0.4953,0.474,0.434
"786","122931",1992,900,458,442,661,303,358,78.17,0.7817,0.734,0.686
"787","123554",1992,472,257,215,289,126,163,63.42,0.6342,0.612,0.586
"788","123572",1992,591,380,211,97,20,77,20.26,0.2026,0.164,0.095
"789","126562",1992,272,175,97,29,6,23,13.14,0.1314,0.107,0.062
"790","126580",1992,313,174,139,29,9,20,11.49,0.1149,0.093,0.065
"791","126614",1992,3559,1700,1859,1198,514,684,40.24,0.4024,0.337,0.276
"792","126818",1992,2202,1150,1052,575,205,370,32.17,0.3217,0.261,0.195
"793","127060",1992,555,284,271,303,130,173,60.92,0.6092,0.546,0.48
"794","127185",1992,1004,439,565,118,49,69,15.72,0.1572,0.118,0.087
"795","127565",1992,1227,614,613,49,17,32,5.21,0.0521,0.04,0.028
"796","127741",1992,1464,921,543,232,63,169,18.35,0.1835,0.158,0.116
"797","128106",1992,656,342,314,58,21,37,10.82,0.1082,0.088,0.067
"798","128744",1992,18,12,6,1,0,1,8.33,0.0833,0.056,0
"799","128771",1992,964,552,412,98,31,67,12.14,0.1214,0.102,0.075
"800","129020",1992,2831,1454,1377,968,354,614,42.23,0.4223,0.342,0.257
"801","129242",1992,861,506,355,672,277,395,78.06,0.7806,0.78,0.78
"802","129941",1992,302,74,228,42,30,12,16.22,0.1622,0.139,0.132
"803","130253",1992,491,240,251,114,52,62,25.83,0.2583,0.232,0.207
"804","130314",1992,105,105,0,42,0,42,40,0.4,0.4,NA
"805","130493",1992,933,493,440,134,35,99,20.08,0.2008,0.144,0.08
"806","130590",1992,472,240,232,352,161,191,79.58,0.7958,0.746,0.694
"807","130697",1992,704,361,343,553,263,290,80.33,0.8033,0.786,0.767
"808","130776",1992,372,161,211,88,47,41,25.47,0.2547,0.237,0.223
"809","130794",1992,1326,640,686,1139,561,578,90.31,0.9031,0.859,0.818
"810","130934",1992,579,305,274,47,22,25,8.2,0.082,0.081,0.08
"811","130943",1992,2944,1729,1215,1593,590,1003,58.01,0.5801,0.541,0.486
"812","131159",1992,1025,629,396,629,235,394,62.64,0.6264,0.614,0.593
"813","131283",1992,471,252,219,272,121,151,59.92,0.5992,0.577,0.553
"814","131450",1992,339,177,162,15,6,9,5.08,0.0508,0.044,0.037
"815","131469",1992,1193,642,551,695,291,404,62.93,0.6293,0.583,0.528
"816","131496",1992,1383,733,650,1179,550,629,85.81,0.8581,0.852,0.846
"817","131520",1992,1264,797,467,264,70,194,24.34,0.2434,0.209,0.15
"818","132471",1992,265,146,119,80,28,52,35.62,0.3562,0.302,0.235
"819","132602",1992,597,326,271,99,29,70,21.47,0.2147,0.166,0.107
"820","132903",1992,1405,745,660,330,92,238,31.95,0.3195,0.235,0.139
"821","133492",1992,348,182,166,187,92,95,52.2,0.522,0.537,0.554
"822","133553",1992,801,132,669,190,149,41,31.06,0.3106,0.237,0.223
"823","133650",1992,1383,815,568,206,60,146,17.91,0.1791,0.149,0.106
"824","133669",1992,795,417,378,115,43,72,17.27,0.1727,0.145,0.114
"825","133711",1992,299,169,130,125,43,82,48.52,0.4852,0.418,0.331
"826","133881",1992,457,121,336,147,99,48,39.67,0.3967,0.322,0.295
"827","133951",1992,1124,625,499,197,64,133,21.28,0.2128,0.175,0.128
"828","134079",1992,343,200,143,147,45,102,51,0.51,0.429,0.315
"829","134097",1992,3313,1949,1364,1259,378,881,45.2,0.452,0.38,0.277
"830","134130",1992,4471,2097,2374,1377,568,809,38.58,0.3858,0.308,0.239
"831","134945",1992,304,128,176,81,33,48,37.5,0.375,0.266,0.188
"832","135726",1992,1770,841,929,798,395,403,47.92,0.4792,0.451,0.425
"833","136172",1992,487,277,210,68,27,41,14.8,0.148,0.14,0.129
"834","136950",1992,394,215,179,194,71,123,57.21,0.5721,0.492,0.397
"835","137546",1992,501,282,219,232,87,145,51.42,0.5142,0.463,0.397
"836","138354",1992,396,208,188,70,28,42,20.19,0.2019,0.177,0.149
"837","138716",1992,645,364,281,50,14,36,9.89,0.0989,0.078,0.05
"838","138789",1992,496,292,204,25,10,15,5.14,0.0514,0.05,0.049
"839","139144",1992,425,286,139,191,64,127,44.41,0.4441,0.449,0.46
"840","139366",1992,589,365,224,42,14,28,7.67,0.0767,0.071,0.062
"841","139393",1992,155,98,57,56,18,38,38.78,0.3878,0.361,0.316
"842","139658",1992,1478,872,606,1010,406,604,69.27,0.6927,0.683,0.67
"843","139719",1992,497,264,233,52,18,34,12.88,0.1288,0.105,0.077
"844","139755",1992,1691,467,1224,472,298,174,37.26,0.3726,0.279,0.243
"845","139764",1992,375,243,132,75,28,47,19.34,0.1934,0.2,0.212
"846","139861",1992,754,451,303,112,23,89,19.73,0.1973,0.149,0.076
"847","139931",1992,2828,1530,1298,506,174,332,21.7,0.217,0.179,0.134
"848","139940",1992,998,574,424,96,36,60,10.45,0.1045,0.096,0.085
"849","139959",1992,3147,1823,1324,1456,521,935,51.29,0.5129,0.463,0.394
"850","140447",1992,579,349,230,158,45,113,32.38,0.3238,0.273,0.196
"851","140960",1992,636,346,290,50,15,35,10.12,0.1012,0.079,0.052
"852","140988",1992,175,118,57,65,20,45,38.14,0.3814,0.371,0.351
"853","141185",1992,201,114,87,53,19,34,29.82,0.2982,0.264,0.218
"854","141264",1992,1057,608,449,146,43,103,16.94,0.1694,0.138,0.096
"855","141334",1992,1182,657,525,141,39,102,15.53,0.1553,0.119,0.074
"856","141486",1992,127,73,54,23,8,15,20.55,0.2055,0.181,0.148
"857","141565",1992,286,173,113,23,10,13,7.51,0.0751,0.08,0.088
"858","141574",1992,1485,823,662,158,46,112,13.61,0.1361,0.106,0.069
"859","142276",1992,1091,556,535,66,22,44,7.91,0.0791,0.06,0.041
"860","142285",1992,1290,574,716,173,77,96,16.72,0.1672,0.134,0.108
"861","142461",1992,284,162,122,82,31,51,31.48,0.3148,0.289,0.254
"862","143084",1992,538,309,229,318,119,199,64.4,0.644,0.591,0.52
"863","143288",1992,148,74,74,52,17,35,47.3,0.473,0.351,0.23
"864","144005",1992,576,351,225,3,2,1,0.28,0.0028,0.005,0.009
"865","144281",1992,760,373,387,90,42,48,12.87,0.1287,0.118,0.109
"866","144740",1992,927,520,407,350,119,231,44.42,0.4442,0.378,0.292
"867","144892",1992,1463,893,570,464,132,332,37.18,0.3718,0.317,0.232
"868","144962",1992,229,128,101,92,29,63,49.22,0.4922,0.402,0.287
"869","144971",1992,119,60,59,53,22,31,51.67,0.5167,0.445,0.373
"870","145600",1992,2475,1273,1202,240,95,145,11.39,0.1139,0.097,0.079
"871","145619",1992,230,110,120,102,43,59,53.64,0.5364,0.443,0.358
"872","145637",1992,5491,2566,2925,2656,1267,1389,54.13,0.5413,0.484,0.433
"873","145691",1992,260,136,124,114,35,79,58.09,0.5809,0.438,0.282
"874","145813",1992,2898,1706,1192,772,229,543,31.83,0.3183,0.266,0.192
"875","146481",1992,235,123,112,145,66,79,64.23,0.6423,0.617,0.589
"876","146612",1992,345,161,184,84,34,50,31.06,0.3106,0.243,0.185
"877","146719",1992,985,587,398,377,143,234,39.86,0.3986,0.383,0.359
"878","146825",1992,171,84,87,67,23,44,52.38,0.5238,0.392,0.264
"879","147013",1992,134,82,52,53,19,34,41.46,0.4146,0.396,0.365
"880","147244",1992,516,302,214,289,102,187,61.92,0.6192,0.56,0.477
"881","147341",1992,125,67,58,61,23,38,56.72,0.5672,0.488,0.397
"882","147703",1992,2742,1537,1205,607,211,396,25.76,0.2576,0.221,0.175
"883","147767",1992,1889,948,941,1533,719,814,85.86,0.8586,0.812,0.764
"884","147776",1992,688,408,280,21,6,15,3.68,0.0368,0.031,0.021
"885","147828",1992,388,202,186,129,48,81,40.1,0.401,0.332,0.258
"886","148131",1992,313,148,165,80,24,56,37.84,0.3784,0.256,0.145
"887","148496",1992,142,117,25,67,9,58,49.57,0.4957,0.472,0.36
"888","148584",1992,144,67,77,52,23,29,43.28,0.4328,0.361,0.299
"889","148627",1992,192,134,58,55,11,44,32.84,0.3284,0.286,0.19
"890","149222",1992,2756,1203,1553,442,195,247,20.53,0.2053,0.16,0.126
"891","149231",1992,965,558,407,100,32,68,12.19,0.1219,0.104,0.079
"892","149772",1992,1566,763,803,315,137,178,23.33,0.2333,0.201,0.171
"893","149781",1992,548,294,254,392,172,220,74.83,0.7483,0.715,0.677
"894","150066",1992,507,297,210,162,53,109,36.7,0.367,0.32,0.252
"895","150136",1992,3265,1841,1424,699,236,463,25.15,0.2515,0.214,0.166
"896","150145",1992,152,88,64,48,16,32,36.36,0.3636,0.316,0.25
"897","150163",1992,666,383,283,257,98,159,41.51,0.4151,0.386,0.346
"898","150400",1992,566,326,240,410,169,241,73.93,0.7393,0.724,0.704
"899","150534",1992,754,435,319,322,117,205,47.13,0.4713,0.427,0.367
"900","150668",1992,201,104,97,73,37,36,34.62,0.3462,0.363,0.381
"901","150941",1992,150,92,58,75,24,51,55.43,0.5543,0.5,0.414
"902","151102",1992,1126,612,514,39,14,25,4.08,0.0408,0.035,0.027
"903","151111",1992,1507,837,670,42,18,24,2.87,0.0287,0.028,0.027
"904","151306",1992,1080,624,456,90,27,63,10.1,0.101,0.083,0.059
"905","151324",1992,2187,1161,1026,339,124,215,18.52,0.1852,0.155,0.121
"906","151333",1992,304,200,104,15,4,11,5.5,0.055,0.049,0.038
"907","151342",1992,564,337,227,34,11,23,6.82,0.0682,0.06,0.048
"908","151351",1992,5529,3233,2296,2231,840,1391,43.03,0.4303,0.404,0.366
"909","151360",1992,597,386,211,26,9,17,4.4,0.044,0.044,0.043
"910","151379",1992,638,381,257,27,6,21,5.51,0.0551,0.042,0.023
"911","151388",1992,263,197,66,8,2,6,3.05,0.0305,0.03,0.03
"912","151777",1992,245,120,125,109,51,58,48.33,0.4833,0.445,0.408
"913","151786",1992,244,149,95,75,32,43,28.86,0.2886,0.307,0.337
"914","152080",1992,1879,822,1057,1631,900,731,88.93,0.8893,0.868,0.851
"915","152248",1992,985,535,450,22,8,14,2.62,0.0262,0.022,0.018
"916","152363",1992,258,129,129,94,40,54,41.86,0.4186,0.364,0.31
"917","152530",1992,491,256,235,324,153,171,66.8,0.668,0.66,0.651
"918","152600",1992,601,334,267,305,117,188,56.29,0.5629,0.507,0.438
"919","153001",1992,290,132,158,129,56,73,55.3,0.553,0.445,0.354
"920","153108",1992,428,235,193,242,98,144,61.28,0.6128,0.565,0.508
"921","153269",1992,838,476,362,407,150,257,53.99,0.5399,0.486,0.414
"922","153384",1992,295,168,127,234,101,133,79.17,0.7917,0.793,0.795
"923","153603",1992,3333,1432,1901,723,309,414,28.91,0.2891,0.217,0.163
"924","153834",1992,579,357,222,389,144,245,68.63,0.6863,0.672,0.649
"925","154095",1992,1659,984,675,435,143,292,29.67,0.2967,0.262,0.212
"926","155089",1992,150,101,49,31,6,25,24.75,0.2475,0.207,0.122
"927","155317",1992,3495,1778,1717,814,304,510,28.68,0.2868,0.233,0.177
"928","155335",1992,83,57,26,28,8,20,35.09,0.3509,0.337,0.308
"929","155399",1992,2778,1357,1421,484,189,295,21.74,0.2174,0.174,0.133
"930","155520",1992,217,107,110,42,16,26,24.3,0.243,0.194,0.145
"931","155627",1992,119,43,76,24,9,15,34.88,0.3488,0.202,0.118
"932","155937",1992,118,52,66,33,9,24,46.15,0.4615,0.28,0.136
"933","156213",1992,268,165,103,95,38,57,34.55,0.3455,0.354,0.369
"934","156286",1992,283,155,128,98,40,58,37.42,0.3742,0.346,0.312
"935","156295",1992,397,206,191,148,66,82,39.81,0.3981,0.373,0.346
"936","156365",1992,208,85,123,27,9,18,21.18,0.2118,0.13,0.073
"937","156541",1992,332,185,147,97,36,61,32.97,0.3297,0.292,0.245
"938","156745",1992,325,174,151,109,37,72,41.38,0.4138,0.335,0.245
"939","157058",1992,393,226,167,16,4,12,5.31,0.0531,0.041,0.024
"940","157076",1992,147,71,76,41,13,28,39.44,0.3944,0.279,0.171
"941","157085",1992,2562,1374,1188,528,195,333,24.24,0.2424,0.206,0.164
"942","157289",1992,1745,843,902,133,45,88,10.44,0.1044,0.076,0.05
"943","157386",1992,1349,769,580,133,39,94,12.22,0.1222,0.099,0.067
"944","157401",1992,982,538,444,223,76,147,27.32,0.2732,0.227,0.171
"945","157447",1992,1359,714,645,49,12,37,5.18,0.0518,0.036,0.019
"946","157535",1992,198,139,59,17,8,9,6.47,0.0647,0.086,0.136
"947","157951",1992,2192,1261,931,271,80,191,15.15,0.1515,0.124,0.086
"948","158477",1992,249,146,103,84,38,46,31.51,0.3151,0.337,0.369
"949","159009",1992,1385,775,610,109,30,79,10.19,0.1019,0.079,0.049
"950","159391",1992,3503,1884,1619,651,219,432,22.93,0.2293,0.186,0.135
"951","159647",1992,1473,703,770,264,86,178,25.32,0.2532,0.179,0.112
"952","159717",1992,1272,705,567,64,16,48,6.81,0.0681,0.05,0.028
"953","159966",1992,1059,613,446,53,10,43,7.01,0.0701,0.05,0.022
"954","160038",1992,1227,737,490,108,30,78,10.58,0.1058,0.088,0.061
"955","160612",1992,2199,1285,914,86,21,65,5.06,0.0506,0.039,0.023
"956","160621",1992,2033,1066,967,91,20,71,6.66,0.0666,0.045,0.021
"957","160658",1992,2563,1396,1167,77,25,52,3.72,0.0372,0.03,0.021
"958","161004",1992,409,224,185,347,154,193,86.16,0.8616,0.848,0.832
"959","161226",1992,441,302,139,126,31,95,31.46,0.3146,0.286,0.223
"960","161235",1992,97,43,54,8,3,5,11.63,0.1163,0.082,0.056
"961","161244",1992,139,98,41,12,3,9,9.18,0.0918,0.086,0.073
"962","161253",1992,1413,630,783,293,128,165,26.19,0.2619,0.207,0.163
"963","161554",1992,682,365,317,51,17,34,9.32,0.0932,0.075,0.054
"964","162007",1992,329,199,130,35,6,29,14.57,0.1457,0.106,0.046
"965","162210",1992,69,46,23,12,1,11,23.91,0.2391,0.174,0.043
"966","162283",1992,350,183,167,14,1,13,7.1,0.071,0.04,0.006
"967","162584",1992,839,454,385,236,68,168,37,0.37,0.281,0.177
"968","162654",1992,223,155,68,131,27,104,67.1,0.671,0.587,0.397
"969","162760",1992,150,143,7,91,4,87,60.84,0.6084,0.607,0.571
"970","162928",1992,847,325,522,685,402,283,87.08,0.8708,0.809,0.77
"971","163046",1992,792,452,340,565,229,336,74.34,0.7434,0.713,0.674
"972","163268",1992,884,437,447,200,79,121,27.69,0.2769,0.226,0.177
"973","163286",1992,3032,1470,1562,966,379,587,39.93,0.3993,0.319,0.243
"974","163453",1992,967,572,395,168,37,131,22.9,0.229,0.174,0.094
"975","163462",1992,346,190,156,209,89,120,63.16,0.6316,0.604,0.571
"976","163851",1992,634,372,262,264,78,186,50,0.5,0.416,0.298
"977","163912",1992,234,133,101,129,53,76,57.14,0.5714,0.551,0.525
"978","164076",1992,1336,824,512,365,99,266,32.28,0.3228,0.273,0.193
"979","164173",1992,200,154,46,44,7,37,24.03,0.2403,0.22,0.152
"980","164216",1992,276,145,131,160,70,90,62.07,0.6207,0.58,0.534
"981","164270",1992,300,160,140,164,62,102,63.75,0.6375,0.547,0.443
"982","164447",1992,225,95,130,71,38,33,34.74,0.3474,0.316,0.292
"983","164492",1992,80,48,32,35,16,19,39.58,0.3958,0.438,0.5
"984","164562",1992,446,287,159,304,102,202,70.38,0.7038,0.682,0.642
"985","165015",1992,757,413,344,556,250,306,74.09,0.7409,0.734,0.727
"986","165024",1992,963,567,396,213,54,159,28.04,0.2804,0.221,0.136
"987","165334",1992,527,317,210,280,106,174,54.89,0.5489,0.531,0.505
"988","165662",1992,408,276,132,198,70,128,46.38,0.4638,0.485,0.53
"989","165671",1992,149,149,0,52,0,52,34.9,0.349,0.349,NA
"990","165820",1992,538,297,241,128,32,96,32.32,0.3232,0.238,0.133
"991","165866",1992,577,382,195,154,35,119,31.15,0.3115,0.267,0.179
"992","165936",1992,292,193,99,140,39,101,52.33,0.5233,0.479,0.394
"993","166027",1992,1603,686,917,1380,782,598,87.17,0.8717,0.861,0.853
"994","166124",1992,765,428,337,698,308,390,91.12,0.9112,0.912,0.914
"995","166513",1992,964,340,624,239,134,105,30.88,0.3088,0.248,0.215
"996","166629",1992,3993,1940,2053,1329,538,791,40.77,0.4077,0.333,0.262
"997","166638",1992,534,256,278,48,18,30,11.72,0.1172,0.09,0.065
"998","166683",1992,1137,398,739,919,583,336,84.42,0.8442,0.808,0.789
"999","167288",1992,203,105,98,49,18,31,29.52,0.2952,0.241,0.184
"1000","167987",1992,869,453,416,223,75,148,32.67,0.3267,0.257,0.18
"1001","167996",1992,514,314,200,387,135,252,80.25,0.8025,0.753,0.675
"1002","168005",1992,382,190,192,113,43,70,36.84,0.3684,0.296,0.224
"1003","168148",1992,1211,638,573,921,426,495,77.59,0.7759,0.761,0.743
"1004","168254",1992,431,182,249,145,82,63,34.62,0.3462,0.336,0.329
"1005","168281",1992,412,274,138,265,87,178,64.96,0.6496,0.643,0.63
"1006","168342",1992,518,258,260,454,225,229,88.76,0.8876,0.876,0.865
"1007","168546",1992,508,242,266,330,173,157,64.88,0.6488,0.65,0.65
"1008","168786",1992,233,162,71,50,14,36,22.22,0.2222,0.215,0.197
"1009","169080",1992,803,474,329,369,145,224,47.26,0.4726,0.46,0.441
"1010","169798",1992,2149,1200,949,174,50,124,10.33,0.1033,0.081,0.053
"1011","169910",1992,2051,835,1216,57,28,29,3.47,0.0347,0.028,0.023
"1012","170082",1992,1557,982,575,289,91,198,20.16,0.2016,0.186,0.158
"1013","170301",1992,687,408,279,371,134,237,58.09,0.5809,0.54,0.48
"1014","170532",1992,349,201,148,193,77,116,57.71,0.5771,0.553,0.52
"1015","170639",1992,482,226,256,84,35,49,21.68,0.2168,0.174,0.137
"1016","170976",1992,5006,2342,2664,3058,1490,1568,66.95,0.6695,0.611,0.559
"1017","171100",1992,6086,3320,2766,1897,669,1228,36.99,0.3699,0.312,0.242
"1018","171128",1992,1260,321,939,253,169,84,26.17,0.2617,0.201,0.18
"1019","171137",1992,625,323,302,46,18,28,8.67,0.0867,0.074,0.06
"1020","171146",1992,523,317,206,45,8,37,11.67,0.1167,0.086,0.039
"1021","171599",1992,139,39,100,14,5,9,23.08,0.2308,0.101,0.05
"1022","172051",1992,655,360,295,42,8,34,9.44,0.0944,0.064,0.027
"1023","172699",1992,2863,1614,1249,484,165,319,19.76,0.1976,0.169,0.132
"1024","173160",1992,236,143,93,153,54,99,69.23,0.6923,0.648,0.581
"1025","173258",1992,494,249,245,402,204,198,79.52,0.7952,0.814,0.833
"1026","173328",1992,149,90,59,39,12,27,30,0.3,0.262,0.203
"1027","173647",1992,620,327,293,455,224,231,70.64,0.7064,0.734,0.765
"1028","173902",1992,475,258,217,332,139,193,74.81,0.7481,0.699,0.641
"1029","174066",1992,1980,905,1075,329,137,192,21.22,0.2122,0.166,0.127
"1030","174233",1992,1163,566,597,221,95,126,22.26,0.2226,0.19,0.159
"1031","174251",1992,497,291,206,187,67,120,41.24,0.4124,0.376,0.325
"1032","174491",1992,308,183,125,106,40,66,36.07,0.3607,0.344,0.32
"1033","174792",1992,435,0,435,236,236,0,NA,NA,0.543,0.543
"1034","174844",1992,701,409,292,501,192,309,75.55,0.7555,0.715,0.658
"1035","174899",1992,325,240,85,126,36,90,37.5,0.375,0.388,0.424
"1036","174914",1992,798,444,354,362,141,221,49.77,0.4977,0.454,0.398
"1037","175342",1992,531,310,221,73,16,57,18.39,0.1839,0.137,0.072
"1038","175421",1992,89,52,37,22,10,12,23.08,0.2308,0.247,0.27
"1039","175616",1992,443,247,196,98,35,63,25.51,0.2551,0.221,0.179
"1040","175856",1992,906,477,429,89,21,68,14.26,0.1426,0.098,0.049
"1041","175980",1992,274,143,131,167,75,92,64.34,0.6434,0.609,0.573
"1042","176017",1992,1610,810,800,460,175,285,35.19,0.3519,0.286,0.219
"1043","176035",1992,259,210,49,52,6,46,21.9,0.219,0.201,0.122
"1044","176044",1992,563,290,273,64,26,38,13.1,0.131,0.114,0.095
"1045","176080",1992,1672,760,912,316,130,186,24.47,0.2447,0.189,0.143
"1046","176406",1992,325,215,110,69,15,54,25.12,0.2512,0.212,0.136
"1047","176628",1992,91,50,41,21,10,11,22,0.22,0.231,0.244
"1048","176947",1992,209,79,130,42,20,22,27.85,0.2785,0.201,0.154
"1049","176965",1992,1763,921,842,240,105,135,14.66,0.1466,0.136,0.125
"1050","177418",1992,144,110,34,56,5,51,46.36,0.4636,0.389,0.147
"1051","178059",1992,129,93,36,70,19,51,54.84,0.5484,0.543,0.528
"1052","178341",1992,702,381,321,63,24,39,10.24,0.1024,0.09,0.075
"1053","178387",1992,794,445,349,85,22,63,14.16,0.1416,0.107,0.063
"1054","178396",1992,2904,1600,1304,828,305,523,32.69,0.3269,0.285,0.234
"1055","178402",1992,480,257,223,42,13,29,11.28,0.1128,0.088,0.058
"1056","178411",1992,809,174,635,64,40,24,13.79,0.1379,0.079,0.063
"1057","178420",1992,474,224,250,49,18,31,13.84,0.1384,0.103,0.072
"1058","178615",1992,1384,786,598,539,167,372,47.33,0.4733,0.389,0.279
"1059","179043",1992,198,121,77,92,30,62,51.24,0.5124,0.465,0.39
"1060","179159",1992,1051,546,505,473,187,286,52.38,0.5238,0.45,0.37
"1061","179557",1992,1405,806,599,236,67,169,20.97,0.2097,0.168,0.112
"1062","179566",1992,2925,1621,1304,420,110,310,19.12,0.1912,0.144,0.084
"1063","179867",1992,1070,513,557,831,421,410,79.92,0.7992,0.777,0.756
"1064","179894",1992,201,114,87,68,22,46,40.35,0.4035,0.338,0.253
"1065","179946",1992,203,89,114,75,39,36,40.45,0.4045,0.369,0.342
"1066","180179",1992,285,200,85,27,9,18,9,0.09,0.095,0.106
"1067","180461",1992,1530,646,884,155,65,90,13.93,0.1393,0.101,0.074
"1068","180522",1992,188,98,90,20,13,7,7.14,0.0714,0.106,0.144
"1069","180984",1992,202,114,88,73,24,49,42.98,0.4298,0.361,0.273
"1070","181002",1992,843,517,326,509,190,319,61.7,0.617,0.604,0.583
"1071","181020",1992,241,125,116,136,55,81,64.8,0.648,0.564,0.474
"1072","181127",1992,254,124,130,112,43,69,55.65,0.5565,0.441,0.331
"1073","181215",1992,1322,723,599,137,38,99,13.69,0.1369,0.104,0.063
"1074","181394",1992,1256,630,626,54,19,35,5.56,0.0556,0.043,0.03
"1075","181446",1992,366,212,154,174,72,102,48.11,0.4811,0.475,0.468
"1076","181464",1992,3392,1651,1741,330,124,206,12.48,0.1248,0.097,0.071
"1077","181534",1992,264,135,129,27,9,18,13.33,0.1333,0.102,0.07
"1078","181783",1992,630,348,282,117,39,78,22.41,0.2241,0.186,0.138
"1079","182281",1992,1213,641,572,128,44,84,13.1,0.131,0.106,0.077
"1080","182290",1992,1058,523,535,119,41,78,14.91,0.1491,0.112,0.077
"1081","182634",1992,160,106,54,73,23,50,47.17,0.4717,0.456,0.426
"1082","182795",1992,469,236,233,178,82,96,40.68,0.4068,0.38,0.352
"1083","183062",1992,754,447,307,179,50,129,28.86,0.2886,0.237,0.163
"1084","183080",1992,775,403,372,206,79,127,31.51,0.3151,0.266,0.212
"1085","183239",1992,493,274,219,325,141,184,67.15,0.6715,0.659,0.644
"1086","183822",1992,266,170,96,15,6,9,5.29,0.0529,0.056,0.062
"1087","183974",1992,113,86,27,19,4,15,17.44,0.1744,0.168,0.148
"1088","184348",1992,332,203,129,246,92,154,75.86,0.7586,0.741,0.713
"1089","184603",1992,938,466,472,114,53,61,13.09,0.1309,0.122,0.112
"1090","184612",1992,116,103,13,16,1,15,14.56,0.1456,0.138,0.077
"1091","184782",1992,771,453,318,154,46,108,23.84,0.2384,0.2,0.145
"1092","185129",1992,663,324,339,28,16,12,3.7,0.037,0.042,0.047
"1093","185572",1992,436,230,206,94,39,55,23.91,0.2391,0.216,0.189
"1094","185590",1992,913,530,383,106,32,74,13.96,0.1396,0.116,0.084
"1095","185828",1992,501,75,426,34,25,9,12,0.12,0.068,0.059
"1096","186131",1992,1135,516,619,1023,544,479,92.83,0.9283,0.901,0.879
"1097","186201",1992,419,216,203,77,25,52,24.07,0.2407,0.184,0.123
"1098","186283",1992,731,402,329,305,113,192,47.76,0.4776,0.417,0.343
"1099","186584",1992,985,484,501,384,161,223,46.07,0.4607,0.39,0.321
"1100","186876",1992,720,401,319,174,70,104,25.94,0.2594,0.242,0.219
"1101","187134",1992,1068,712,356,628,174,454,63.76,0.6376,0.588,0.489
"1102","187444",1992,962,536,426,94,24,70,13.06,0.1306,0.098,0.056
"1103","187985",1992,1700,946,754,148,53,95,10.04,0.1004,0.087,0.07
"1104","188030",1992,1598,830,768,152,58,94,11.33,0.1133,0.095,0.076
"1105","188429",1992,591,356,235,153,40,113,31.74,0.3174,0.259,0.17
"1106","188641",1992,300,136,164,151,73,78,57.35,0.5735,0.503,0.445
"1107","190044",1992,549,138,411,294,210,84,60.87,0.6087,0.536,0.511
"1108","190099",1992,690,368,322,589,257,332,90.22,0.9022,0.854,0.798
"1109","190150",1992,1113,458,655,880,511,369,80.57,0.8057,0.791,0.78
"1110","190248",1992,106,62,44,28,8,20,32.26,0.3226,0.264,0.182
"1111","190415",1992,2893,1382,1511,2354,1179,1175,85.02,0.8502,0.814,0.78
"1112","190512",1992,1359,830,529,52,20,32,3.86,0.0386,0.038,0.038
"1113","190549",1992,1341,765,576,122,40,82,10.72,0.1072,0.091,0.069
"1114","190558",1992,1126,593,533,17,3,14,2.36,0.0236,0.015,0.006
"1115","190567",1992,1071,454,617,18,12,6,1.32,0.0132,0.017,0.019
"1116","190594",1992,936,710,226,35,10,25,3.52,0.0352,0.037,0.044
"1117","190637",1992,692,468,224,21,6,15,3.21,0.0321,0.03,0.027
"1118","190664",1992,1448,819,629,146,35,111,13.55,0.1355,0.101,0.056
"1119","190691",1992,640,392,248,22,12,10,2.55,0.0255,0.034,0.048
"1120","190725",1992,302,205,97,45,9,36,17.56,0.1756,0.149,0.093
"1121","191241",1992,1039,546,493,623,294,329,60.26,0.6026,0.6,0.596
"1122","191515",1992,461,223,238,373,178,195,87.44,0.8744,0.809,0.748
"1123","191533",1992,446,228,218,248,108,140,61.4,0.614,0.556,0.495
"1124","191630",1992,564,261,303,349,167,182,69.73,0.6973,0.619,0.551
"1125","191649",1992,1403,769,634,571,196,375,48.76,0.4876,0.407,0.309
"1126","191676",1992,296,195,101,141,44,97,49.74,0.4974,0.476,0.436
"1127","191931",1992,1012,522,490,322,136,186,35.63,0.3563,0.318,0.278
"1128","191968",1992,1566,832,734,978,425,553,66.47,0.6647,0.625,0.579
"1129","192192",1992,160,121,39,53,12,41,33.88,0.3388,0.331,0.308
"1130","192323",1992,371,215,156,254,105,149,69.3,0.693,0.685,0.673
"1131","192439",1992,837,552,285,34,15,19,3.44,0.0344,0.041,0.053
"1132","192703",1992,577,250,327,244,120,124,49.6,0.496,0.423,0.367
"1133","192749",1992,183,139,44,106,23,83,59.71,0.5971,0.579,0.523
"1134","192819",1992,820,451,369,514,201,313,69.4,0.694,0.627,0.545
"1135","192925",1992,185,86,99,21,4,17,19.77,0.1977,0.114,0.04
"1136","193016",1992,867,534,333,19,7,12,2.25,0.0225,0.022,0.021
"1137","193292",1992,1417,1055,362,65,7,58,5.5,0.055,0.046,0.019
"1138","193353",1992,254,180,74,97,25,72,40,0.4,0.382,0.338
"1139","193399",1992,185,153,32,88,12,76,49.67,0.4967,0.476,0.375
"1140","193584",1992,211,159,52,129,24,105,66.04,0.6604,0.611,0.462
"1141","193645",1992,935,777,158,85,7,78,10.04,0.1004,0.091,0.044
"1142","193654",1992,423,275,148,155,41,114,41.45,0.4145,0.366,0.277
"1143","193900",1992,2669,1511,1158,1355,571,784,51.89,0.5189,0.508,0.493
"1144","193973",1992,517,334,183,184,60,124,37.13,0.3713,0.356,0.328
"1145","194161",1992,104,60,44,37,14,23,38.33,0.3833,0.356,0.318
"1146","194310",1992,543,357,186,151,42,109,30.53,0.3053,0.278,0.226
"1147","194824",1992,1083,216,867,483,368,115,53.24,0.5324,0.446,0.424
"1148","195003",1992,1482,432,1050,323,172,151,34.95,0.3495,0.218,0.164
"1149","195030",1992,1266,585,681,824,425,399,68.21,0.6821,0.651,0.624
"1150","195164",1992,441,216,225,226,93,133,61.57,0.6157,0.512,0.413
"1151","195173",1992,372,200,172,63,26,37,18.5,0.185,0.169,0.151
"1152","195216",1992,601,294,307,413,207,206,70.07,0.7007,0.687,0.674
"1153","195234",1992,233,177,56,122,21,101,57.06,0.5706,0.524,0.375
"1154","195243",1992,214,125,89,53,9,44,35.2,0.352,0.248,0.101
"1155","195304",1992,220,168,52,127,30,97,57.74,0.5774,0.577,0.577
"1156","195474",1992,544,315,229,399,153,246,78.1,0.781,0.733,0.668
"1157","195526",1992,615,369,246,425,144,281,76.15,0.7615,0.691,0.585
"1158","195544",1992,55,42,13,32,7,25,59.52,0.5952,0.582,0.538
"1159","195809",1992,2326,1211,1115,526,223,303,25.02,0.2502,0.226,0.2
"1160","196413",1992,2581,1329,1252,1465,628,837,62.98,0.6298,0.568,0.502
"1161","196592",1992,1037,676,361,63,14,49,7.25,0.0725,0.061,0.039
"1162","197045",1992,323,183,140,90,37,53,28.96,0.2896,0.279,0.264
"1163","197133",1992,597,370,227,478,175,303,81.89,0.8189,0.801,0.771
"1164","197869",1992,2060,1146,914,621,215,406,35.43,0.3543,0.301,0.235
"1165","197984",1992,145,67,78,42,22,20,29.85,0.2985,0.29,0.282
"1166","198385",1992,414,221,193,367,170,197,89.14,0.8914,0.886,0.881
"1167","198464",1992,2880,1673,1207,561,166,395,23.61,0.2361,0.195,0.138
"1168","198507",1992,541,317,224,181,47,134,42.27,0.4227,0.335,0.21
"1169","198516",1992,817,470,347,455,175,280,59.57,0.5957,0.557,0.504
"1170","198835",1992,255,162,93,104,30,74,45.68,0.4568,0.408,0.323
"1171","198969",1992,290,98,192,54,36,18,18.37,0.1837,0.186,0.188
"1172","199102",1992,1484,780,704,290,86,204,26.15,0.2615,0.195,0.122
"1173","199111",1992,364,195,169,101,33,68,34.87,0.3487,0.277,0.195
"1174","199120",1992,3200,1957,1243,2009,733,1276,65.2,0.652,0.628,0.59
"1175","199139",1992,1575,813,762,291,111,180,22.14,0.2214,0.185,0.146
"1176","199148",1992,1509,1000,509,363,80,283,28.3,0.283,0.241,0.157
"1177","199157",1992,759,452,307,134,30,104,23.01,0.2301,0.177,0.098
"1178","199193",1992,3176,1219,1957,759,338,421,34.54,0.3454,0.239,0.173
"1179","199218",1992,1225,771,454,320,95,225,29.18,0.2918,0.261,0.209
"1180","199281",1992,417,199,218,68,26,42,21.11,0.2111,0.163,0.119
"1181","199306",1992,147,66,81,45,18,27,40.91,0.4091,0.306,0.222
"1182","199412",1992,127,95,32,45,8,37,38.95,0.3895,0.354,0.25
"1183","199582",1992,401,232,169,61,14,47,20.26,0.2026,0.152,0.083
"1184","199643",1992,740,428,312,124,33,91,21.26,0.2126,0.168,0.106
"1185","199847",1992,909,445,464,639,300,339,76.18,0.7618,0.703,0.647
"1186","199962",1992,365,179,186,84,36,48,26.82,0.2682,0.23,0.194
"1187","199999",1992,391,267,124,83,20,63,23.6,0.236,0.212,0.161
"1188","200004",1992,1065,543,522,208,76,132,24.31,0.2431,0.195,0.146
"1189","200059",1992,336,191,145,32,9,23,12.04,0.1204,0.095,0.062
"1190","200156",1992,292,140,152,86,27,59,42.14,0.4214,0.295,0.178
"1191","200217",1992,343,205,138,104,30,74,36.1,0.361,0.303,0.217
"1192","200226",1992,165,86,79,15,5,10,11.63,0.1163,0.091,0.063
"1193","200253",1992,624,398,226,30,6,24,6.03,0.0603,0.048,0.027
"1194","200280",1992,1579,724,855,189,87,102,14.09,0.1409,0.12,0.102
"1195","200332",1992,1550,674,876,155,68,87,12.91,0.1291,0.1,0.078
"1196","200572",1992,193,90,103,28,12,16,17.78,0.1778,0.145,0.117
"1197","201104",1992,650,307,343,172,69,103,33.55,0.3355,0.265,0.201
"1198","201371",1992,181,104,77,92,39,53,50.96,0.5096,0.508,0.506
"1199","201548",1992,330,213,117,163,56,107,50.23,0.5023,0.494,0.479
"1200","201645",1992,762,321,441,350,152,198,61.68,0.6168,0.459,0.345
"1201","201690",1992,665,319,346,42,12,30,9.4,0.094,0.063,0.035
"1202","202134",1992,868,409,459,55,21,34,8.31,0.0831,0.063,0.046
"1203","202480",1992,1622,778,844,832,343,489,62.85,0.6285,0.513,0.406
"1204","202523",1992,570,301,269,392,174,218,72.43,0.7243,0.688,0.647
"1205","202763",1992,412,197,215,153,62,91,46.19,0.4619,0.371,0.288
"1206","203085",1992,229,88,141,86,46,40,45.45,0.4545,0.376,0.326
"1207","203128",1992,277,134,143,116,116,0,0,0,0.419,0.811
"1208","203368",1992,748,395,353,452,184,268,67.85,0.6785,0.604,0.521
"1209","203517",1992,2581,1580,1001,508,135,373,23.61,0.2361,0.197,0.135
"1210","203535",1992,413,218,195,319,147,172,78.9,0.789,0.772,0.754
"1211","203580",1992,36,29,7,14,1,13,44.83,0.4483,0.389,0.143
"1212","203775",1992,363,236,127,114,33,81,34.32,0.3432,0.314,0.26
"1213","203845",1992,370,150,220,165,82,83,55.33,0.5533,0.446,0.373
"1214","204024",1992,2985,1653,1332,1815,700,1115,67.45,0.6745,0.608,0.526
"1215","204185",1992,380,178,202,170,73,97,54.49,0.5449,0.447,0.361
"1216","204194",1992,283,168,115,86,36,50,29.76,0.2976,0.304,0.313
"1217","204617",1992,208,121,87,56,19,37,30.58,0.3058,0.269,0.218
"1218","204796",1992,5389,2625,2764,1024,351,673,25.64,0.2564,0.19,0.127
"1219","204857",1992,3235,1952,1283,1396,427,969,49.64,0.4964,0.432,0.333
"1220","206330",1992,148,48,100,15,7,8,16.67,0.1667,0.101,0.07
"1221","206589",1992,459,240,219,273,118,155,64.58,0.6458,0.595,0.539
"1222","206604",1992,1941,1028,913,159,42,117,11.38,0.1138,0.082,0.046
"1223","206622",1992,672,331,341,345,166,179,54.08,0.5408,0.513,0.487
"1224","206695",1992,1908,962,946,129,59,70,7.28,0.0728,0.068,0.062
"1225","206914",1992,577,323,254,27,6,21,6.5,0.065,0.047,0.024
"1226","207209",1992,411,215,196,23,4,19,8.84,0.0884,0.056,0.02
"1227","207306",1992,317,164,153,36,13,23,14.02,0.1402,0.114,0.085
"1228","207324",1992,355,183,172,97,41,56,30.6,0.306,0.273,0.238
"1229","207388",1992,2148,1116,1032,400,130,270,24.19,0.2419,0.186,0.126
"1230","207500",1992,2376,1164,1212,264,110,154,13.23,0.1323,0.111,0.091
"1231","207722",1992,219,151,68,33,10,23,15.23,0.1523,0.151,0.147
"1232","207847",1992,503,287,216,60,19,41,14.29,0.1429,0.119,0.088
"1233","207865",1992,945,534,411,79,21,58,10.86,0.1086,0.084,0.051
"1234","208822",1992,282,176,106,134,52,82,46.59,0.4659,0.475,0.491
"1235","209056",1992,395,235,160,221,78,143,60.85,0.6085,0.559,0.488
"1236","209065",1992,428,265,163,234,68,166,62.64,0.6264,0.547,0.417
"1237","209542",1992,1703,771,932,442,179,263,34.11,0.3411,0.26,0.192
"1238","209551",1992,2279,1179,1100,808,315,493,41.82,0.4182,0.355,0.286
"1239","209612",1992,226,142,84,103,39,64,45.07,0.4507,0.456,0.464
"1240","209807",1992,651,343,308,94,42,52,15.16,0.1516,0.144,0.136
"1241","209922",1992,310,173,137,148,58,90,52.02,0.5202,0.477,0.423
"1242","210146",1992,588,301,287,63,24,39,12.96,0.1296,0.107,0.084
"1243","210401",1992,385,231,154,256,103,153,66.23,0.6623,0.665,0.669
"1244","210429",1992,626,394,232,112,36,76,19.29,0.1929,0.179,0.155
"1245","210571",1992,310,135,175,160,81,79,58.52,0.5852,0.516,0.463
"1246","210669",1992,471,251,220,295,114,181,72.11,0.7211,0.626,0.518
"1247","210775",1992,182,103,79,26,7,19,18.45,0.1845,0.143,0.089
"1248","211088",1992,163,120,43,81,15,66,55,0.55,0.497,0.349
"1249","211158",1992,1047,696,351,423,87,336,48.28,0.4828,0.404,0.248
"1250","211291",1992,890,426,464,739,376,363,85.21,0.8521,0.83,0.81
"1251","211352",1992,161,115,46,91,24,67,58.26,0.5826,0.565,0.522
"1252","211361",1992,962,436,526,139,45,94,21.56,0.2156,0.144,0.086
"1253","211431",1992,159,148,11,50,2,48,32.43,0.3243,0.314,0.182
"1254","211440",1992,1141,354,787,666,440,226,63.84,0.6384,0.584,0.559
"1255","211468",1992,187,186,1,74,0,74,39.78,0.3978,0.396,0
"1256","211556",1992,89,89,0,42,0,42,47.19,0.4719,0.472,NA
"1257","211583",1992,145,145,0,76,0,76,52.41,0.5241,0.524,NA
"1258","211608",1992,375,184,191,19,2,17,9.24,0.0924,0.051,0.01
"1259","211644",1992,1093,679,414,246,60,186,27.39,0.2739,0.225,0.145
"1260","211981",1992,347,146,201,132,61,71,48.63,0.4863,0.38,0.303
"1261","212009",1992,569,342,227,428,178,250,73.1,0.731,0.752,0.784
"1262","212054",1992,1054,340,714,94,30,64,18.82,0.1882,0.089,0.042
"1263","212106",1992,1026,588,438,441,165,276,46.94,0.4694,0.43,0.377
"1264","212115",1992,628,368,260,143,39,104,28.26,0.2826,0.228,0.15
"1265","212133",1992,183,130,53,82,20,62,47.69,0.4769,0.448,0.377
"1266","212160",1992,1500,857,643,257,75,182,21.24,0.2124,0.171,0.117
"1267","212197",1992,442,318,124,256,52,204,64.15,0.6415,0.579,0.419
"1268","212577",1992,486,222,264,351,182,169,76.13,0.7613,0.722,0.689
"1269","212601",1992,406,244,162,152,54,98,40.16,0.4016,0.374,0.333
"1270","212832",1992,89,72,17,34,2,32,44.44,0.4444,0.382,0.118
"1271","212911",1992,301,145,156,253,132,121,83.45,0.8345,0.841,0.846
"1272","213020",1992,2423,1423,1000,665,197,468,32.89,0.3289,0.274,0.197
"1273","213251",1992,258,132,126,161,68,93,70.45,0.7045,0.624,0.54
"1274","213321",1992,467,213,254,310,159,151,70.89,0.7089,0.664,0.626
"1275","213349",1992,1131,632,499,188,40,148,23.42,0.2342,0.166,0.08
"1276","213358",1992,118,84,34,33,6,27,32.14,0.3214,0.28,0.176
"1277","213367",1992,564,293,271,358,159,199,67.92,0.6792,0.635,0.587
"1278","213385",1992,575,263,312,455,231,224,85.17,0.8517,0.791,0.74
"1279","213507",1992,280,123,157,161,84,77,62.6,0.626,0.575,0.535
"1280","213543",1992,1089,385,704,720,430,290,75.32,0.7532,0.661,0.611
"1281","213613",1992,906,514,392,210,61,149,28.99,0.2899,0.232,0.156
"1282","213668",1992,359,179,180,174,72,102,56.98,0.5698,0.485,0.4
"1283","213783",1992,485,294,191,148,44,104,35.37,0.3537,0.305,0.23
"1284","213826",1992,239,193,46,81,5,76,39.38,0.3938,0.339,0.109
"1285","213996",1992,568,357,211,376,142,234,65.55,0.6555,0.662,0.673
"1286","214041",1992,1002,635,367,375,93,282,44.41,0.4441,0.374,0.253
"1287","214069",1992,292,228,64,88,20,68,29.82,0.2982,0.301,0.312
"1288","214157",1992,296,142,154,187,86,101,71.13,0.7113,0.632,0.558
"1289","214175",1992,466,244,222,334,141,193,79.1,0.791,0.717,0.635
"1290","214272",1992,63,47,16,29,8,21,44.68,0.4468,0.46,0.5
"1291","214777",1992,4227,1995,2232,2529,1163,1366,68.47,0.6847,0.598,0.521
"1292","215062",1992,2259,977,1282,1789,972,817,83.62,0.8362,0.792,0.758
"1293","215743",1992,297,145,152,121,58,63,43.45,0.4345,0.407,0.382
"1294","215798",1992,267,152,115,148,50,98,64.47,0.6447,0.554,0.435
"1295","215929",1992,898,495,403,605,262,343,69.29,0.6929,0.674,0.65
"1296","216010",1992,1238,675,563,441,156,285,42.22,0.4222,0.356,0.277
"1297","216038",1992,1164,658,506,242,95,147,22.34,0.2234,0.208,0.188
"1298","216287",1992,353,172,181,285,143,142,82.56,0.8256,0.807,0.79
"1299","216339",1992,2029,1068,961,337,124,213,19.94,0.1994,0.166,0.129
"1300","216524",1992,403,199,204,285,131,154,77.39,0.7739,0.707,0.642
"1301","216694",1992,346,178,168,158,65,93,52.25,0.5225,0.457,0.387
"1302","216764",1992,1378,883,495,357,90,267,30.24,0.3024,0.259,0.182
"1303","216807",1992,362,213,149,227,89,138,64.79,0.6479,0.627,0.597
"1304","216852",1992,436,169,267,140,66,74,43.79,0.4379,0.321,0.247
"1305","216931",1992,404,164,240,153,73,80,48.78,0.4878,0.379,0.304
"1306","217059",1992,691,414,277,263,87,176,42.51,0.4251,0.381,0.314
"1307","217156",1992,1406,711,695,1121,553,568,79.89,0.7989,0.797,0.796
"1308","217402",1992,931,523,408,734,322,412,78.78,0.7878,0.788,0.789
"1309","217536",1992,381,264,117,208,58,150,56.82,0.5682,0.546,0.496
"1310","217776",1992,88,54,34,26,6,20,37.04,0.3704,0.295,0.176
"1311","217819",1992,1296,853,443,426,100,326,38.22,0.3822,0.329,0.226
"1312","217882",1992,2484,1179,1305,910,330,580,49.19,0.4919,0.366,0.253
"1313","217998",1992,185,98,87,110,52,58,59.18,0.5918,0.595,0.598
"1314","218061",1992,875,487,388,110,42,68,13.96,0.1396,0.126,0.108
"1315","218229",1992,402,273,129,65,16,49,17.95,0.1795,0.162,0.124
"1316","218238",1992,115,48,67,9,4,5,10.42,0.1042,0.078,0.06
"1317","218399",1992,293,177,116,40,16,24,13.56,0.1356,0.137,0.138
"1318","218414",1992,177,82,95,36,16,20,24.39,0.2439,0.203,0.168
"1319","218663",1992,2460,1312,1148,643,257,386,29.42,0.2942,0.261,0.224
"1320","218724",1992,591,305,286,71,17,54,17.7,0.177,0.12,0.059
"1321","218733",1992,701,366,335,89,25,64,17.49,0.1749,0.127,0.075
"1322","218742",1992,399,240,159,56,16,40,16.67,0.1667,0.14,0.101
"1323","218973",1992,287,132,155,206,113,93,70.45,0.7045,0.718,0.729
"1324","219000",1992,347,228,119,162,48,114,50,0.5,0.467,0.403
"1325","219046",1992,1056,597,459,226,79,147,24.62,0.2462,0.214,0.172
"1326","219082",1992,234,123,111,26,12,14,11.38,0.1138,0.111,0.108
"1327","219198",1992,107,72,35,31,9,22,30.56,0.3056,0.29,0.257
"1328","219259",1992,587,313,274,60,20,40,12.78,0.1278,0.102,0.073
"1329","219356",1992,1495,701,794,293,112,181,25.82,0.2582,0.196,0.141
"1330","219471",1992,1228,686,542,239,79,160,23.32,0.2332,0.195,0.146
"1331","219602",1992,752,471,281,164,46,118,25.05,0.2505,0.218,0.164
"1332","219709",1992,285,158,127,93,41,52,32.91,0.3291,0.326,0.323
"1333","219718",1992,104,65,39,12,6,6,9.23,0.0923,0.115,0.154
"1334","219949",1992,173,80,93,40,18,22,27.5,0.275,0.231,0.194
"1335","220075",1992,1610,971,639,150,37,113,11.64,0.1164,0.093,0.058
"1336","220215",1992,286,156,130,92,32,60,38.46,0.3846,0.322,0.246
"1337","220613",1992,359,207,152,63,20,43,20.77,0.2077,0.175,0.132
"1338","220631",1992,328,207,121,127,47,80,38.65,0.3865,0.387,0.388
"1339","220710",1992,194,94,100,67,23,44,46.81,0.4681,0.345,0.23
"1340","221351",1992,360,202,158,256,113,143,70.79,0.7079,0.711,0.715
"1341","221519",1992,338,171,167,230,111,119,69.59,0.6959,0.68,0.665
"1342","221731",1992,74,20,54,13,3,10,50,0.5,0.176,0.056
"1343","221847",1992,1381,584,797,267,113,154,26.37,0.2637,0.193,0.142
"1344","221892",1992,180,96,84,27,10,17,17.71,0.1771,0.15,0.119
"1345","222178",1992,672,323,349,168,66,102,31.58,0.3158,0.25,0.189
"1346","222983",1992,289,144,145,165,76,89,61.81,0.6181,0.571,0.524
"1347","223232",1992,2363,1400,963,930,336,594,42.43,0.4243,0.394,0.349
"1348","224004",1992,115,65,50,16,2,14,21.54,0.2154,0.139,0.04
"1349","224323",1992,251,137,114,114,42,72,52.55,0.5255,0.454,0.368
"1350","225432",1992,540,275,265,3,1,2,0.73,0.0073,0.006,0.004
"1351","225548",1992,265,123,142,60,31,29,23.58,0.2358,0.226,0.218
"1352","225627",1992,310,224,86,33,4,29,12.95,0.1295,0.106,0.047
"1353","226231",1992,182,26,156,37,30,7,26.92,0.2692,0.203,0.192
"1354","226833",1992,641,313,328,43,16,27,8.63,0.0863,0.067,0.049
"1355","227216",1992,1794,1014,780,191,41,150,14.79,0.1479,0.106,0.053
"1356","227331",1992,315,241,74,40,8,32,13.28,0.1328,0.127,0.108
"1357","227526",1992,1194,579,615,261,97,164,28.32,0.2832,0.219,0.158
"1358","227757",1992,598,266,332,437,221,216,81.2,0.812,0.731,0.666
"1359","227845",1992,337,196,141,57,27,30,15.31,0.1531,0.169,0.191
"1360","227863",1992,173,123,50,2,0,2,1.63,0.0163,0.012,0
"1361","228042",1992,140,75,65,12,3,9,12,0.12,0.086,0.046
"1362","228149",1992,491,285,206,139,43,96,33.68,0.3368,0.283,0.209
"1363","228246",1992,1221,634,587,663,274,389,61.36,0.6136,0.543,0.467
"1364","228343",1992,317,176,141,175,62,113,64.2,0.642,0.552,0.44
"1365","228431",1992,2183,1255,928,332,95,237,18.88,0.1888,0.152,0.102
"1366","228459",1992,2310,1372,938,229,59,170,12.39,0.1239,0.099,0.063
"1367","228501",1992,278,124,154,17,6,11,8.87,0.0887,0.061,0.039
"1368","228529",1992,942,428,514,69,28,41,9.58,0.0958,0.073,0.054
"1369","228705",1992,987,484,503,72,20,52,10.74,0.1074,0.073,0.04
"1370","228723",1992,5968,2872,3096,2475,953,1522,52.99,0.5299,0.415,0.308
"1371","228769",1992,1523,724,799,105,39,66,9.12,0.0912,0.069,0.049
"1372","228778",1992,5633,2670,2963,1696,691,1005,37.64,0.3764,0.301,0.233
"1373","228787",1992,93,34,59,21,9,12,35.29,0.3529,0.226,0.153
"1374","228796",1992,1846,989,857,38,18,20,2.02,0.0202,0.021,0.021
"1375","228875",1992,1261,746,515,506,161,345,46.25,0.4625,0.401,0.313
"1376","228981",1992,251,148,103,65,22,43,29.05,0.2905,0.259,0.214
"1377","229018",1992,71,46,25,6,3,3,6.52,0.0652,0.085,0.12
"1378","229027",1992,1558,834,724,120,38,82,9.83,0.0983,0.077,0.052
"1379","229115",1992,2823,1418,1405,528,195,333,23.48,0.2348,0.187,0.139
"1380","229780",1992,133,84,49,20,7,13,15.48,0.1548,0.15,0.143
"1381","229814",1992,848,421,427,98,27,71,16.86,0.1686,0.116,0.063
"1382","230603",1992,649,421,228,84,18,66,15.68,0.1568,0.129,0.079
"1383","230728",1992,1237,847,390,186,31,155,18.3,0.183,0.15,0.079
"1384","230764",1992,2026,996,1030,304,119,185,18.57,0.1857,0.15,0.116
"1385","230782",1992,1211,729,482,52,15,37,5.08,0.0508,0.043,0.031
"1386","231059",1992,414,211,203,277,121,156,73.93,0.7393,0.669,0.596
"1387","231174",1992,1796,978,818,944,378,566,57.87,0.5787,0.526,0.462
"1388","231420",1992,104,62,42,25,6,19,30.65,0.3065,0.24,0.143
"1389","231554",1992,150,72,78,49,29,20,27.78,0.2778,0.327,0.372
"1390","231624",1992,1202,680,522,954,386,568,83.53,0.8353,0.794,0.739
"1391","231712",1992,478,300,178,44,10,34,11.33,0.1133,0.092,0.056
"1392","232025",1992,188,79,109,61,25,36,45.57,0.4557,0.324,0.229
"1393","232043",1992,205,117,88,87,31,56,47.86,0.4786,0.424,0.352
"1394","232089",1992,337,130,207,78,46,32,24.62,0.2462,0.231,0.222
"1395","232186",1992,1732,981,751,467,146,321,32.72,0.3272,0.27,0.194
"1396","232265",1992,1139,675,464,364,80,284,42.07,0.4207,0.32,0.172
"1397","232423",1992,2038,1171,867,1075,361,714,60.97,0.6097,0.527,0.416
"1398","232557",1992,766,369,397,156,81,75,20.33,0.2033,0.204,0.204
"1399","232566",1992,687,473,214,268,50,218,46.09,0.4609,0.39,0.234
"1400","232609",1992,416,248,168,177,52,125,50.4,0.504,0.425,0.31
"1401","232681",1992,698,474,224,448,132,316,66.67,0.6667,0.642,0.589
"1402","232706",1992,212,165,47,77,19,58,35.15,0.3515,0.363,0.404
"1403","232937",1992,1492,893,599,76,24,52,5.82,0.0582,0.051,0.04
"1404","232982",1992,1491,764,727,158,50,108,14.14,0.1414,0.106,0.069
"1405","233277",1992,1807,1128,679,445,99,346,30.67,0.3067,0.246,0.146
"1406","233374",1992,749,361,388,576,294,282,78.12,0.7812,0.769,0.758
"1407","233426",1992,422,259,163,222,65,157,60.62,0.6062,0.526,0.399
"1408","233541",1992,221,141,80,46,16,30,21.28,0.2128,0.208,0.2
"1409","233897",1992,232,110,122,41,14,27,24.55,0.2455,0.177,0.115
"1410","233921",1992,3851,1639,2212,1386,603,783,47.77,0.4777,0.36,0.273
"1411","234030",1992,1460,877,583,270,92,178,20.3,0.203,0.185,0.158
"1412","234085",1992,349,0,349,174,174,0,NA,NA,0.499,0.499
"1413","234155",1992,911,496,415,46,11,35,7.06,0.0706,0.05,0.027
"1414","234164",1992,449,238,211,45,12,33,13.87,0.1387,0.1,0.057
"1415","235097",1992,753,480,273,124,38,86,17.92,0.1792,0.165,0.139
"1416","235167",1992,399,239,160,116,39,77,32.22,0.3222,0.291,0.244
"1417","236230",1992,500,295,205,214,69,145,49.15,0.4915,0.428,0.337
"1418","236328",1992,725,446,279,433,166,267,59.87,0.5987,0.597,0.595
"1419","236577",1992,380,253,127,103,24,79,31.23,0.3123,0.271,0.189
"1420","236595",1992,439,236,203,161,74,87,36.86,0.3686,0.367,0.365
"1421","236896",1992,267,126,141,58,27,31,24.6,0.246,0.217,0.191
"1422","236939",1992,2027,1019,1008,527,212,315,30.91,0.3091,0.26,0.21
"1423","236948",1992,3509,1769,1740,1315,517,798,45.11,0.4511,0.375,0.297
"1424","237011",1992,1455,883,572,341,98,243,27.52,0.2752,0.234,0.171
"1425","237057",1992,336,167,169,218,104,114,68.26,0.6826,0.649,0.615
"1426","237066",1992,266,151,115,113,44,69,45.7,0.457,0.425,0.383
"1427","237215",1992,371,192,179,9,4,5,2.6,0.026,0.024,0.022
"1428","237330",1992,393,233,160,50,9,41,17.6,0.176,0.127,0.056
"1429","237358",1992,201,108,93,49,22,27,25,0.25,0.244,0.237
"1430","237367",1992,1107,578,529,66,18,48,8.3,0.083,0.06,0.034
"1431","237792",1992,490,270,220,3,0,3,1.11,0.0111,0.006,0
"1432","237899",1992,400,188,212,17,7,10,5.32,0.0532,0.043,0.033
"1433","237932",1992,488,263,225,104,29,75,28.52,0.2852,0.213,0.129
"1434","237969",1992,467,223,244,173,72,101,45.29,0.4529,0.37,0.295
"1435","238032",1992,2978,1444,1534,766,296,470,32.55,0.3255,0.257,0.193
"1436","238333",1992,306,159,147,171,68,103,64.78,0.6478,0.559,0.463
"1437","238430",1992,199,133,66,20,10,10,7.52,0.0752,0.101,0.152
"1438","238458",1992,298,193,105,93,27,66,34.2,0.342,0.312,0.257
"1439","238476",1992,406,233,173,196,80,116,49.79,0.4979,0.483,0.462
"1440","238616",1992,183,103,80,69,31,38,36.89,0.3689,0.377,0.388
"1441","238661",1992,131,90,41,25,7,18,20,0.2,0.191,0.171
"1442","239080",1992,190,125,65,52,14,38,30.4,0.304,0.274,0.215
"1443","239105",1992,1651,846,805,804,322,482,56.97,0.5697,0.487,0.4
"1444","239628",1992,180,92,88,88,32,56,60.87,0.6087,0.489,0.364
"1445","239716",1992,496,275,221,328,142,186,67.64,0.6764,0.661,0.643
"1446","240107",1992,218,151,67,61,12,49,32.45,0.3245,0.28,0.179
"1447","240189",1992,1746,933,813,204,68,136,14.58,0.1458,0.117,0.084
"1448","240277",1992,780,487,293,85,22,63,12.94,0.1294,0.109,0.075
"1449","240329",1992,1486,921,565,161,42,119,12.92,0.1292,0.108,0.074
"1450","240338",1992,77,45,32,22,7,15,33.33,0.3333,0.286,0.219
"1451","240365",1992,1461,834,627,172,32,140,16.79,0.1679,0.118,0.051
"1452","240374",1992,633,321,312,32,14,18,5.61,0.0561,0.051,0.045
"1453","240417",1992,988,530,458,114,25,89,16.79,0.1679,0.115,0.055
"1454","240426",1992,350,189,161,35,14,21,11.11,0.1111,0.1,0.087
"1455","240444",1992,4390,2244,2146,1514,599,915,40.78,0.4078,0.345,0.279
"1456","240453",1992,1187,566,621,113,40,73,12.9,0.129,0.095,0.064
"1457","240462",1992,878,304,574,98,48,50,16.45,0.1645,0.112,0.084
"1458","240471",1992,1009,543,466,151,68,83,15.29,0.1529,0.15,0.146
"1459","240480",1992,1388,772,616,229,61,168,21.76,0.2176,0.165,0.099
"1460","240727",1992,1281,640,641,221,73,148,23.12,0.2312,0.173,0.114
"1461","243443",1992,584,396,188,47,7,40,10.1,0.101,0.08,0.037
"1462","243780",1992,5583,2396,3187,1589,761,828,34.56,0.3456,0.285,0.239
"1463","100654",1993,1019,543,476,189,55,134,24.68,0.2468,0.185,0.116
"1464","100663",1993,938,518,420,99,31,68,13.13,0.1313,0.106,0.074
"1465","100751",1993,2516,1318,1198,638,231,407,30.88,0.3088,0.254,0.193
"1466","100858",1993,2997,1552,1445,878,286,592,38.14,0.3814,0.293,0.198
"1467","101435",1993,125,80,45,40,7,33,41.25,0.4125,0.32,0.156
"1468","101480",1993,845,436,409,89,24,65,14.91,0.1491,0.105,0.059
"1469","101675",1993,331,164,167,162,67,95,57.93,0.5793,0.489,0.401
"1470","101879",1993,651,371,280,83,16,67,18.06,0.1806,0.127,0.057
"1471","102049",1993,680,438,242,318,117,201,45.89,0.4589,0.468,0.483
"1472","102094",1993,1086,621,465,125,38,87,14.01,0.1401,0.115,0.082
"1473","102234",1993,229,129,100,106,43,63,48.84,0.4884,0.463,0.43
"1474","102368",1993,926,526,400,303,108,195,37.07,0.3707,0.327,0.27
"1475","102377",1993,595,302,293,104,39,65,21.52,0.2152,0.175,0.133
"1476","104151",1993,3298,1637,1661,561,203,358,21.87,0.2187,0.17,0.122
"1477","104179",1993,4287,2254,2033,968,317,651,28.88,0.2888,0.226,0.156
"1478","105330",1993,1930,1090,840,306,103,203,18.62,0.1862,0.159,0.123
"1479","106245",1993,966,565,401,59,12,47,8.32,0.0832,0.061,0.03
"1480","106342",1993,166,84,82,65,29,36,42.86,0.4286,0.392,0.354
"1481","106397",1993,2015,964,1051,401,158,243,25.21,0.2521,0.199,0.15
"1482","106412",1993,735,379,356,52,15,37,9.76,0.0976,0.071,0.042
"1483","106458",1993,1487,812,675,190,66,124,15.27,0.1527,0.128,0.098
"1484","106467",1993,847,404,443,117,43,74,18.32,0.1832,0.138,0.097
"1485","106485",1993,508,249,259,31,12,19,7.63,0.0763,0.061,0.046
"1486","106704",1993,1792,1098,694,283,94,189,17.21,0.1721,0.158,0.135
"1487","107044",1993,793,437,356,244,101,143,32.72,0.3272,0.308,0.284
"1488","107080",1993,273,165,108,152,58,94,56.97,0.5697,0.557,0.537
"1489","107141",1993,245,139,106,76,29,47,33.81,0.3381,0.31,0.274
"1490","107512",1993,443,217,226,174,86,88,40.55,0.4055,0.393,0.381
"1491","107558",1993,162,96,66,37,15,22,22.92,0.2292,0.228,0.227
"1492","110097",1993,444,286,158,157,48,109,38.11,0.3811,0.354,0.304
"1493","110404",1993,209,63,146,151,109,42,66.67,0.6667,0.722,0.747
"1494","110422",1993,1600,722,878,155,36,119,16.48,0.1648,0.097,0.041
"1495","110486",1993,317,200,117,38,12,26,13,0.13,0.12,0.103
"1496","110495",1993,387,232,155,60,22,38,16.38,0.1638,0.155,0.142
"1497","110510",1993,692,433,259,37,9,28,6.47,0.0647,0.053,0.035
"1498","110529",1993,1309,536,773,105,42,63,11.75,0.1175,0.08,0.054
"1499","110538",1993,1244,754,490,169,27,142,18.83,0.1883,0.136,0.055
"1500","110547",1993,389,252,137,15,5,10,3.97,0.0397,0.039,0.036
"1501","110556",1993,1436,792,644,152,32,120,15.15,0.1515,0.106,0.05
"1502","110565",1993,1309,748,561,112,40,72,9.63,0.0963,0.086,0.071
"1503","110574",1993,553,371,182,59,11,48,12.94,0.1294,0.107,0.06
"1504","110583",1993,1835,1125,710,80,21,59,5.24,0.0524,0.044,0.03
"1505","110592",1993,1133,697,436,34,11,23,3.3,0.033,0.03,0.025
"1506","110617",1993,1086,635,451,51,8,43,6.77,0.0677,0.047,0.018
"1507","113698",1993,75,46,29,17,4,13,28.26,0.2826,0.227,0.138
"1508","115755",1993,553,324,229,60,9,51,15.74,0.1574,0.108,0.039
"1509","119173",1993,276,273,3,56,0,56,20.51,0.2051,0.203,0
"1510","120184",1993,96,76,20,36,5,31,40.79,0.4079,0.375,0.25
"1511","121309",1993,425,255,170,127,34,93,36.47,0.3647,0.299,0.2
"1512","121345",1993,390,183,207,317,167,150,81.97,0.8197,0.813,0.807
"1513","122409",1993,1973,1081,892,126,25,101,9.34,0.0934,0.064,0.028
"1514","122436",1993,890,516,374,468,171,297,57.56,0.5756,0.526,0.457
"1515","122597",1993,1141,668,473,60,16,44,6.59,0.0659,0.053,0.034
"1516","122612",1993,530,359,171,225,61,164,45.68,0.4568,0.425,0.357
"1517","122931",1993,888,489,399,657,287,370,75.66,0.7566,0.74,0.719
"1518","123554",1993,464,249,215,294,128,166,66.67,0.6667,0.634,0.595
"1519","123572",1993,539,362,177,82,18,64,17.68,0.1768,0.152,0.102
"1520","126562",1993,243,141,102,38,9,29,20.57,0.2057,0.156,0.088
"1521","126580",1993,306,164,142,46,18,28,17.07,0.1707,0.15,0.127
"1522","126614",1993,3440,1693,1747,1215,509,706,41.7,0.417,0.353,0.291
"1523","126818",1993,2168,1160,1008,611,210,401,34.57,0.3457,0.282,0.208
"1524","127060",1993,576,306,270,332,144,188,61.44,0.6144,0.576,0.533
"1525","127185",1993,1078,438,640,95,39,56,12.79,0.1279,0.088,0.061
"1526","127565",1993,1380,682,698,43,22,21,3.08,0.0308,0.031,0.032
"1527","127741",1993,1704,1019,685,309,81,228,22.37,0.2237,0.181,0.118
"1528","128106",1993,678,321,357,78,34,44,13.71,0.1371,0.115,0.095
"1529","128744",1993,137,66,71,58,20,38,57.58,0.5758,0.423,0.282
"1530","128771",1993,902,483,419,80,18,62,12.84,0.1284,0.089,0.043
"1531","129020",1993,2052,1068,984,775,297,478,44.76,0.4476,0.378,0.302
"1532","129242",1993,773,392,381,595,283,312,79.59,0.7959,0.77,0.743
"1533","129941",1993,289,103,186,47,27,20,19.42,0.1942,0.163,0.145
"1534","130253",1993,515,274,241,197,72,125,45.62,0.4562,0.383,0.299
"1535","130314",1993,93,93,0,47,0,47,50.54,0.5054,0.505,NA
"1536","130493",1993,1044,572,472,139,38,101,17.66,0.1766,0.133,0.081
"1537","130590",1993,476,242,234,362,173,189,78.1,0.781,0.761,0.739
"1538","130697",1993,703,365,338,547,257,290,79.45,0.7945,0.778,0.76
"1539","130776",1993,526,247,279,115,50,65,26.32,0.2632,0.219,0.179
"1540","130794",1993,1317,627,690,1135,582,553,88.2,0.882,0.862,0.843
"1541","130934",1993,686,386,300,68,11,57,14.77,0.1477,0.099,0.037
"1542","130943",1993,3181,1847,1334,1623,573,1050,56.85,0.5685,0.51,0.43
"1543","131159",1993,1039,660,379,641,219,422,63.94,0.6394,0.617,0.578
"1544","131283",1993,505,276,229,306,130,176,63.77,0.6377,0.606,0.568
"1545","131450",1993,306,164,142,18,6,12,7.32,0.0732,0.059,0.042
"1546","131469",1993,1492,801,691,887,373,514,64.17,0.6417,0.595,0.54
"1547","131496",1993,1377,720,657,1155,551,604,83.89,0.8389,0.839,0.839
"1548","131520",1993,1492,951,541,352,88,264,27.76,0.2776,0.236,0.163
"1549","132471",1993,232,143,89,77,19,58,40.56,0.4056,0.332,0.213
"1550","132602",1993,543,291,252,100,28,72,24.74,0.2474,0.184,0.111
"1551","132903",1993,1882,955,927,432,144,288,30.16,0.3016,0.23,0.155
"1552","133492",1993,364,185,179,201,103,98,52.97,0.5297,0.552,0.575
"1553","133553",1993,799,128,671,154,122,32,25,0.25,0.193,0.182
"1554","133650",1993,1507,908,599,210,46,164,18.06,0.1806,0.139,0.077
"1555","133669",1993,743,412,331,104,34,70,16.99,0.1699,0.14,0.103
"1556","133711",1993,338,193,145,147,59,88,45.6,0.456,0.435,0.407
"1557","133881",1993,358,109,249,93,65,28,25.69,0.2569,0.26,0.261
"1558","133951",1993,1306,751,555,216,65,151,20.11,0.2011,0.165,0.117
"1559","134079",1993,375,207,168,138,58,80,38.65,0.3865,0.368,0.345
"1560","134097",1993,3603,2132,1471,1424,480,944,44.28,0.4428,0.395,0.326
"1561","134130",1993,5074,2520,2554,1728,701,1027,40.75,0.4075,0.341,0.274
"1562","134945",1993,310,139,171,92,47,45,32.37,0.3237,0.297,0.275
"1563","135726",1993,1612,791,821,741,338,403,50.95,0.5095,0.46,0.412
"1564","136172",1993,545,289,256,94,25,69,23.88,0.2388,0.172,0.098
"1565","136950",1993,377,210,167,195,82,113,53.81,0.5381,0.517,0.491
"1566","137546",1993,481,292,189,238,87,151,51.71,0.5171,0.495,0.46
"1567","138354",1993,438,252,186,68,17,51,20.24,0.2024,0.155,0.091
"1568","138716",1993,649,367,282,47,8,39,10.63,0.1063,0.072,0.028
"1569","138789",1993,577,353,224,39,7,32,9.07,0.0907,0.068,0.031
"1570","139144",1993,484,306,178,183,57,126,41.18,0.4118,0.378,0.32
"1571","139366",1993,650,401,249,59,20,39,9.73,0.0973,0.091,0.08
"1572","139393",1993,168,93,75,75,31,44,47.31,0.4731,0.446,0.413
"1573","139658",1993,1406,762,644,999,458,541,71,0.71,0.711,0.711
"1574","139719",1993,539,290,249,27,3,24,8.28,0.0828,0.05,0.012
"1575","139755",1993,1963,484,1479,398,252,146,30.17,0.3017,0.203,0.17
"1576","139764",1993,349,226,123,38,6,32,14.16,0.1416,0.109,0.049
"1577","139861",1993,809,520,289,122,18,104,20,0.2,0.151,0.062
"1578","139931",1993,2955,1602,1353,540,158,382,23.85,0.2385,0.183,0.117
"1579","139940",1993,1072,613,459,119,33,86,14.03,0.1403,0.111,0.072
"1580","139959",1993,3808,2115,1693,1617,630,987,46.67,0.4667,0.425,0.372
"1581","140447",1993,639,378,261,243,85,158,41.8,0.418,0.38,0.326
"1582","140960",1993,760,391,369,48,15,33,8.44,0.0844,0.063,0.041
"1583","140988",1993,165,112,53,60,15,45,40.18,0.4018,0.364,0.283
"1584","141185",1993,165,105,60,47,15,32,30.48,0.3048,0.285,0.25
"1585","141264",1993,1357,807,550,211,50,161,19.95,0.1995,0.155,0.091
"1586","141334",1993,1263,738,525,97,19,78,10.57,0.1057,0.077,0.036
"1587","141486",1993,84,50,34,17,5,12,24,0.24,0.202,0.147
"1588","141565",1993,310,190,120,20,4,16,8.42,0.0842,0.065,0.033
"1589","141574",1993,1551,899,652,141,44,97,10.79,0.1079,0.091,0.067
"1590","142276",1993,1165,626,539,44,12,32,5.11,0.0511,0.038,0.022
"1591","142285",1993,1323,613,710,214,71,143,23.33,0.2333,0.162,0.1
"1592","142461",1993,319,180,139,110,42,68,37.78,0.3778,0.345,0.302
"1593","143084",1993,498,290,208,309,121,188,64.83,0.6483,0.62,0.582
"1594","143288",1993,156,76,80,42,15,27,35.53,0.3553,0.269,0.188
"1595","144005",1993,641,432,209,7,1,6,1.39,0.0139,0.011,0.005
"1596","144281",1993,817,398,419,95,34,61,15.33,0.1533,0.116,0.081
"1597","144740",1993,1182,701,481,416,159,257,36.66,0.3666,0.352,0.331
"1598","144892",1993,1612,969,643,471,112,359,37.05,0.3705,0.292,0.174
"1599","144962",1993,252,140,112,99,41,58,41.43,0.4143,0.393,0.366
"1600","144971",1993,109,45,64,50,26,24,53.33,0.5333,0.459,0.406
"1601","145600",1993,2589,1360,1229,229,85,144,10.59,0.1059,0.088,0.069
"1602","145619",1993,270,125,145,104,43,61,48.8,0.488,0.385,0.297
"1603","145637",1993,5705,2588,3117,2665,1307,1358,52.47,0.5247,0.467,0.419
"1604","145691",1993,261,150,111,113,34,79,52.67,0.5267,0.433,0.306
"1605","145813",1993,2387,1440,947,648,183,465,32.29,0.3229,0.271,0.193
"1606","146481",1993,271,140,131,148,65,83,59.29,0.5929,0.546,0.496
"1607","146612",1993,344,155,189,109,49,60,38.71,0.3871,0.317,0.259
"1608","146719",1993,856,511,345,366,141,225,44.03,0.4403,0.428,0.409
"1609","146825",1993,151,72,79,64,21,43,59.72,0.5972,0.424,0.266
"1610","147013",1993,119,72,47,34,12,22,30.56,0.3056,0.286,0.255
"1611","147244",1993,452,235,217,256,111,145,61.7,0.617,0.566,0.512
"1612","147341",1993,204,93,111,77,31,46,49.46,0.4946,0.377,0.279
"1613","147703",1993,2380,1320,1060,491,163,328,24.85,0.2485,0.206,0.154
"1614","147767",1993,1903,950,953,1566,749,817,86,0.86,0.823,0.786
"1615","147776",1993,641,374,267,14,3,11,2.94,0.0294,0.022,0.011
"1616","147828",1993,421,234,187,169,61,108,46.15,0.4615,0.401,0.326
"1617","148131",1993,297,134,163,71,33,38,28.36,0.2836,0.239,0.202
"1618","148496",1993,140,101,39,66,17,49,48.51,0.4851,0.471,0.436
"1619","148584",1993,149,79,70,61,25,36,45.57,0.4557,0.409,0.357
"1620","148627",1993,272,163,109,75,20,55,33.74,0.3374,0.276,0.183
"1621","149222",1993,2271,969,1302,318,152,166,17.13,0.1713,0.14,0.117
"1622","149231",1993,912,523,389,113,38,75,14.34,0.1434,0.124,0.098
"1623","149772",1993,1531,793,738,347,146,201,25.35,0.2535,0.227,0.198
"1624","149781",1993,546,282,264,371,159,212,75.18,0.7518,0.679,0.602
"1625","150066",1993,423,251,172,131,43,88,35.06,0.3506,0.31,0.25
"1626","150136",1993,3872,2104,1768,701,230,471,22.39,0.2239,0.181,0.13
"1627","150145",1993,168,95,73,62,23,39,41.05,0.4105,0.369,0.315
"1628","150163",1993,700,437,263,288,94,194,44.39,0.4439,0.411,0.357
"1629","150400",1993,495,250,245,361,179,182,72.8,0.728,0.729,0.731
"1630","150534",1993,746,424,322,296,113,183,43.16,0.4316,0.397,0.351
"1631","150668",1993,229,140,89,88,34,54,38.57,0.3857,0.384,0.382
"1632","150941",1993,124,69,55,64,26,38,55.07,0.5507,0.516,0.473
"1633","151102",1993,1189,650,539,47,17,30,4.62,0.0462,0.04,0.032
"1634","151111",1993,1509,830,679,70,29,41,4.94,0.0494,0.046,0.043
"1635","151306",1993,1162,681,481,79,21,58,8.52,0.0852,0.068,0.044
"1636","151324",1993,2221,1165,1056,334,128,206,17.68,0.1768,0.15,0.121
"1637","151333",1993,330,208,122,14,7,7,3.37,0.0337,0.042,0.057
"1638","151342",1993,554,360,194,32,16,16,4.44,0.0444,0.058,0.082
"1639","151351",1993,5833,3340,2493,2427,906,1521,45.54,0.4554,0.416,0.363
"1640","151360",1993,665,415,250,26,13,13,3.13,0.0313,0.039,0.052
"1641","151379",1993,700,392,308,37,12,25,6.38,0.0638,0.053,0.039
"1642","151388",1993,264,168,96,8,2,6,3.57,0.0357,0.03,0.021
"1643","151777",1993,238,118,120,94,43,51,43.22,0.4322,0.395,0.358
"1644","151786",1993,239,150,89,74,23,51,34,0.34,0.31,0.258
"1645","152080",1993,1901,851,1050,1685,910,775,91.07,0.9107,0.886,0.867
"1646","152248",1993,847,475,372,64,32,32,6.74,0.0674,0.076,0.086
"1647","152363",1993,292,140,152,110,59,51,36.43,0.3643,0.377,0.388
"1648","152530",1993,435,233,202,270,107,163,69.96,0.6996,0.621,0.53
"1649","152600",1993,487,251,236,278,109,169,67.33,0.6733,0.571,0.462
"1650","153001",1993,284,143,141,130,47,83,58.04,0.5804,0.458,0.333
"1651","153108",1993,397,210,187,211,87,124,59.05,0.5905,0.531,0.465
"1652","153269",1993,832,492,340,422,158,264,53.66,0.5366,0.507,0.465
"1653","153384",1993,434,224,210,321,151,170,75.89,0.7589,0.74,0.719
"1654","153603",1993,3416,1435,1981,763,327,436,30.38,0.3038,0.223,0.165
"1655","153834",1993,586,341,245,411,176,235,68.91,0.6891,0.701,0.718
"1656","154095",1993,1808,1112,696,491,152,339,30.49,0.3049,0.272,0.218
"1657","155089",1993,230,125,105,55,22,33,26.4,0.264,0.239,0.21
"1658","155317",1993,3603,1849,1754,843,335,508,27.47,0.2747,0.234,0.191
"1659","155335",1993,98,72,26,20,5,15,20.83,0.2083,0.204,0.192
"1660","155399",1993,2739,1356,1383,550,203,347,25.59,0.2559,0.201,0.147
"1661","155520",1993,212,97,115,36,16,20,20.62,0.2062,0.17,0.139
"1662","155627",1993,130,51,79,39,16,23,45.1,0.451,0.3,0.203
"1663","155937",1993,156,76,80,42,18,24,31.58,0.3158,0.269,0.225
"1664","156213",1993,268,177,91,109,36,73,41.24,0.4124,0.407,0.396
"1665","156286",1993,309,172,137,135,65,70,40.7,0.407,0.437,0.474
"1666","156295",1993,453,230,223,150,78,72,31.3,0.313,0.331,0.35
"1667","156365",1993,286,122,164,48,19,29,23.77,0.2377,0.168,0.116
"1668","156541",1993,397,205,192,80,24,56,27.32,0.2732,0.202,0.125
"1669","156745",1993,285,153,132,79,20,59,38.56,0.3856,0.277,0.152
"1670","157058",1993,335,163,172,18,7,11,6.75,0.0675,0.054,0.041
"1671","157076",1993,173,79,94,41,17,24,30.38,0.3038,0.237,0.181
"1672","157085",1993,2662,1391,1271,599,210,389,27.97,0.2797,0.225,0.165
"1673","157289",1993,1743,858,885,157,57,100,11.66,0.1166,0.09,0.064
"1674","157386",1993,1266,706,560,143,41,102,14.45,0.1445,0.113,0.073
"1675","157401",1993,946,510,436,228,77,151,29.61,0.2961,0.241,0.177
"1676","157447",1993,1517,890,627,55,11,44,4.94,0.0494,0.036,0.018
"1677","157535",1993,167,117,50,20,7,13,11.11,0.1111,0.12,0.14
"1678","157951",1993,2201,1222,979,238,80,158,12.93,0.1293,0.108,0.082
"1679","158477",1993,211,121,90,80,33,47,38.84,0.3884,0.379,0.367
"1680","159009",1993,1620,859,761,160,34,126,14.67,0.1467,0.099,0.045
"1681","159391",1993,3178,1697,1481,586,182,404,23.81,0.2381,0.184,0.123
"1682","159647",1993,1411,672,739,258,96,162,24.11,0.2411,0.183,0.13
"1683","159717",1993,1307,702,605,66,13,53,7.55,0.0755,0.05,0.021
"1684","159966",1993,969,586,383,33,12,21,3.58,0.0358,0.034,0.031
"1685","160038",1993,1380,824,556,112,28,84,10.19,0.1019,0.081,0.05
"1686","160612",1993,2192,1222,970,77,19,58,4.75,0.0475,0.035,0.02
"1687","160621",1993,1658,862,796,80,16,64,7.42,0.0742,0.048,0.02
"1688","160658",1993,2524,1378,1146,110,32,78,5.66,0.0566,0.044,0.028
"1689","161004",1993,418,218,200,356,163,193,88.53,0.8853,0.852,0.815
"1690","161226",1993,419,317,102,169,24,145,45.74,0.4574,0.403,0.235
"1691","161235",1993,81,46,35,6,0,6,13.04,0.1304,0.074,0
"1692","161244",1993,133,84,49,10,6,4,4.76,0.0476,0.075,0.122
"1693","161253",1993,1211,522,689,320,131,189,36.21,0.3621,0.264,0.19
"1694","161554",1993,732,390,342,48,18,30,7.69,0.0769,0.066,0.053
"1695","162007",1993,257,152,105,30,9,21,13.82,0.1382,0.117,0.086
"1696","162210",1993,94,52,42,17,7,10,19.23,0.1923,0.181,0.167
"1697","162283",1993,500,264,236,26,6,20,7.58,0.0758,0.052,0.025
"1698","162584",1993,910,433,477,210,87,123,28.41,0.2841,0.231,0.182
"1699","162654",1993,242,168,74,138,34,104,61.9,0.619,0.57,0.459
"1700","162760",1993,163,161,2,102,0,102,63.35,0.6335,0.626,0
"1701","162928",1993,64,32,32,37,16,21,65.62,0.6562,0.578,0.5
"1702","163046",1993,739,436,303,515,181,334,76.61,0.7661,0.697,0.597
"1703","163268",1993,929,419,510,215,97,118,28.16,0.2816,0.231,0.19
"1704","163286",1993,3153,1461,1692,1051,447,604,41.34,0.4134,0.333,0.264
"1705","163453",1993,944,567,377,138,26,112,19.75,0.1975,0.146,0.069
"1706","163462",1993,325,166,159,218,99,119,71.69,0.7169,0.671,0.623
"1707","163851",1993,726,405,321,297,92,205,50.62,0.5062,0.409,0.287
"1708","163912",1993,284,153,131,166,68,98,64.05,0.6405,0.585,0.519
"1709","164076",1993,1215,721,494,348,90,258,35.78,0.3578,0.286,0.182
"1710","164173",1993,218,171,47,53,10,43,25.15,0.2515,0.243,0.213
"1711","164216",1993,213,123,90,132,46,86,69.92,0.6992,0.62,0.511
"1712","164270",1993,258,132,126,145,62,83,62.88,0.6288,0.562,0.492
"1713","164447",1993,240,110,130,68,32,36,32.73,0.3273,0.283,0.246
"1714","164492",1993,94,62,32,50,17,33,53.23,0.5323,0.532,0.531
"1715","164562",1993,491,302,189,299,108,191,63.25,0.6325,0.609,0.571
"1716","165015",1993,704,379,325,531,238,293,77.31,0.7731,0.754,0.732
"1717","165024",1993,1045,590,455,196,68,128,21.69,0.2169,0.188,0.149
"1718","165334",1993,443,257,186,251,102,149,57.98,0.5798,0.567,0.548
"1719","165662",1993,427,263,164,256,100,156,59.32,0.5932,0.6,0.61
"1720","165671",1993,133,133,0,59,0,59,44.36,0.4436,0.444,NA
"1721","165820",1993,550,304,246,97,18,79,25.99,0.2599,0.176,0.073
"1722","165866",1993,517,339,178,117,21,96,28.32,0.2832,0.226,0.118
"1723","165936",1993,298,186,112,98,27,71,38.17,0.3817,0.329,0.241
"1724","166027",1993,1601,715,886,1358,743,615,86.01,0.8601,0.848,0.839
"1725","166124",1993,658,350,308,598,277,321,91.71,0.9171,0.909,0.899
"1726","166513",1993,1033,392,641,217,108,109,27.81,0.2781,0.21,0.168
"1727","166629",1993,3926,1908,2018,1436,577,859,45.02,0.4502,0.366,0.286
"1728","166638",1993,546,253,293,44,15,29,11.46,0.1146,0.081,0.051
"1729","166683",1993,1074,366,708,874,546,328,89.62,0.8962,0.814,0.771
"1730","167288",1993,228,107,121,39,11,28,26.17,0.2617,0.171,0.091
"1731","167987",1993,985,489,496,234,87,147,30.06,0.3006,0.238,0.175
"1732","167996",1993,585,331,254,411,159,252,76.13,0.7613,0.703,0.626
"1733","168005",1993,357,185,172,114,43,71,38.38,0.3838,0.319,0.25
"1734","168148",1993,1193,632,561,923,422,501,79.27,0.7927,0.774,0.752
"1735","168254",1993,392,149,243,120,64,56,37.58,0.3758,0.306,0.263
"1736","168281",1993,417,300,117,263,71,192,64,0.64,0.631,0.607
"1737","168342",1993,527,269,258,467,222,245,91.08,0.9108,0.886,0.86
"1738","168546",1993,488,251,237,270,145,125,49.8,0.498,0.553,0.612
"1739","168786",1993,219,152,67,67,14,53,34.87,0.3487,0.306,0.209
"1740","169080",1993,908,524,384,471,194,277,52.86,0.5286,0.519,0.505
"1741","169798",1993,2242,1217,1025,180,67,113,9.29,0.0929,0.08,0.065
"1742","169910",1993,2114,810,1304,51,26,25,3.09,0.0309,0.024,0.02
"1743","170082",1993,1511,916,595,262,79,183,19.98,0.1998,0.173,0.133
"1744","170301",1993,657,360,297,360,157,203,56.39,0.5639,0.548,0.529
"1745","170532",1993,338,198,140,217,86,131,66.16,0.6616,0.642,0.614
"1746","170639",1993,593,290,303,95,35,60,20.69,0.2069,0.16,0.116
"1747","170976",1993,5016,2428,2588,3078,1451,1627,67.01,0.6701,0.614,0.561
"1748","171100",1993,6164,3372,2792,1851,641,1210,35.88,0.3588,0.3,0.23
"1749","171128",1993,1026,262,764,215,133,82,31.3,0.313,0.21,0.174
"1750","171137",1993,631,311,320,50,21,29,9.32,0.0932,0.079,0.066
"1751","171146",1993,504,322,182,41,12,29,9.01,0.0901,0.081,0.066
"1752","171599",1993,234,78,156,53,30,23,29.49,0.2949,0.226,0.192
"1753","172051",1993,633,337,296,112,36,76,22.55,0.2255,0.177,0.122
"1754","172699",1993,2810,1587,1223,538,161,377,23.76,0.2376,0.191,0.132
"1755","173160",1993,275,168,107,175,64,111,66.07,0.6607,0.636,0.598
"1756","173258",1993,488,252,236,391,185,206,81.75,0.8175,0.801,0.784
"1757","173328",1993,138,77,61,39,16,23,29.87,0.2987,0.283,0.262
"1758","173647",1993,630,369,261,485,191,294,79.67,0.7967,0.77,0.732
"1759","173902",1993,452,252,200,318,128,190,75.4,0.754,0.704,0.64
"1760","174066",1993,2272,1080,1192,413,171,242,22.41,0.2241,0.182,0.143
"1761","174233",1993,1248,631,617,226,88,138,21.87,0.2187,0.181,0.143
"1762","174251",1993,519,284,235,209,88,121,42.61,0.4261,0.403,0.374
"1763","174491",1993,329,209,120,107,38,69,33.01,0.3301,0.325,0.317
"1764","174792",1993,444,0,444,265,265,0,NA,NA,0.597,0.597
"1765","174844",1993,737,413,324,515,215,300,72.64,0.7264,0.699,0.664
"1766","174899",1993,254,193,61,120,25,95,49.22,0.4922,0.472,0.41
"1767","174914",1993,827,439,388,382,155,227,51.71,0.5171,0.462,0.399
"1768","175342",1993,506,299,207,100,24,76,25.42,0.2542,0.198,0.116
"1769","175421",1993,113,59,54,37,16,21,35.59,0.3559,0.327,0.296
"1770","175616",1993,450,255,195,81,28,53,20.78,0.2078,0.18,0.144
"1771","175856",1993,1105,596,509,124,35,89,14.93,0.1493,0.112,0.069
"1772","175980",1993,319,161,158,189,95,94,58.39,0.5839,0.592,0.601
"1773","176017",1993,1538,796,742,461,156,305,38.32,0.3832,0.3,0.21
"1774","176035",1993,272,229,43,68,5,63,27.51,0.2751,0.25,0.116
"1775","176044",1993,478,256,222,57,19,38,14.84,0.1484,0.119,0.086
"1776","176080",1993,1633,777,856,330,118,212,27.28,0.2728,0.202,0.138
"1777","176406",1993,311,223,88,79,17,62,27.8,0.278,0.254,0.193
"1778","176628",1993,84,57,27,25,3,22,38.6,0.386,0.298,0.111
"1779","176947",1993,238,108,130,62,21,41,37.96,0.3796,0.261,0.162
"1780","176965",1993,1433,757,676,213,72,141,18.63,0.1863,0.149,0.107
"1781","177418",1993,126,95,31,50,7,43,45.26,0.4526,0.397,0.226
"1782","178059",1993,165,109,56,73,20,53,48.62,0.4862,0.442,0.357
"1783","178341",1993,701,362,339,51,16,35,9.67,0.0967,0.073,0.047
"1784","178387",1993,928,514,414,86,30,56,10.89,0.1089,0.093,0.072
"1785","178396",1993,2898,1511,1387,828,320,508,33.62,0.3362,0.286,0.231
"1786","178402",1993,515,266,249,53,18,35,13.16,0.1316,0.103,0.072
"1787","178411",1993,786,190,596,78,58,20,10.53,0.1053,0.099,0.097
"1788","178420",1993,458,231,227,52,17,35,15.15,0.1515,0.114,0.075
"1789","178615",1993,1614,962,652,597,178,419,43.56,0.4356,0.37,0.273
"1790","179043",1993,345,194,151,169,74,95,48.97,0.4897,0.49,0.49
"1791","179159",1993,1066,578,488,500,188,312,53.98,0.5398,0.469,0.385
"1792","179557",1993,1229,733,496,226,58,168,22.92,0.2292,0.184,0.117
"1793","179566",1993,2800,1493,1307,376,109,267,17.88,0.1788,0.134,0.083
"1794","179867",1993,1229,569,660,930,460,470,82.6,0.826,0.757,0.697
"1795","179894",1993,227,132,95,81,28,53,40.15,0.4015,0.357,0.295
"1796","179946",1993,180,71,109,73,39,34,47.89,0.4789,0.406,0.358
"1797","180179",1993,386,261,125,25,3,22,8.43,0.0843,0.065,0.024
"1798","180461",1993,1716,756,960,195,89,106,14.02,0.1402,0.114,0.093
"1799","180522",1993,223,106,117,20,9,11,10.38,0.1038,0.09,0.077
"1800","180984",1993,230,114,116,87,31,56,49.12,0.4912,0.378,0.267
"1801","181002",1993,833,492,341,438,164,274,55.69,0.5569,0.526,0.481
"1802","181020",1993,246,135,111,127,52,75,55.56,0.5556,0.516,0.468
"1803","181127",1993,266,147,119,119,48,71,48.3,0.483,0.447,0.403
"1804","181215",1993,936,501,435,124,37,87,17.37,0.1737,0.132,0.085
"1805","181394",1993,1220,664,556,52,14,38,5.72,0.0572,0.043,0.025
"1806","181446",1993,382,218,164,153,62,91,41.74,0.4174,0.401,0.378
"1807","181464",1993,3325,1571,1754,449,170,279,17.76,0.1776,0.135,0.097
"1808","181534",1993,211,112,99,22,4,18,16.07,0.1607,0.104,0.04
"1809","181783",1993,718,398,320,105,25,80,20.1,0.201,0.146,0.078
"1810","182281",1993,1281,669,612,127,47,80,11.96,0.1196,0.099,0.077
"1811","182290",1993,1140,563,577,155,49,106,18.83,0.1883,0.136,0.085
"1812","182634",1993,179,115,64,72,24,48,41.74,0.4174,0.402,0.375
"1813","182795",1993,410,186,224,117,64,53,28.49,0.2849,0.285,0.286
"1814","183062",1993,809,488,321,170,43,127,26.02,0.2602,0.21,0.134
"1815","183080",1993,748,364,384,163,63,100,27.47,0.2747,0.218,0.164
"1816","183239",1993,510,284,226,323,128,195,68.66,0.6866,0.633,0.566
"1817","183822",1993,270,192,78,20,5,15,7.81,0.0781,0.074,0.064
"1818","183974",1993,95,77,18,20,2,18,23.38,0.2338,0.211,0.111
"1819","184348",1993,312,190,122,226,84,142,74.74,0.7474,0.724,0.689
"1820","184603",1993,860,422,438,128,46,82,19.43,0.1943,0.149,0.105
"1821","184612",1993,129,105,24,10,0,10,9.52,0.0952,0.078,0
"1822","184782",1993,713,408,305,152,43,109,26.72,0.2672,0.213,0.141
"1823","185129",1993,514,276,238,27,11,16,5.8,0.058,0.053,0.046
"1824","185572",1993,477,220,257,94,43,51,23.18,0.2318,0.197,0.167
"1825","185590",1993,868,531,337,117,34,83,15.63,0.1563,0.135,0.101
"1826","185828",1993,476,90,386,33,22,11,12.22,0.1222,0.069,0.057
"1827","186131",1993,1152,514,638,1032,563,469,91.25,0.9125,0.896,0.882
"1828","186201",1993,361,199,162,62,21,41,20.6,0.206,0.172,0.13
"1829","186283",1993,663,376,287,267,104,163,43.35,0.4335,0.403,0.362
"1830","186584",1993,996,522,474,376,142,234,44.83,0.4483,0.378,0.3
"1831","186876",1993,709,369,340,193,77,116,31.44,0.3144,0.272,0.226
"1832","187134",1993,1064,628,436,576,186,390,62.1,0.621,0.541,0.427
"1833","187444",1993,1091,608,483,89,14,75,12.34,0.1234,0.082,0.029
"1834","187985",1993,1910,1067,843,171,52,119,11.15,0.1115,0.09,0.062
"1835","188030",1993,1602,780,822,153,64,89,11.41,0.1141,0.096,0.078
"1836","188429",1993,464,282,182,154,48,106,37.59,0.3759,0.332,0.264
"1837","188641",1993,314,148,166,165,74,91,61.49,0.6149,0.525,0.446
"1838","190044",1993,557,120,437,285,221,64,53.33,0.5333,0.512,0.506
"1839","190099",1993,726,378,348,603,269,334,88.36,0.8836,0.831,0.773
"1840","190150",1993,1626,997,629,1243,482,761,76.33,0.7633,0.764,0.766
"1841","190248",1993,81,40,41,27,12,15,37.5,0.375,0.333,0.293
"1842","190415",1993,3172,1423,1749,2612,1400,1212,85.17,0.8517,0.823,0.8
"1843","190512",1993,1300,798,502,63,25,38,4.76,0.0476,0.048,0.05
"1844","190549",1993,1269,748,521,143,40,103,13.77,0.1377,0.113,0.077
"1845","190558",1993,1100,579,521,23,9,14,2.42,0.0242,0.021,0.017
"1846","190567",1993,1167,507,660,25,13,12,2.37,0.0237,0.021,0.02
"1847","190594",1993,1308,1011,297,62,7,55,5.44,0.0544,0.047,0.024
"1848","190637",1993,663,455,208,15,1,14,3.08,0.0308,0.023,0.005
"1849","190664",1993,1526,831,695,180,55,125,15.04,0.1504,0.118,0.079
"1850","190691",1993,607,359,248,29,13,16,4.46,0.0446,0.048,0.052
"1851","190725",1993,405,271,134,58,19,39,14.39,0.1439,0.143,0.142
"1852","191241",1993,989,532,457,587,271,316,59.4,0.594,0.594,0.593
"1853","191515",1993,452,195,257,361,192,169,86.67,0.8667,0.799,0.747
"1854","191533",1993,429,217,212,201,80,121,55.76,0.5576,0.469,0.377
"1855","191630",1993,493,236,257,325,146,179,75.85,0.7585,0.659,0.568
"1856","191649",1993,1349,705,644,524,191,333,47.23,0.4723,0.388,0.297
"1857","191676",1993,287,182,105,147,50,97,53.3,0.533,0.512,0.476
"1858","191931",1993,951,455,496,260,117,143,31.43,0.3143,0.273,0.236
"1859","191968",1993,1365,721,644,813,345,468,64.91,0.6491,0.596,0.536
"1860","192192",1993,172,124,48,47,13,34,27.42,0.2742,0.273,0.271
"1861","192323",1993,415,213,202,254,107,147,69.01,0.6901,0.612,0.53
"1862","192439",1993,918,633,285,36,13,23,3.63,0.0363,0.039,0.046
"1863","192703",1993,546,254,292,307,152,155,61.02,0.6102,0.562,0.521
"1864","192749",1993,214,133,81,86,30,56,42.11,0.4211,0.402,0.37
"1865","192819",1993,806,460,346,371,134,237,51.52,0.5152,0.46,0.387
"1866","192925",1993,202,94,108,38,16,22,23.4,0.234,0.188,0.148
"1867","193016",1993,733,403,330,16,6,10,2.48,0.0248,0.022,0.018
"1868","193292",1993,175,139,36,74,8,66,47.48,0.4748,0.423,0.222
"1869","193353",1993,239,164,75,90,29,61,37.2,0.372,0.377,0.387
"1870","193399",1993,174,136,38,71,9,62,45.59,0.4559,0.408,0.237
"1871","193584",1993,266,192,74,142,29,113,58.85,0.5885,0.534,0.392
"1872","193645",1993,821,677,144,89,14,75,11.08,0.1108,0.108,0.097
"1873","193654",1993,441,282,159,142,50,92,32.62,0.3262,0.322,0.314
"1874","193900",1993,2752,1592,1160,1395,546,849,53.33,0.5333,0.507,0.471
"1875","193973",1993,432,259,173,202,68,134,51.74,0.5174,0.468,0.393
"1876","194161",1993,109,69,40,30,8,22,31.88,0.3188,0.275,0.2
"1877","194310",1993,659,430,229,228,64,164,38.14,0.3814,0.346,0.279
"1878","194824",1993,936,168,768,408,303,105,62.5,0.625,0.436,0.395
"1879","195003",1993,1343,425,918,310,146,164,38.59,0.3859,0.231,0.159
"1880","195030",1993,1229,599,630,754,365,389,64.94,0.6494,0.614,0.579
"1881","195164",1993,370,187,183,215,95,120,64.17,0.6417,0.581,0.519
"1882","195173",1993,358,214,144,107,40,67,31.31,0.3131,0.299,0.278
"1883","195216",1993,507,260,247,353,167,186,71.54,0.7154,0.696,0.676
"1884","195234",1993,236,160,76,116,24,92,57.5,0.575,0.492,0.316
"1885","195243",1993,211,132,79,86,24,62,46.97,0.4697,0.408,0.304
"1886","195304",1993,255,195,60,131,31,100,51.28,0.5128,0.514,0.517
"1887","195474",1993,616,339,277,421,185,236,69.62,0.6962,0.683,0.668
"1888","195526",1993,588,355,233,414,153,261,73.52,0.7352,0.704,0.657
"1889","195544",1993,78,61,17,42,10,32,52.46,0.5246,0.538,0.588
"1890","195809",1993,2324,1174,1150,565,223,342,29.13,0.2913,0.243,0.194
"1891","196413",1993,2418,1270,1148,1386,590,796,62.68,0.6268,0.573,0.514
"1892","196592",1993,1236,815,421,70,6,64,7.85,0.0785,0.057,0.014
"1893","197045",1993,256,140,116,84,35,49,35,0.35,0.328,0.302
"1894","197133",1993,649,414,235,497,169,328,79.23,0.7923,0.766,0.719
"1895","197869",1993,1931,1098,833,603,192,411,37.43,0.3743,0.312,0.23
"1896","197984",1993,136,69,67,44,20,24,34.78,0.3478,0.324,0.299
"1897","198385",1993,452,195,257,381,212,169,86.67,0.8667,0.843,0.825
"1898","198464",1993,2428,1417,1011,558,151,407,28.72,0.2872,0.23,0.149
"1899","198507",1993,460,273,187,164,47,117,42.86,0.4286,0.357,0.251
"1900","198516",1993,857,492,365,478,197,281,57.11,0.5711,0.558,0.54
"1901","198835",1993,254,135,119,115,39,76,56.3,0.563,0.453,0.328
"1902","198969",1993,310,81,229,49,28,21,25.93,0.2593,0.158,0.122
"1903","199102",1993,1429,775,654,300,85,215,27.74,0.2774,0.21,0.13
"1904","199111",1993,394,222,172,129,42,87,39.19,0.3919,0.327,0.244
"1905","199120",1993,3310,2048,1262,2089,744,1345,65.67,0.6567,0.631,0.59
"1906","199139",1993,1685,845,840,312,111,201,23.79,0.2379,0.185,0.132
"1907","199148",1993,1500,959,541,297,61,236,24.61,0.2461,0.198,0.113
"1908","199157",1993,810,525,285,201,40,161,30.67,0.3067,0.248,0.14
"1909","199193",1993,3277,1248,2029,841,397,444,35.58,0.3558,0.257,0.196
"1910","199218",1993,1439,860,579,417,131,286,33.26,0.3326,0.29,0.226
"1911","199281",1993,422,216,206,71,19,52,24.07,0.2407,0.168,0.092
"1912","199306",1993,156,70,86,40,14,26,37.14,0.3714,0.256,0.163
"1913","199412",1993,169,134,35,60,13,47,35.07,0.3507,0.355,0.371
"1914","199582",1993,361,196,165,49,12,37,18.88,0.1888,0.136,0.073
"1915","199643",1993,601,336,265,140,43,97,28.87,0.2887,0.233,0.162
"1916","199847",1993,904,443,461,676,314,362,81.72,0.8172,0.748,0.681
"1917","199962",1993,376,171,205,78,31,47,27.49,0.2749,0.207,0.151
"1918","199999",1993,369,225,144,79,26,53,23.56,0.2356,0.214,0.181
"1919","200004",1993,1051,509,542,226,91,135,26.52,0.2652,0.215,0.168
"1920","200059",1993,300,148,152,22,5,17,11.49,0.1149,0.073,0.033
"1921","200156",1993,262,121,141,62,27,35,28.93,0.2893,0.237,0.191
"1922","200217",1993,350,224,126,91,20,71,31.7,0.317,0.26,0.159
"1923","200226",1993,146,61,85,17,4,13,21.31,0.2131,0.116,0.047
"1924","200253",1993,579,346,233,48,13,35,10.12,0.1012,0.083,0.056
"1925","200280",1993,1465,747,718,205,80,125,16.73,0.1673,0.14,0.111
"1926","200332",1993,1433,571,862,182,76,106,18.56,0.1856,0.127,0.088
"1927","200572",1993,196,80,116,34,12,22,27.5,0.275,0.173,0.103
"1928","201104",1993,510,268,242,134,29,105,39.18,0.3918,0.263,0.12
"1929","201371",1993,214,105,109,110,43,67,63.81,0.6381,0.514,0.394
"1930","201548",1993,448,266,182,238,81,157,59.02,0.5902,0.531,0.445
"1931","201645",1993,712,249,463,354,201,153,61.45,0.6145,0.497,0.434
"1932","201690",1993,613,301,312,66,18,48,15.95,0.1595,0.108,0.058
"1933","202134",1993,942,479,463,77,26,51,10.65,0.1065,0.082,0.056
"1934","202480",1993,1507,730,777,769,324,445,60.96,0.6096,0.51,0.417
"1935","202523",1993,535,290,245,342,142,200,68.97,0.6897,0.639,0.58
"1936","202763",1993,394,190,204,162,76,86,45.26,0.4526,0.411,0.373
"1937","203085",1993,217,105,112,86,38,48,45.71,0.4571,0.396,0.339
"1938","203128",1993,263,127,136,134,64,70,55.12,0.5512,0.51,0.471
"1939","203368",1993,813,422,391,487,216,271,64.22,0.6422,0.599,0.552
"1940","203517",1993,2371,1476,895,540,163,377,25.54,0.2554,0.228,0.182
"1941","203535",1993,408,231,177,316,129,187,80.95,0.8095,0.775,0.729
"1942","203580",1993,51,39,12,12,1,11,28.21,0.2821,0.235,0.083
"1943","203775",1993,427,218,209,110,34,76,34.86,0.3486,0.258,0.163
"1944","203845",1993,342,145,197,174,84,90,62.07,0.6207,0.509,0.426
"1945","204024",1993,3264,1782,1482,1948,739,1209,67.85,0.6785,0.597,0.499
"1946","204185",1993,396,194,202,197,89,108,55.67,0.5567,0.497,0.441
"1947","204194",1993,335,201,134,108,35,73,36.32,0.3632,0.322,0.261
"1948","204617",1993,225,123,102,61,16,45,36.59,0.3659,0.271,0.157
"1949","204796",1993,5283,2710,2573,1074,371,703,25.94,0.2594,0.203,0.144
"1950","204857",1993,3148,1782,1366,1297,433,864,48.48,0.4848,0.412,0.317
"1951","206330",1993,200,61,139,33,15,18,29.51,0.2951,0.165,0.108
"1952","206589",1993,548,291,257,346,139,207,71.13,0.7113,0.631,0.541
"1953","206604",1993,2002,1045,957,190,73,117,11.2,0.112,0.095,0.076
"1954","206622",1993,696,381,315,368,170,198,51.97,0.5197,0.529,0.54
"1955","206695",1993,1967,1005,962,180,78,102,10.15,0.1015,0.092,0.081
"1956","206914",1993,626,350,276,54,26,28,8,0.08,0.086,0.094
"1957","207209",1993,479,253,226,28,10,18,7.11,0.0711,0.058,0.044
"1958","207306",1993,228,119,109,33,12,21,17.65,0.1765,0.145,0.11
"1959","207324",1993,291,157,134,56,31,25,15.92,0.1592,0.192,0.231
"1960","207388",1993,2050,999,1051,377,130,247,24.72,0.2472,0.184,0.124
"1961","207500",1993,2235,1072,1163,337,139,198,18.47,0.1847,0.151,0.12
"1962","207722",1993,207,128,79,21,6,15,11.72,0.1172,0.101,0.076
"1963","207847",1993,541,295,246,77,31,46,15.59,0.1559,0.142,0.126
"1964","207865",1993,791,409,382,68,19,49,11.98,0.1198,0.086,0.05
"1965","208822",1993,343,198,145,159,62,97,48.99,0.4899,0.464,0.428
"1966","209056",1993,469,274,195,259,113,146,53.28,0.5328,0.552,0.579
"1967","209065",1993,436,235,201,254,110,144,61.28,0.6128,0.583,0.547
"1968","209542",1993,1625,705,920,395,169,226,32.06,0.3206,0.243,0.184
"1969","209551",1993,2513,1422,1091,951,346,605,42.55,0.4255,0.378,0.317
"1970","209612",1993,280,164,116,126,47,79,48.17,0.4817,0.45,0.405
"1971","209807",1993,684,330,354,74,31,43,13.03,0.1303,0.108,0.088
"1972","209922",1993,328,171,157,148,80,68,39.77,0.3977,0.451,0.51
"1973","210146",1993,601,324,277,75,19,56,17.28,0.1728,0.125,0.069
"1974","210401",1993,381,218,163,249,101,148,67.89,0.6789,0.654,0.62
"1975","210429",1993,675,404,271,133,31,102,25.25,0.2525,0.197,0.114
"1976","210571",1993,227,140,87,147,50,97,69.29,0.6929,0.648,0.575
"1977","210669",1993,481,247,234,301,126,175,70.85,0.7085,0.626,0.538
"1978","210775",1993,157,103,54,48,14,34,33.01,0.3301,0.306,0.259
"1979","211088",1993,227,166,61,131,35,96,57.83,0.5783,0.577,0.574
"1980","211158",1993,1017,615,402,379,115,264,42.93,0.4293,0.373,0.286
"1981","211291",1993,854,454,400,717,324,393,86.56,0.8656,0.84,0.81
"1982","211352",1993,224,158,66,115,29,86,54.43,0.5443,0.513,0.439
"1983","211361",1993,951,401,550,145,55,90,22.44,0.2244,0.152,0.1
"1984","211431",1993,169,158,11,80,3,77,48.73,0.4873,0.473,0.273
"1985","211440",1993,1189,358,831,752,510,242,67.6,0.676,0.632,0.614
"1986","211468",1993,198,196,2,83,1,82,41.84,0.4184,0.419,0.5
"1987","211556",1993,87,87,0,41,0,41,47.13,0.4713,0.471,NA
"1988","211583",1993,132,132,0,73,0,73,55.3,0.553,0.553,NA
"1989","211608",1993,287,128,159,23,11,12,9.38,0.0938,0.08,0.069
"1990","211644",1993,1081,650,431,246,70,176,27.08,0.2708,0.228,0.162
"1991","211981",1993,435,212,223,142,65,77,36.32,0.3632,0.326,0.291
"1992","212009",1993,482,277,205,330,124,206,74.37,0.7437,0.685,0.605
"1993","212054",1993,1126,383,743,86,27,59,15.4,0.154,0.076,0.036
"1994","212106",1993,971,547,424,418,182,236,43.14,0.4314,0.43,0.429
"1995","212115",1993,799,446,353,161,39,122,27.35,0.2735,0.202,0.11
"1996","212133",1993,162,113,49,76,22,54,47.79,0.4779,0.469,0.449
"1997","212160",1993,1315,763,552,221,65,156,20.45,0.2045,0.168,0.118
"1998","212197",1993,424,276,148,270,76,194,70.29,0.7029,0.637,0.514
"1999","212577",1993,507,229,278,364,190,174,75.98,0.7598,0.718,0.683
"2000","212601",1993,450,257,193,177,79,98,38.13,0.3813,0.393,0.409
"2001","212832",1993,86,74,12,32,2,30,40.54,0.4054,0.372,0.167
"2002","212911",1993,292,143,149,243,122,121,84.62,0.8462,0.832,0.819
"2003","213020",1993,2366,1365,1001,495,154,341,24.98,0.2498,0.209,0.154
"2004","213251",1993,301,166,135,198,87,111,66.87,0.6687,0.658,0.644
"2005","213321",1993,380,166,214,241,127,114,68.67,0.6867,0.634,0.593
"2006","213349",1993,1309,771,538,236,57,179,23.22,0.2322,0.18,0.106
"2007","213358",1993,181,85,96,61,31,30,35.29,0.3529,0.337,0.323
"2008","213367",1993,597,327,270,321,125,196,59.94,0.5994,0.538,0.463
"2009","213385",1993,570,252,318,443,226,217,86.11,0.8611,0.777,0.711
"2010","213507",1993,314,170,144,191,77,114,67.06,0.6706,0.608,0.535
"2011","213543",1993,1095,394,701,706,404,302,76.65,0.7665,0.645,0.576
"2012","213613",1993,758,402,356,157,43,114,28.36,0.2836,0.207,0.121
"2013","213668",1993,361,203,158,191,72,119,58.62,0.5862,0.529,0.456
"2014","213783",1993,590,350,240,189,59,130,37.14,0.3714,0.32,0.246
"2015","213826",1993,292,228,64,101,17,84,36.84,0.3684,0.346,0.266
"2016","213996",1993,606,376,230,400,155,245,65.16,0.6516,0.66,0.674
"2017","214041",1993,946,593,353,339,86,253,42.66,0.4266,0.358,0.244
"2018","214069",1993,316,231,85,88,24,64,27.71,0.2771,0.278,0.282
"2019","214157",1993,304,157,147,216,102,114,72.61,0.7261,0.711,0.694
"2020","214175",1993,464,270,194,332,131,201,74.44,0.7444,0.716,0.675
"2021","214272",1993,84,64,20,33,7,26,40.62,0.4062,0.393,0.35
"2022","214777",1993,4265,2107,2158,1846,741,1105,52.44,0.5244,0.433,0.343
"2023","215062",1993,2434,1086,1348,1923,1008,915,84.25,0.8425,0.79,0.748
"2024","215743",1993,285,136,149,115,49,66,48.53,0.4853,0.404,0.329
"2025","215798",1993,277,122,155,144,74,70,57.38,0.5738,0.52,0.477
"2026","215929",1993,899,496,403,582,239,343,69.15,0.6915,0.647,0.593
"2027","216010",1993,1114,603,511,443,162,281,46.6,0.466,0.398,0.317
"2028","216038",1993,1239,739,500,247,77,170,23,0.23,0.199,0.154
"2029","216287",1993,413,226,187,348,149,199,88.05,0.8805,0.843,0.797
"2030","216339",1993,2186,1209,977,355,141,214,17.7,0.177,0.162,0.144
"2031","216524",1993,308,159,149,226,108,118,74.21,0.7421,0.734,0.725
"2032","216694",1993,325,180,145,132,51,81,45,0.45,0.406,0.352
"2033","216764",1993,1386,876,510,346,74,272,31.05,0.3105,0.25,0.145
"2034","216807",1993,375,216,159,250,93,157,72.69,0.7269,0.667,0.585
"2035","216852",1993,473,215,258,182,79,103,47.91,0.4791,0.385,0.306
"2036","216931",1993,434,198,236,177,85,92,46.46,0.4646,0.408,0.36
"2037","217059",1993,691,397,294,274,102,172,43.32,0.4332,0.397,0.347
"2038","217156",1993,1424,770,654,1109,494,615,79.87,0.7987,0.779,0.755
"2039","217402",1993,968,503,465,775,368,407,80.91,0.8091,0.801,0.791
"2040","217536",1993,345,235,110,181,57,124,52.77,0.5277,0.525,0.518
"2041","217776",1993,90,48,42,23,8,15,31.25,0.3125,0.256,0.19
"2042","217819",1993,1519,1004,515,485,123,362,36.06,0.3606,0.319,0.239
"2043","217882",1993,2300,1053,1247,872,323,549,52.14,0.5214,0.379,0.259
"2044","217998",1993,177,108,69,113,36,77,71.3,0.713,0.638,0.522
"2045","218061",1993,807,435,372,130,40,90,20.69,0.2069,0.161,0.108
"2046","218229",1993,491,327,164,80,21,59,18.04,0.1804,0.163,0.128
"2047","218238",1993,214,88,126,43,22,21,23.86,0.2386,0.201,0.175
"2048","218399",1993,327,213,114,33,10,23,10.8,0.108,0.101,0.088
"2049","218414",1993,155,62,93,44,24,20,32.26,0.3226,0.284,0.258
"2050","218663",1993,2298,1269,1029,681,246,435,34.28,0.3428,0.296,0.239
"2051","218724",1993,732,379,353,86,26,60,15.83,0.1583,0.117,0.074
"2052","218733",1993,613,329,284,80,20,60,18.24,0.1824,0.131,0.07
"2053","218742",1993,327,216,111,46,6,40,18.52,0.1852,0.141,0.054
"2054","218973",1993,273,109,164,210,117,93,85.32,0.8532,0.769,0.713
"2055","219000",1993,306,208,98,128,25,103,49.52,0.4952,0.418,0.255
"2056","219046",1993,1078,586,492,243,85,158,26.96,0.2696,0.225,0.173
"2057","219082",1993,208,116,92,14,2,12,10.34,0.1034,0.067,0.022
"2058","219198",1993,117,96,21,39,9,30,31.25,0.3125,0.333,0.429
"2059","219259",1993,647,360,287,73,14,59,16.39,0.1639,0.113,0.049
"2060","219356",1993,1670,831,839,320,128,192,23.1,0.231,0.192,0.153
"2061","219471",1993,1227,704,523,247,79,168,23.86,0.2386,0.201,0.151
"2062","219602",1993,788,474,314,152,50,102,21.52,0.2152,0.193,0.159
"2063","219709",1993,328,182,146,137,58,79,43.41,0.4341,0.418,0.397
"2064","219718",1993,125,43,82,15,4,11,25.58,0.2558,0.12,0.049
"2065","219949",1993,169,106,63,37,6,31,29.25,0.2925,0.219,0.095
"2066","220075",1993,1289,757,532,128,51,77,10.17,0.1017,0.099,0.096
"2067","220215",1993,296,169,127,83,31,52,30.77,0.3077,0.28,0.244
"2068","220613",1993,395,205,190,87,37,50,24.39,0.2439,0.22,0.195
"2069","220631",1993,217,134,83,59,23,36,26.87,0.2687,0.272,0.277
"2070","220710",1993,175,73,102,56,28,28,38.36,0.3836,0.32,0.275
"2071","221351",1993,385,215,170,284,124,160,74.42,0.7442,0.738,0.729
"2072","221519",1993,322,157,165,250,131,119,75.8,0.758,0.776,0.794
"2073","221731",1993,90,28,62,8,2,6,21.43,0.2143,0.089,0.032
"2074","221847",1993,1330,608,722,172,55,117,19.24,0.1924,0.129,0.076
"2075","221892",1993,139,84,55,25,9,16,19.05,0.1905,0.18,0.164
"2076","222178",1993,650,343,307,165,66,99,28.86,0.2886,0.254,0.215
"2077","222983",1993,294,175,119,165,57,108,61.71,0.6171,0.561,0.479
"2078","223232",1993,2426,1420,1006,978,350,628,44.23,0.4423,0.403,0.348
"2079","224004",1993,107,62,45,26,7,19,30.65,0.3065,0.243,0.156
"2080","224323",1993,246,138,108,118,56,62,44.93,0.4493,0.48,0.519
"2081","225432",1993,666,362,304,8,2,6,1.66,0.0166,0.012,0.007
"2082","225548",1993,322,133,189,56,31,25,18.8,0.188,0.174,0.164
"2083","225627",1993,297,202,95,29,8,21,10.4,0.104,0.098,0.084
"2084","226231",1993,202,33,169,46,36,10,30.3,0.303,0.228,0.213
"2085","226833",1993,553,284,269,49,23,26,9.15,0.0915,0.089,0.086
"2086","227216",1993,1872,1045,827,211,63,148,14.16,0.1416,0.113,0.076
"2087","227331",1993,291,224,67,29,0,29,12.95,0.1295,0.1,0
"2088","227526",1993,1208,610,598,110,27,83,13.61,0.1361,0.091,0.045
"2089","227757",1993,639,281,358,440,228,212,75.44,0.7544,0.689,0.637
"2090","227845",1993,370,235,135,98,32,66,28.09,0.2809,0.265,0.237
"2091","227863",1993,192,129,63,53,13,40,31.01,0.3101,0.276,0.206
"2092","228042",1993,134,77,57,26,10,16,20.78,0.2078,0.194,0.175
"2093","228149",1993,402,231,171,125,34,91,39.39,0.3939,0.311,0.199
"2094","228246",1993,1161,630,531,657,265,392,62.22,0.6222,0.566,0.499
"2095","228343",1993,351,207,144,218,79,139,67.15,0.6715,0.621,0.549
"2096","228431",1993,2247,1255,992,308,81,227,18.09,0.1809,0.137,0.082
"2097","228459",1993,2281,1358,923,248,62,186,13.7,0.137,0.109,0.067
"2098","228501",1993,317,107,210,23,9,14,13.08,0.1308,0.073,0.043
"2099","228529",1993,923,432,491,82,24,58,13.43,0.1343,0.089,0.049
"2100","228705",1993,1012,481,531,50,19,31,6.44,0.0644,0.049,0.036
"2101","228723",1993,6341,3083,3258,1631,524,1107,35.91,0.3591,0.257,0.161
"2102","228769",1993,1314,638,676,81,34,47,7.37,0.0737,0.062,0.05
"2103","228778",1993,5872,2810,3062,1776,741,1035,36.83,0.3683,0.302,0.242
"2104","228787",1993,414,156,258,125,76,49,31.41,0.3141,0.302,0.295
"2105","228796",1993,1948,1023,925,59,22,37,3.62,0.0362,0.03,0.024
"2106","228875",1993,1189,690,499,467,162,305,44.2,0.442,0.393,0.325
"2107","228981",1993,213,134,79,65,24,41,30.6,0.306,0.305,0.304
"2108","229018",1993,78,41,37,8,3,5,12.2,0.122,0.103,0.081
"2109","229027",1993,1591,855,736,84,43,41,4.8,0.048,0.053,0.058
"2110","229115",1993,3073,1525,1548,520,196,324,21.25,0.2125,0.169,0.127
"2111","229780",1993,166,106,60,26,10,16,15.09,0.1509,0.157,0.167
"2112","229814",1993,986,472,514,93,25,68,14.41,0.1441,0.094,0.049
"2113","230603",1993,588,416,172,83,11,72,17.31,0.1731,0.141,0.064
"2114","230728",1993,1321,850,471,212,42,170,20,0.2,0.16,0.089
"2115","230764",1993,1794,1004,790,202,59,143,14.24,0.1424,0.113,0.075
"2116","230782",1993,1219,829,390,81,23,58,7,0.07,0.066,0.059
"2117","231059",1993,454,238,216,291,128,163,68.49,0.6849,0.641,0.593
"2118","231174",1993,1706,955,751,828,319,509,53.3,0.533,0.485,0.425
"2119","231420",1993,168,101,67,56,17,39,38.61,0.3861,0.333,0.254
"2120","231554",1993,210,119,91,88,36,52,43.7,0.437,0.419,0.396
"2121","231624",1993,1201,690,511,913,360,553,80.14,0.8014,0.76,0.705
"2122","231712",1993,428,266,162,29,7,22,8.27,0.0827,0.068,0.043
"2123","232025",1993,230,120,110,91,30,61,50.83,0.5083,0.396,0.273
"2124","232043",1993,229,130,99,108,42,66,50.77,0.5077,0.472,0.424
"2125","232089",1993,332,131,201,68,29,39,29.77,0.2977,0.205,0.144
"2126","232186",1993,1670,934,736,442,140,302,32.33,0.3233,0.265,0.19
"2127","232265",1993,1427,879,548,410,85,325,36.97,0.3697,0.287,0.155
"2128","232423",1993,2079,1170,909,1239,453,786,67.18,0.6718,0.596,0.498
"2129","232557",1993,1407,691,716,204,81,123,17.8,0.178,0.145,0.113
"2130","232566",1993,724,509,215,275,40,235,46.17,0.4617,0.38,0.186
"2131","232609",1993,361,221,140,120,36,84,38.01,0.3801,0.332,0.257
"2132","232681",1993,750,477,273,486,161,325,68.13,0.6813,0.648,0.59
"2133","232706",1993,175,130,45,66,10,56,43.08,0.4308,0.377,0.222
"2134","232937",1993,1324,759,565,70,24,46,6.06,0.0606,0.053,0.042
"2135","232982",1993,1173,580,593,137,39,98,16.9,0.169,0.117,0.066
"2136","233277",1993,1736,1088,648,460,128,332,30.51,0.3051,0.265,0.198
"2137","233374",1993,728,383,345,559,251,308,80.42,0.8042,0.768,0.728
"2138","233426",1993,438,275,163,242,67,175,63.64,0.6364,0.553,0.411
"2139","233541",1993,185,88,97,47,17,30,34.09,0.3409,0.254,0.175
"2140","233897",1993,253,110,143,53,22,31,28.18,0.2818,0.209,0.154
"2141","233921",1993,4270,1776,2494,1459,620,839,47.24,0.4724,0.342,0.249
"2142","234030",1993,1466,874,592,281,80,201,23,0.23,0.192,0.135
"2143","234085",1993,278,0,278,131,131,0,NA,NA,0.471,0.471
"2144","234155",1993,695,409,286,88,33,55,13.45,0.1345,0.127,0.115
"2145","234164",1993,435,240,195,49,15,34,14.17,0.1417,0.113,0.077
"2146","235097",1993,725,424,301,131,45,86,20.28,0.2028,0.181,0.15
"2147","235167",1993,435,253,182,158,63,95,37.55,0.3755,0.363,0.346
"2148","236230",1993,499,269,230,228,90,138,51.3,0.513,0.457,0.391
"2149","236328",1993,687,402,285,402,159,243,60.45,0.6045,0.585,0.558
"2150","236577",1993,395,263,132,117,42,75,28.52,0.2852,0.296,0.318
"2151","236595",1993,489,276,213,165,61,104,37.68,0.3768,0.337,0.286
"2152","236896",1993,263,138,125,70,29,41,29.71,0.2971,0.266,0.232
"2153","236939",1993,2431,1234,1197,644,235,409,33.14,0.3314,0.265,0.196
"2154","236948",1993,3206,1576,1630,1217,515,702,44.54,0.4454,0.38,0.316
"2155","237011",1993,1542,941,601,365,91,274,29.12,0.2912,0.237,0.151
"2156","237057",1993,341,196,145,249,102,147,75,0.75,0.73,0.703
"2157","237066",1993,361,206,155,160,59,101,49.03,0.4903,0.443,0.381
"2158","237215",1993,358,215,143,10,5,5,2.33,0.0233,0.028,0.035
"2159","237330",1993,487,284,203,71,25,46,16.2,0.162,0.146,0.123
"2160","237358",1993,167,100,67,24,10,14,14,0.14,0.144,0.149
"2161","237367",1993,1053,553,500,93,29,64,11.57,0.1157,0.088,0.058
"2162","237792",1993,557,310,247,59,17,42,13.55,0.1355,0.106,0.069
"2163","237899",1993,634,308,326,21,8,13,4.22,0.0422,0.033,0.025
"2164","237932",1993,474,238,236,85,32,53,22.27,0.2227,0.179,0.136
"2165","237969",1993,475,235,240,172,64,108,45.96,0.4596,0.362,0.267
"2166","238032",1993,2806,1370,1436,658,252,406,29.64,0.2964,0.234,0.175
"2167","238333",1993,284,161,123,158,61,97,60.25,0.6025,0.556,0.496
"2168","238430",1993,481,327,154,39,12,27,8.26,0.0826,0.081,0.078
"2169","238458",1993,345,211,134,130,45,85,40.28,0.4028,0.377,0.336
"2170","238476",1993,441,227,214,216,99,117,51.54,0.5154,0.49,0.463
"2171","238616",1993,289,139,150,81,37,44,31.65,0.3165,0.28,0.247
"2172","238661",1993,161,121,40,42,7,35,28.93,0.2893,0.261,0.175
"2173","239080",1993,170,115,55,47,12,35,30.43,0.3043,0.276,0.218
"2174","239105",1993,1684,895,789,880,339,541,60.45,0.6045,0.523,0.43
"2175","239628",1993,211,102,109,113,47,66,64.71,0.6471,0.536,0.431
"2176","239716",1993,569,320,249,352,142,210,65.62,0.6562,0.619,0.57
"2177","240107",1993,270,205,65,67,14,53,25.85,0.2585,0.248,0.215
"2178","240189",1993,1823,1019,804,251,78,173,16.98,0.1698,0.138,0.097
"2179","240277",1993,703,438,265,96,29,67,15.3,0.153,0.137,0.109
"2180","240329",1993,1695,1008,687,243,83,160,15.87,0.1587,0.143,0.121
"2181","240338",1993,80,55,25,31,10,21,38.18,0.3818,0.388,0.4
"2182","240365",1993,1465,833,632,200,53,147,17.65,0.1765,0.137,0.084
"2183","240374",1993,668,355,313,51,17,34,9.58,0.0958,0.076,0.054
"2184","240417",1993,1023,488,535,143,36,107,21.93,0.2193,0.14,0.067
"2185","240426",1993,323,182,141,41,14,27,14.84,0.1484,0.127,0.099
"2186","240444",1993,4585,2396,2189,1686,659,1027,42.86,0.4286,0.368,0.301
"2187","240453",1993,1712,849,863,117,51,66,7.77,0.0777,0.068,0.059
"2188","240462",1993,917,276,641,109,51,58,21.01,0.2101,0.119,0.08
"2189","240471",1993,838,443,395,162,64,98,22.12,0.2212,0.193,0.162
"2190","240480",1993,1359,702,657,201,72,129,18.38,0.1838,0.148,0.11
"2191","240727",1993,1212,560,652,207,79,128,22.86,0.2286,0.171,0.121
"2192","243443",1993,796,541,255,44,8,36,6.65,0.0665,0.055,0.031
"2193","243780",1993,5725,2560,3165,1625,773,852,33.28,0.3328,0.284,0.244
"2194","100654",1995,849,434,415,185,47,138,31.8,0.318,0.218,0.113
"2195","100663",1995,1052,599,453,128,37,91,15.19,0.1519,0.122,0.082
"2196","100751",1995,2493,1387,1106,748,246,502,36.19,0.3619,0.3,0.222
"2197","100858",1995,3486,1832,1654,1106,345,761,41.54,0.4154,0.317,0.209
"2198","101435",1995,160,106,54,56,17,39,36.79,0.3679,0.35,0.315
"2199","101480",1995,798,435,363,136,36,100,22.99,0.2299,0.17,0.099
"2200","101675",1995,229,114,115,120,50,70,61.4,0.614,0.524,0.435
"2201","101879",1995,762,444,318,167,44,123,27.7,0.277,0.219,0.138
"2202","102049",1995,647,399,248,331,118,213,53.38,0.5338,0.512,0.476
"2203","102094",1995,1192,674,518,167,54,113,16.77,0.1677,0.14,0.104
"2204","102234",1995,232,141,91,113,34,79,56.03,0.5603,0.487,0.374
"2205","102368",1995,877,477,400,354,120,234,49.06,0.4906,0.404,0.3
"2206","102377",1995,645,383,262,139,35,104,27.15,0.2715,0.216,0.134
"2207","104151",1995,3945,2096,1849,854,299,555,26.48,0.2648,0.216,0.162
"2208","104179",1995,4370,2382,1988,1160,405,755,31.7,0.317,0.265,0.204
"2209","105330",1995,2015,1120,895,436,133,303,27.05,0.2705,0.216,0.149
"2210","106245",1995,675,390,285,103,37,66,16.92,0.1692,0.153,0.13
"2211","106342",1995,168,90,78,82,32,50,55.56,0.5556,0.488,0.41
"2212","106397",1995,2249,1148,1101,425,155,270,23.52,0.2352,0.189,0.141
"2213","106412",1995,565,302,263,39,11,28,9.27,0.0927,0.069,0.042
"2214","106458",1995,1448,803,645,218,65,153,19.05,0.1905,0.151,0.101
"2215","106467",1995,756,386,370,133,46,87,22.54,0.2254,0.176,0.124
"2216","106485",1995,489,254,235,46,14,32,12.6,0.126,0.094,0.06
"2217","106704",1995,1469,920,549,207,46,161,17.5,0.175,0.141,0.084
"2218","107044",1995,779,437,342,250,92,158,36.16,0.3616,0.321,0.269
"2219","107080",1995,273,166,107,148,58,90,54.22,0.5422,0.542,0.542
"2220","107141",1995,224,115,109,71,28,43,37.39,0.3739,0.317,0.257
"2221","107512",1995,380,206,174,173,75,98,47.57,0.4757,0.455,0.431
"2222","107558",1995,133,66,67,29,14,15,22.73,0.2273,0.218,0.209
"2223","110097",1995,407,278,129,168,45,123,44.24,0.4424,0.413,0.349
"2224","110404",1995,218,52,166,156,108,48,92.31,0.9231,0.716,0.651
"2225","110422",1995,2418,1092,1326,356,114,242,22.16,0.2216,0.147,0.086
"2226","110486",1995,397,236,161,43,11,32,13.56,0.1356,0.108,0.068
"2227","110495",1995,353,242,111,75,12,63,26.03,0.2603,0.212,0.108
"2228","110510",1995,799,505,294,58,16,42,8.32,0.0832,0.073,0.054
"2229","110529",1995,1422,621,801,96,37,59,9.5,0.095,0.068,0.046
"2230","110538",1995,1401,832,569,161,22,139,16.71,0.1671,0.115,0.039
"2231","110547",1995,467,335,132,19,4,15,4.48,0.0448,0.041,0.03
"2232","110556",1995,1571,915,656,176,44,132,14.43,0.1443,0.112,0.067
"2233","110565",1995,1832,1036,796,148,41,107,10.33,0.1033,0.081,0.052
"2234","110574",1995,542,331,211,55,22,33,9.97,0.0997,0.101,0.104
"2235","110583",1995,2057,1307,750,88,26,62,4.74,0.0474,0.043,0.035
"2236","110592",1995,1243,766,477,49,12,37,4.83,0.0483,0.039,0.025
"2237","110617",1995,1219,735,484,96,24,72,9.8,0.098,0.079,0.05
"2238","113698",1995,69,51,18,27,5,22,43.14,0.4314,0.391,0.278
"2239","115755",1995,908,503,405,69,18,51,10.14,0.1014,0.076,0.044
"2240","119173",1995,222,220,2,50,2,48,21.82,0.2182,0.225,1
"2241","120184",1995,115,79,36,44,9,35,44.3,0.443,0.383,0.25
"2242","121309",1995,475,313,162,185,57,128,40.89,0.4089,0.389,0.352
"2243","121345",1995,392,190,202,336,166,170,89.47,0.8947,0.857,0.822
"2244","122409",1995,2840,1716,1124,212,58,154,8.97,0.0897,0.075,0.052
"2245","122436",1995,978,597,381,500,186,314,52.6,0.526,0.511,0.488
"2246","122597",1995,1539,966,573,89,26,63,6.52,0.0652,0.058,0.045
"2247","122612",1995,550,350,200,237,71,166,47.43,0.4743,0.431,0.355
"2248","122931",1995,1043,558,485,757,329,428,76.7,0.767,0.726,0.678
"2249","123554",1995,474,256,218,306,141,165,64.45,0.6445,0.646,0.647
"2250","123572",1995,681,441,240,131,41,90,20.41,0.2041,0.192,0.171
"2251","126562",1995,266,166,100,41,14,27,16.27,0.1627,0.154,0.14
"2252","126580",1995,363,197,166,88,36,52,26.4,0.264,0.242,0.217
"2253","126614",1995,4170,2020,2150,1454,602,852,42.18,0.4218,0.349,0.28
"2254","126818",1995,2546,1354,1192,805,287,518,38.26,0.3826,0.316,0.241
"2255","127060",1995,654,330,324,376,175,201,60.91,0.6091,0.575,0.54
"2256","127185",1995,1010,434,576,96,26,70,16.13,0.1613,0.095,0.045
"2257","127565",1995,1239,691,548,48,19,29,4.2,0.042,0.039,0.035
"2258","127741",1995,1763,1091,672,404,90,314,28.78,0.2878,0.229,0.134
"2259","128106",1995,590,299,291,69,31,38,12.71,0.1271,0.117,0.107
"2260","128744",1995,123,73,50,38,14,24,32.88,0.3288,0.309,0.28
"2261","128771",1995,1076,566,510,68,28,40,7.07,0.0707,0.063,0.055
"2262","129020",1995,2010,1051,959,855,341,514,48.91,0.4891,0.425,0.356
"2263","129242",1995,784,450,334,602,248,354,78.67,0.7867,0.768,0.743
"2264","129941",1995,352,115,237,110,74,36,31.3,0.313,0.312,0.312
"2265","130253",1995,639,357,282,269,107,162,45.38,0.4538,0.421,0.379
"2266","130314",1995,153,152,1,82,0,82,53.95,0.5395,0.536,0
"2267","130493",1995,917,526,391,121,36,85,16.16,0.1616,0.132,0.092
"2268","130590",1995,507,246,261,388,174,214,86.99,0.8699,0.765,0.667
"2269","130697",1995,710,356,354,584,288,296,83.15,0.8315,0.823,0.814
"2270","130776",1995,460,237,223,79,35,44,18.57,0.1857,0.172,0.157
"2271","130794",1995,1360,692,668,1198,575,623,90.03,0.9003,0.881,0.861
"2272","130934",1995,563,333,230,76,27,49,14.71,0.1471,0.135,0.117
"2273","130943",1995,3155,1883,1272,1719,621,1098,58.31,0.5831,0.545,0.488
"2274","131159",1995,1221,794,427,789,288,501,63.1,0.631,0.646,0.674
"2275","131283",1995,514,265,249,290,125,165,62.26,0.6226,0.564,0.502
"2276","131450",1995,225,120,105,10,2,8,6.67,0.0667,0.044,0.019
"2277","131469",1995,1367,803,564,905,346,559,69.61,0.6961,0.662,0.613
"2278","131496",1995,1403,742,661,1207,568,639,86.12,0.8612,0.86,0.859
"2279","131520",1995,834,540,294,438,117,321,59.44,0.5944,0.525,0.398
"2280","132471",1995,177,103,74,46,10,36,34.95,0.3495,0.26,0.135
"2281","132602",1995,729,393,336,106,31,75,19.08,0.1908,0.145,0.092
"2282","132903",1995,2411,1295,1116,661,217,444,34.29,0.3429,0.274,0.194
"2283","133492",1995,334,184,150,199,83,116,63.04,0.6304,0.596,0.553
"2284","133553",1995,665,100,565,128,105,23,23,0.23,0.192,0.186
"2285","133650",1995,1574,952,622,245,63,182,19.12,0.1912,0.156,0.101
"2286","133669",1995,901,504,397,162,51,111,22.02,0.2202,0.18,0.128
"2287","133711",1995,355,217,138,143,45,98,45.16,0.4516,0.403,0.326
"2288","133881",1995,370,111,259,113,70,43,38.74,0.3874,0.305,0.27
"2289","133951",1995,1752,1003,749,270,74,196,19.54,0.1954,0.154,0.099
"2290","134079",1995,527,302,225,230,76,154,50.99,0.5099,0.436,0.338
"2291","134097",1995,3826,2210,1616,1534,530,1004,45.43,0.4543,0.401,0.328
"2292","134130",1995,5655,3023,2632,2443,903,1540,50.94,0.5094,0.432,0.343
"2293","134945",1995,356,197,159,129,51,78,39.59,0.3959,0.362,0.321
"2294","135726",1995,1684,913,771,832,348,484,53.01,0.5301,0.494,0.451
"2295","136172",1995,762,463,299,145,26,119,25.7,0.257,0.19,0.087
"2296","136950",1995,412,248,164,250,88,162,65.32,0.6532,0.607,0.537
"2297","137546",1995,464,253,211,228,89,139,54.94,0.5494,0.491,0.422
"2298","138354",1995,509,279,230,101,30,71,25.45,0.2545,0.198,0.13
"2299","138716",1995,530,291,239,37,10,27,9.28,0.0928,0.07,0.042
"2300","138789",1995,773,497,276,50,13,37,7.44,0.0744,0.065,0.047
"2301","139144",1995,522,316,206,184,68,116,36.71,0.3671,0.352,0.33
"2302","139366",1995,633,390,243,54,17,37,9.49,0.0949,0.085,0.07
"2303","139393",1995,155,90,65,75,33,42,46.67,0.4667,0.484,0.508
"2304","139658",1995,1587,896,691,1093,441,652,72.77,0.7277,0.689,0.638
"2305","139719",1995,522,261,261,38,8,30,11.49,0.1149,0.073,0.031
"2306","139755",1995,2120,600,1520,451,271,180,30,0.3,0.213,0.178
"2307","139764",1995,328,211,117,26,3,23,10.9,0.109,0.079,0.026
"2308","139861",1995,754,467,287,123,28,95,20.34,0.2034,0.163,0.098
"2309","139931",1995,3193,1825,1368,407,112,295,16.16,0.1616,0.127,0.082
"2310","139940",1995,1276,750,526,127,51,76,10.13,0.1013,0.1,0.097
"2311","139959",1995,3996,2376,1620,1702,570,1132,47.64,0.4764,0.426,0.352
"2312","140447",1995,630,381,249,199,65,134,35.17,0.3517,0.316,0.261
"2313","140960",1995,676,358,318,25,2,23,6.42,0.0642,0.037,0.006
"2314","140988",1995,167,118,49,76,24,52,44.07,0.4407,0.455,0.49
"2315","141185",1995,210,124,86,8,2,6,4.84,0.0484,0.038,0.023
"2316","141264",1995,1665,985,680,247,71,176,17.87,0.1787,0.148,0.104
"2317","141334",1995,1430,841,589,128,32,96,11.41,0.1141,0.09,0.054
"2318","141486",1995,123,72,51,31,12,19,26.39,0.2639,0.252,0.235
"2319","141565",1995,359,216,143,32,5,27,12.5,0.125,0.089,0.035
"2320","141574",1995,1671,967,704,184,57,127,13.13,0.1313,0.11,0.081
"2321","142276",1995,1363,783,580,37,6,31,3.96,0.0396,0.027,0.01
"2322","142285",1995,1242,602,640,225,78,147,24.42,0.2442,0.181,0.122
"2323","142461",1995,320,183,137,86,27,59,32.24,0.3224,0.269,0.197
"2324","143084",1995,605,352,253,394,151,243,69.03,0.6903,0.651,0.597
"2325","143288",1995,157,66,91,37,17,20,30.3,0.303,0.236,0.187
"2326","144005",1995,613,410,203,35,3,32,7.8,0.078,0.057,0.015
"2327","144281",1995,939,464,475,131,67,64,13.79,0.1379,0.14,0.141
"2328","144740",1995,1225,700,525,447,177,270,38.57,0.3857,0.365,0.337
"2329","144892",1995,1538,973,565,468,117,351,36.07,0.3607,0.304,0.207
"2330","144962",1995,253,147,106,128,41,87,59.18,0.5918,0.506,0.387
"2331","144971",1995,139,58,81,68,35,33,56.9,0.569,0.489,0.432
"2332","145600",1995,2469,1401,1068,309,110,199,14.2,0.142,0.125,0.103
"2333","145619",1995,245,123,122,95,38,57,46.34,0.4634,0.388,0.311
"2334","145637",1995,6101,2944,3157,3312,1492,1820,61.82,0.6182,0.543,0.473
"2335","145691",1995,223,139,84,98,30,68,48.92,0.4892,0.439,0.357
"2336","145813",1995,2950,1798,1152,823,240,583,32.42,0.3242,0.279,0.208
"2337","146481",1995,266,155,111,156,58,98,63.23,0.6323,0.586,0.523
"2338","146612",1995,331,158,173,104,49,55,34.81,0.3481,0.314,0.283
"2339","146719",1995,1182,733,449,544,167,377,51.43,0.5143,0.46,0.372
"2340","146825",1995,175,75,100,50,12,38,50.67,0.5067,0.286,0.12
"2341","147013",1995,188,109,79,54,16,38,34.86,0.3486,0.287,0.203
"2342","147244",1995,494,272,222,248,98,150,55.15,0.5515,0.502,0.441
"2343","147341",1995,308,187,121,156,54,102,54.55,0.5455,0.506,0.446
"2344","147703",1995,2429,1368,1061,582,200,382,27.92,0.2792,0.24,0.189
"2345","147767",1995,1948,1066,882,1595,672,923,86.59,0.8659,0.819,0.762
"2346","147776",1995,812,488,324,20,7,13,2.66,0.0266,0.025,0.022
"2347","147828",1995,389,217,172,150,60,90,41.47,0.4147,0.386,0.349
"2348","148131",1995,259,126,133,89,30,59,46.83,0.4683,0.344,0.226
"2349","148496",1995,124,95,29,67,13,54,56.84,0.5684,0.54,0.448
"2350","148584",1995,165,82,83,67,30,37,45.12,0.4512,0.406,0.361
"2351","148627",1995,226,139,87,67,19,48,34.53,0.3453,0.296,0.218
"2352","149222",1995,2277,1006,1271,371,162,209,20.78,0.2078,0.163,0.127
"2353","149231",1995,1085,644,441,154,40,114,17.7,0.177,0.142,0.091
"2354","149772",1995,1538,757,781,392,168,224,29.59,0.2959,0.255,0.215
"2355","149781",1995,546,281,265,425,198,227,80.78,0.8078,0.778,0.747
"2356","150066",1995,498,298,200,169,59,110,36.91,0.3691,0.339,0.295
"2357","150136",1995,3855,2068,1787,787,262,525,25.39,0.2539,0.204,0.147
"2358","150145",1995,184,118,66,63,18,45,38.14,0.3814,0.342,0.273
"2359","150163",1995,847,510,337,409,145,264,51.76,0.5176,0.483,0.43
"2360","150400",1995,580,328,252,434,187,247,75.3,0.753,0.748,0.742
"2361","150534",1995,826,504,322,370,131,239,47.42,0.4742,0.448,0.407
"2362","150668",1995,213,111,102,104,40,64,57.66,0.5766,0.488,0.392
"2363","150941",1995,191,113,78,87,27,60,53.1,0.531,0.455,0.346
"2364","151102",1995,1063,577,486,43,14,29,5.03,0.0503,0.04,0.029
"2365","151111",1995,1860,1024,836,148,65,83,8.11,0.0811,0.08,0.078
"2366","151306",1995,1407,813,594,138,30,108,13.28,0.1328,0.098,0.051
"2367","151324",1995,1980,1032,948,350,132,218,21.12,0.2112,0.177,0.139
"2368","151333",1995,294,184,110,27,7,20,10.87,0.1087,0.092,0.064
"2369","151342",1995,626,374,252,51,19,32,8.56,0.0856,0.081,0.075
"2370","151351",1995,5705,3293,2412,3057,1182,1875,56.94,0.5694,0.536,0.49
"2371","151360",1995,599,383,216,42,13,29,7.57,0.0757,0.07,0.06
"2372","151379",1995,593,357,236,74,27,47,13.17,0.1317,0.125,0.114
"2373","151388",1995,242,144,98,12,5,7,4.86,0.0486,0.05,0.051
"2374","151777",1995,321,158,163,136,61,75,47.47,0.4747,0.424,0.374
"2375","151786",1995,255,168,87,90,28,62,36.9,0.369,0.353,0.322
"2376","152080",1995,1902,870,1032,1667,887,780,89.66,0.8966,0.876,0.859
"2377","152248",1995,906,487,419,71,21,50,10.27,0.1027,0.078,0.05
"2378","152363",1995,237,106,131,99,52,47,44.34,0.4434,0.418,0.397
"2379","152530",1995,419,224,195,270,112,158,70.54,0.7054,0.644,0.574
"2380","152600",1995,673,370,303,405,141,264,71.35,0.7135,0.602,0.465
"2381","153001",1995,352,167,185,168,71,97,58.08,0.5808,0.477,0.384
"2382","153108",1995,410,249,161,247,92,155,62.25,0.6225,0.602,0.571
"2383","153269",1995,734,435,299,365,144,221,50.8,0.508,0.497,0.482
"2384","153384",1995,307,168,139,238,106,132,78.57,0.7857,0.775,0.763
"2385","153603",1995,3274,1490,1784,822,341,481,32.28,0.3228,0.251,0.191
"2386","153834",1995,590,372,218,375,122,253,68.01,0.6801,0.636,0.56
"2387","154095",1995,2007,1244,763,604,170,434,34.89,0.3489,0.301,0.223
"2388","155089",1995,200,109,91,43,19,24,22.02,0.2202,0.215,0.209
"2389","155317",1995,3474,1857,1617,905,351,554,29.83,0.2983,0.261,0.217
"2390","155335",1995,118,74,44,23,6,17,22.97,0.2297,0.195,0.136
"2391","155399",1995,2877,1380,1497,558,219,339,24.57,0.2457,0.194,0.146
"2392","155520",1995,246,124,122,62,17,45,36.29,0.3629,0.252,0.139
"2393","155627",1995,137,44,93,21,9,12,27.27,0.2727,0.153,0.097
"2394","155937",1995,120,63,57,42,12,30,47.62,0.4762,0.35,0.211
"2395","156213",1995,298,180,118,140,65,75,41.67,0.4167,0.47,0.551
"2396","156286",1995,329,189,140,151,49,102,53.97,0.5397,0.459,0.35
"2397","156295",1995,416,220,196,146,64,82,37.27,0.3727,0.351,0.327
"2398","156365",1995,322,156,166,84,34,50,32.05,0.3205,0.261,0.205
"2399","156541",1995,377,204,173,107,33,74,36.27,0.3627,0.284,0.191
"2400","156745",1995,304,201,103,134,30,104,51.74,0.5174,0.441,0.291
"2401","157058",1995,370,189,181,13,10,3,1.59,0.0159,0.035,0.055
"2402","157076",1995,151,79,72,49,17,32,40.51,0.4051,0.325,0.236
"2403","157085",1995,2612,1383,1229,620,235,385,27.84,0.2784,0.237,0.191
"2404","157289",1995,1835,903,932,193,69,124,13.73,0.1373,0.105,0.074
"2405","157386",1995,1119,646,473,104,7,97,15.02,0.1502,0.093,0.015
"2406","157401",1995,1201,661,540,262,82,180,27.23,0.2723,0.218,0.152
"2407","157447",1995,1545,873,672,79,22,57,6.53,0.0653,0.051,0.033
"2408","157535",1995,227,154,73,34,8,26,16.88,0.1688,0.15,0.11
"2409","157951",1995,2454,1364,1090,496,159,337,24.71,0.2471,0.202,0.146
"2410","158477",1995,213,134,79,91,26,65,48.51,0.4851,0.427,0.329
"2411","159009",1995,1121,569,552,107,23,84,14.76,0.1476,0.095,0.042
"2412","159391",1995,3646,2007,1639,746,257,489,24.36,0.2436,0.205,0.157
"2413","159647",1995,1278,598,680,281,103,178,29.77,0.2977,0.22,0.151
"2414","159717",1995,1376,775,601,71,22,49,6.32,0.0632,0.052,0.037
"2415","159966",1995,1170,672,498,76,19,57,8.48,0.0848,0.065,0.038
"2416","160038",1995,1556,947,609,165,41,124,13.09,0.1309,0.106,0.067
"2417","160612",1995,2367,1387,980,94,21,73,5.26,0.0526,0.04,0.021
"2418","160621",1995,1846,991,855,101,21,80,8.07,0.0807,0.055,0.025
"2419","160658",1995,2609,1453,1156,110,24,86,5.92,0.0592,0.042,0.021
"2420","161004",1995,446,225,221,369,180,189,84,0.84,0.827,0.814
"2421","161226",1995,473,335,138,153,35,118,35.22,0.3522,0.323,0.254
"2422","161235",1995,74,34,40,6,2,4,11.76,0.1176,0.081,0.05
"2423","161244",1995,129,73,56,10,5,5,6.85,0.0685,0.078,0.089
"2424","161253",1995,1118,526,592,322,148,174,33.08,0.3308,0.288,0.25
"2425","161554",1995,620,358,262,66,23,43,12.01,0.1201,0.106,0.088
"2426","162007",1995,435,260,175,62,11,51,19.62,0.1962,0.143,0.063
"2427","162210",1995,137,84,53,24,9,15,17.86,0.1786,0.175,0.17
"2428","162283",1995,439,303,136,31,8,23,7.59,0.0759,0.071,0.059
"2429","162584",1995,909,433,476,194,68,126,29.1,0.291,0.213,0.143
"2430","162654",1995,277,193,84,154,41,113,58.55,0.5855,0.556,0.488
"2431","162760",1995,177,172,5,103,2,101,58.72,0.5872,0.582,0.4
"2432","162928",1995,873,332,541,683,401,282,84.94,0.8494,0.782,0.741
"2433","163046",1995,798,450,348,581,240,341,75.78,0.7578,0.728,0.69
"2434","163268",1995,968,485,483,295,115,180,37.11,0.3711,0.305,0.238
"2435","163286",1995,3577,1722,1855,1343,539,804,46.69,0.4669,0.375,0.291
"2436","163453",1995,959,580,379,166,30,136,23.45,0.2345,0.173,0.079
"2437","163462",1995,315,169,146,205,95,110,65.09,0.6509,0.651,0.651
"2438","163851",1995,642,412,230,322,101,221,53.64,0.5364,0.502,0.439
"2439","163912",1995,352,201,151,207,81,126,62.69,0.6269,0.588,0.536
"2440","164076",1995,1488,934,554,468,121,347,37.15,0.3715,0.315,0.218
"2441","164173",1995,253,180,73,94,26,68,37.78,0.3778,0.372,0.356
"2442","164216",1995,241,134,107,144,60,84,62.69,0.6269,0.598,0.561
"2443","164270",1995,316,163,153,206,80,126,77.3,0.773,0.652,0.523
"2444","164447",1995,260,104,156,84,37,47,45.19,0.4519,0.323,0.237
"2445","164492",1995,69,43,26,28,7,21,48.84,0.4884,0.406,0.269
"2446","164562",1995,446,262,184,295,119,176,67.18,0.6718,0.661,0.647
"2447","165015",1995,874,483,391,702,306,396,81.99,0.8199,0.803,0.783
"2448","165024",1995,1087,620,467,211,57,154,24.84,0.2484,0.194,0.122
"2449","165334",1995,505,318,187,311,103,208,65.41,0.6541,0.616,0.551
"2450","165662",1995,526,313,213,310,121,189,60.38,0.6038,0.589,0.568
"2451","165671",1995,100,100,0,43,0,43,43,0.43,0.43,NA
"2452","165820",1995,574,329,245,106,20,86,26.14,0.2614,0.185,0.082
"2453","165866",1995,600,404,196,122,28,94,23.27,0.2327,0.203,0.143
"2454","165936",1995,330,226,104,152,43,109,48.23,0.4823,0.461,0.413
"2455","166027",1995,1606,738,868,1343,705,638,86.45,0.8645,0.836,0.812
"2456","166124",1995,710,384,326,618,287,331,86.2,0.862,0.87,0.88
"2457","166513",1995,1102,422,680,195,90,105,24.88,0.2488,0.177,0.132
"2458","166629",1995,3959,1946,2013,1429,583,846,43.47,0.4347,0.361,0.29
"2459","166638",1995,502,222,280,38,17,21,9.46,0.0946,0.076,0.061
"2460","166683",1995,1115,468,647,921,517,404,86.32,0.8632,0.826,0.799
"2461","167288",1995,290,171,119,80,15,65,38.01,0.3801,0.276,0.126
"2462","167987",1995,886,420,466,253,90,163,38.81,0.3881,0.286,0.193
"2463","167996",1995,547,328,219,443,166,277,84.45,0.8445,0.81,0.758
"2464","168005",1995,386,214,172,110,39,71,33.18,0.3318,0.285,0.227
"2465","168148",1995,1147,594,553,944,439,505,85.02,0.8502,0.823,0.794
"2466","168254",1995,580,222,358,223,116,107,48.2,0.482,0.384,0.324
"2467","168281",1995,359,249,110,241,72,169,67.87,0.6787,0.671,0.655
"2468","168342",1995,524,243,281,453,237,216,88.89,0.8889,0.865,0.843
"2469","168546",1995,473,238,235,334,150,184,77.31,0.7731,0.706,0.638
"2470","168786",1995,241,139,102,69,28,41,29.5,0.295,0.286,0.275
"2471","169080",1995,1013,571,442,506,215,291,50.96,0.5096,0.5,0.486
"2472","169798",1995,2172,1230,942,198,65,133,10.81,0.1081,0.091,0.069
"2473","169910",1995,1893,752,1141,55,28,27,3.59,0.0359,0.029,0.025
"2474","170082",1995,1773,1087,686,287,95,192,17.66,0.1766,0.162,0.138
"2475","170301",1995,709,418,291,412,143,269,64.35,0.6435,0.581,0.491
"2476","170532",1995,350,197,153,221,90,131,66.5,0.665,0.631,0.588
"2477","170639",1995,593,281,312,80,39,41,14.59,0.1459,0.135,0.125
"2478","170976",1995,5265,2658,2607,3223,1428,1795,67.53,0.6753,0.612,0.548
"2479","171100",1995,6396,3546,2850,2076,693,1383,39,0.39,0.325,0.243
"2480","171128",1995,1072,285,787,218,134,84,29.47,0.2947,0.203,0.17
"2481","171137",1995,600,320,280,49,23,26,8.12,0.0812,0.082,0.082
"2482","171146",1995,263,169,94,116,45,71,42.01,0.4201,0.441,0.479
"2483","171599",1995,209,69,140,28,20,8,11.59,0.1159,0.134,0.143
"2484","172051",1995,752,412,340,40,14,26,6.31,0.0631,0.053,0.041
"2485","172699",1995,3165,1851,1314,524,148,376,20.31,0.2031,0.166,0.113
"2486","173160",1995,475,303,172,282,90,192,63.37,0.6337,0.594,0.523
"2487","173258",1995,463,232,231,393,191,202,87.07,0.8707,0.849,0.827
"2488","173328",1995,153,91,62,42,13,29,31.87,0.3187,0.275,0.21
"2489","173647",1995,690,380,310,478,196,282,74.21,0.7421,0.693,0.632
"2490","173902",1995,437,231,206,322,143,179,77.49,0.7749,0.737,0.694
"2491","174066",1995,4128,2100,2028,984,418,566,26.95,0.2695,0.238,0.206
"2492","174233",1995,1462,688,774,361,146,215,31.25,0.3125,0.247,0.189
"2493","174251",1995,503,297,206,202,66,136,45.79,0.4579,0.402,0.32
"2494","174491",1995,378,245,133,155,43,112,45.71,0.4571,0.41,0.323
"2495","174792",1995,430,0,430,286,286,0,NA,NA,0.665,0.665
"2496","174844",1995,742,431,311,557,223,334,77.49,0.7749,0.751,0.717
"2497","174899",1995,270,201,69,142,30,112,55.72,0.5572,0.526,0.435
"2498","174914",1995,852,454,398,430,181,249,54.85,0.5485,0.505,0.455
"2499","175342",1995,746,410,336,148,38,110,26.83,0.2683,0.198,0.113
"2500","175421",1995,112,67,45,39,13,26,38.81,0.3881,0.348,0.289
"2501","175616",1995,464,301,163,102,25,77,25.58,0.2558,0.22,0.153
"2502","175856",1995,1212,679,533,162,39,123,18.11,0.1811,0.134,0.073
"2503","175980",1995,261,128,133,180,74,106,82.81,0.8281,0.69,0.556
"2504","176017",1995,1526,825,701,490,180,310,37.58,0.3758,0.321,0.257
"2505","176035",1995,288,238,50,59,7,52,21.85,0.2185,0.205,0.14
"2506","176044",1995,448,244,204,87,23,64,26.23,0.2623,0.194,0.113
"2507","176080",1995,1826,845,981,382,158,224,26.51,0.2651,0.209,0.161
"2508","176406",1995,218,141,77,65,19,46,32.62,0.3262,0.298,0.247
"2509","176628",1995,101,61,40,31,11,20,32.79,0.3279,0.307,0.275
"2510","176947",1995,229,95,134,73,36,37,38.95,0.3895,0.319,0.269
"2511","176965",1995,1428,755,673,243,79,164,21.72,0.2172,0.17,0.117
"2512","177418",1995,143,110,33,51,11,40,36.36,0.3636,0.357,0.333
"2513","178059",1995,167,123,44,77,16,61,49.59,0.4959,0.461,0.364
"2514","178341",1995,720,359,361,77,37,40,11.14,0.1114,0.107,0.102
"2515","178387",1995,923,530,393,92,24,68,12.83,0.1283,0.1,0.061
"2516","178396",1995,3782,2099,1683,1210,420,790,37.64,0.3764,0.32,0.25
"2517","178402",1995,568,318,250,70,25,45,14.15,0.1415,0.123,0.1
"2518","178411",1995,804,190,614,121,75,46,24.21,0.2421,0.15,0.122
"2519","178420",1995,552,315,237,85,31,54,17.14,0.1714,0.154,0.131
"2520","178615",1995,1498,883,615,577,183,394,44.62,0.4462,0.385,0.298
"2521","179043",1995,288,161,127,174,74,100,62.11,0.6211,0.604,0.583
"2522","179159",1995,1055,604,451,501,195,306,50.66,0.5066,0.475,0.432
"2523","179557",1995,1385,824,561,334,90,244,29.61,0.2961,0.241,0.16
"2524","179566",1995,2479,1394,1085,440,156,284,20.37,0.2037,0.177,0.144
"2525","179867",1995,1180,608,572,911,411,500,82.24,0.8224,0.772,0.719
"2526","179894",1995,227,105,122,90,52,38,36.19,0.3619,0.396,0.426
"2527","179946",1995,190,88,102,91,47,44,50,0.5,0.479,0.461
"2528","180179",1995,384,255,129,12,2,10,3.92,0.0392,0.031,0.016
"2529","180461",1995,1744,714,1030,224,101,123,17.23,0.1723,0.128,0.098
"2530","180522",1995,192,99,93,38,16,22,22.22,0.2222,0.198,0.172
"2531","180984",1995,227,128,99,92,37,55,42.97,0.4297,0.405,0.374
"2532","181002",1995,746,441,305,421,157,264,59.86,0.5986,0.564,0.515
"2533","181020",1995,243,130,113,140,56,84,64.62,0.6462,0.576,0.496
"2534","181127",1995,271,134,137,117,44,73,54.48,0.5448,0.432,0.321
"2535","181215",1995,1306,729,577,138,46,92,12.62,0.1262,0.106,0.08
"2536","181394",1995,1123,607,516,64,20,44,7.25,0.0725,0.057,0.039
"2537","181446",1995,362,214,148,164,57,107,50,0.5,0.453,0.385
"2538","181464",1995,3891,1925,1966,620,256,364,18.91,0.1891,0.159,0.13
"2539","181534",1995,225,122,103,45,19,26,21.31,0.2131,0.2,0.184
"2540","181783",1995,722,382,340,146,45,101,26.44,0.2644,0.202,0.132
"2541","182281",1995,1324,748,576,161,54,107,14.3,0.143,0.122,0.094
"2542","182290",1995,1035,591,444,170,52,118,19.97,0.1997,0.164,0.117
"2543","182634",1995,240,154,86,115,46,69,44.81,0.4481,0.479,0.535
"2544","182795",1995,464,220,244,174,75,99,45,0.45,0.375,0.307
"2545","183062",1995,988,588,400,251,86,165,28.06,0.2806,0.254,0.215
"2546","183080",1995,872,426,446,204,80,124,29.11,0.2911,0.234,0.179
"2547","183239",1995,612,369,243,424,163,261,70.73,0.7073,0.693,0.671
"2548","183822",1995,275,196,79,40,11,29,14.8,0.148,0.145,0.139
"2549","183974",1995,73,53,20,19,3,16,30.19,0.3019,0.26,0.15
"2550","184348",1995,433,255,178,312,122,190,74.51,0.7451,0.721,0.685
"2551","184603",1995,781,396,385,128,57,71,17.93,0.1793,0.164,0.148
"2552","184612",1995,87,70,17,18,9,9,12.86,0.1286,0.207,0.529
"2553","184782",1995,927,516,411,226,69,157,30.43,0.3043,0.244,0.168
"2554","185129",1995,457,246,211,40,11,29,11.79,0.1179,0.088,0.052
"2555","185572",1995,764,412,352,234,82,152,36.89,0.3689,0.306,0.233
"2556","185590",1995,1068,651,417,216,69,147,22.58,0.2258,0.202,0.165
"2557","185828",1995,552,131,421,60,35,25,19.08,0.1908,0.109,0.083
"2558","186131",1995,1207,569,638,1105,579,526,92.44,0.9244,0.915,0.908
"2559","186201",1995,319,190,129,67,20,47,24.74,0.2474,0.21,0.155
"2560","186283",1995,612,329,283,242,103,139,42.25,0.4225,0.395,0.364
"2561","186584",1995,955,527,428,371,145,226,42.88,0.4288,0.388,0.339
"2562","186876",1995,726,438,288,258,86,172,39.27,0.3927,0.355,0.299
"2563","187134",1995,1087,670,417,638,212,426,63.58,0.6358,0.587,0.508
"2564","187444",1995,831,476,355,87,23,64,13.45,0.1345,0.105,0.065
"2565","187985",1995,1712,956,756,221,76,145,15.17,0.1517,0.129,0.101
"2566","188030",1995,1419,726,693,146,51,95,13.09,0.1309,0.103,0.074
"2567","188429",1995,370,212,158,140,52,88,41.51,0.4151,0.378,0.329
"2568","188641",1995,326,158,168,153,56,97,61.39,0.6139,0.469,0.333
"2569","190044",1995,645,170,475,305,221,84,49.41,0.4941,0.473,0.465
"2570","190099",1995,722,361,361,604,290,314,86.98,0.8698,0.837,0.803
"2571","190150",1995,1157,505,652,918,501,417,82.57,0.8257,0.793,0.768
"2572","190248",1995,118,63,55,29,13,16,25.4,0.254,0.246,0.236
"2573","190415",1995,2070,842,1228,1625,931,694,82.42,0.8242,0.785,0.758
"2574","190512",1995,1445,839,606,149,55,94,11.2,0.112,0.103,0.091
"2575","190549",1995,1167,685,482,182,60,122,17.81,0.1781,0.156,0.124
"2576","190558",1995,1426,728,698,33,17,16,2.2,0.022,0.023,0.024
"2577","190567",1995,865,449,416,31,18,13,2.9,0.029,0.036,0.043
"2578","190594",1995,1091,807,284,82,13,69,8.55,0.0855,0.075,0.046
"2579","190637",1995,506,345,161,32,7,25,7.25,0.0725,0.063,0.043
"2580","190664",1995,1444,805,639,228,81,147,18.26,0.1826,0.158,0.127
"2581","190691",1995,486,294,192,22,7,15,5.1,0.051,0.045,0.036
"2582","190725",1995,398,269,129,77,20,57,21.19,0.2119,0.193,0.155
"2583","191241",1995,1120,620,500,794,323,471,75.97,0.7597,0.709,0.646
"2584","191515",1995,488,237,251,392,194,198,83.54,0.8354,0.803,0.773
"2585","191533",1995,453,229,224,227,88,139,60.7,0.607,0.501,0.393
"2586","191630",1995,458,244,214,318,137,181,74.18,0.7418,0.694,0.64
"2587","191649",1995,1518,830,688,559,201,358,43.13,0.4313,0.368,0.292
"2588","191676",1995,293,213,80,171,52,119,55.87,0.5587,0.584,0.65
"2589","191931",1995,609,288,321,203,73,130,45.14,0.4514,0.333,0.227
"2590","191968",1995,1625,878,747,1052,440,612,69.7,0.697,0.647,0.589
"2591","192192",1995,200,154,46,69,10,59,38.31,0.3831,0.345,0.217
"2592","192323",1995,397,236,161,258,98,160,67.8,0.678,0.65,0.609
"2593","192439",1995,1043,700,343,55,17,38,5.43,0.0543,0.053,0.05
"2594","192703",1995,572,256,316,321,160,161,62.89,0.6289,0.561,0.506
"2595","192749",1995,161,115,46,87,18,69,60,0.6,0.54,0.391
"2596","192819",1995,926,527,399,472,181,291,55.22,0.5522,0.51,0.454
"2597","192925",1995,78,50,28,15,5,10,20,0.2,0.192,0.179
"2598","193016",1995,1002,623,379,4,2,2,0.32,0.0032,0.004,0.005
"2599","193292",1995,135,108,27,30,5,25,23.15,0.2315,0.222,0.185
"2600","193353",1995,258,196,62,114,24,90,45.92,0.4592,0.442,0.387
"2601","193399",1995,217,164,53,107,27,80,48.78,0.4878,0.493,0.509
"2602","193584",1995,302,227,75,182,36,146,64.32,0.6432,0.603,0.48
"2603","193645",1995,718,595,123,120,13,107,17.98,0.1798,0.167,0.106
"2604","193654",1995,445,275,170,178,54,124,45.09,0.4509,0.4,0.318
"2605","193900",1995,3156,1851,1305,1652,681,971,52.46,0.5246,0.523,0.522
"2606","193973",1995,424,264,160,204,67,137,51.89,0.5189,0.481,0.419
"2607","194161",1995,160,92,68,56,21,35,38.04,0.3804,0.35,0.309
"2608","194310",1995,1139,681,458,420,139,281,41.26,0.4126,0.369,0.303
"2609","194824",1995,962,243,719,425,296,129,53.09,0.5309,0.442,0.412
"2610","195003",1995,1634,502,1132,621,379,242,48.21,0.4821,0.38,0.335
"2611","195030",1995,1205,583,622,751,354,397,68.1,0.681,0.623,0.569
"2612","195164",1995,547,278,269,285,127,158,56.83,0.5683,0.521,0.472
"2613","195173",1995,281,145,136,89,48,41,28.28,0.2828,0.317,0.353
"2614","195216",1995,571,287,284,382,176,206,71.78,0.7178,0.669,0.62
"2615","195234",1995,248,170,78,111,34,77,45.29,0.4529,0.448,0.436
"2616","195243",1995,276,162,114,74,22,52,32.1,0.321,0.268,0.193
"2617","195304",1995,233,183,50,118,29,89,48.63,0.4863,0.506,0.58
"2618","195474",1995,590,317,273,393,182,211,66.56,0.6656,0.666,0.667
"2619","195526",1995,606,373,233,438,152,286,76.68,0.7668,0.723,0.652
"2620","195544",1995,84,64,20,56,9,47,73.44,0.7344,0.667,0.45
"2621","195809",1995,2206,1181,1025,629,234,395,33.45,0.3345,0.285,0.228
"2622","196413",1995,2392,1259,1133,1467,631,836,66.4,0.664,0.613,0.557
"2623","196592",1995,1899,1266,633,136,70,66,5.21,0.0521,0.072,0.111
"2624","197045",1995,255,162,93,100,27,73,45.06,0.4506,0.392,0.29
"2625","197133",1995,632,381,251,509,193,316,82.94,0.8294,0.805,0.769
"2626","197869",1995,2205,1198,1007,749,273,476,39.73,0.3973,0.34,0.271
"2627","197984",1995,114,45,69,47,26,21,46.67,0.4667,0.412,0.377
"2628","198385",1995,429,209,220,373,186,187,89.47,0.8947,0.869,0.845
"2629","198464",1995,2635,1550,1085,630,189,441,28.45,0.2845,0.239,0.174
"2630","198507",1995,381,222,159,162,47,115,51.8,0.518,0.425,0.296
"2631","198516",1995,907,545,362,548,198,350,64.22,0.6422,0.604,0.547
"2632","198835",1995,287,157,130,132,47,85,54.14,0.5414,0.46,0.362
"2633","198969",1995,370,121,249,67,37,30,24.79,0.2479,0.181,0.149
"2634","199102",1995,1396,706,690,339,117,222,31.44,0.3144,0.243,0.17
"2635","199111",1995,393,235,158,123,35,88,37.45,0.3745,0.313,0.222
"2636","199120",1995,3229,1982,1247,2101,732,1369,69.07,0.6907,0.651,0.587
"2637","199139",1995,1663,974,689,396,115,281,28.85,0.2885,0.238,0.167
"2638","199148",1995,1804,1234,570,376,77,299,24.23,0.2423,0.208,0.135
"2639","199157",1995,510,309,201,139,34,105,33.98,0.3398,0.273,0.169
"2640","199193",1995,3607,1523,2084,900,395,505,33.16,0.3316,0.25,0.19
"2641","199218",1995,1370,863,507,463,133,330,38.24,0.3824,0.338,0.262
"2642","199281",1995,410,199,211,81,34,47,23.62,0.2362,0.198,0.161
"2643","199306",1995,146,66,80,31,10,21,31.82,0.3182,0.212,0.125
"2644","199412",1995,146,110,36,72,19,53,48.18,0.4818,0.493,0.528
"2645","199582",1995,385,203,182,61,17,44,21.67,0.2167,0.158,0.093
"2646","199643",1995,518,305,213,127,29,98,32.13,0.3213,0.245,0.136
"2647","199847",1995,962,458,504,720,357,363,79.26,0.7926,0.748,0.708
"2648","199962",1995,334,157,177,113,45,68,43.31,0.4331,0.338,0.254
"2649","199999",1995,446,298,148,121,32,89,29.87,0.2987,0.271,0.216
"2650","200004",1995,1156,608,548,259,78,181,29.77,0.2977,0.224,0.142
"2651","200059",1995,296,140,156,27,10,17,12.14,0.1214,0.091,0.064
"2652","200156",1995,289,144,145,89,32,57,39.58,0.3958,0.308,0.221
"2653","200217",1995,412,234,178,115,32,83,35.47,0.3547,0.279,0.18
"2654","200226",1995,193,80,113,25,10,15,18.75,0.1875,0.13,0.088
"2655","200253",1995,525,322,203,36,11,25,7.76,0.0776,0.069,0.054
"2656","200280",1995,1407,665,742,190,81,109,16.39,0.1639,0.135,0.109
"2657","200332",1995,1482,661,821,189,87,102,15.43,0.1543,0.128,0.106
"2658","200572",1995,166,80,86,32,11,21,26.25,0.2625,0.193,0.128
"2659","201104",1995,549,269,280,214,67,147,54.65,0.5465,0.39,0.239
"2660","201371",1995,248,163,85,125,39,86,52.76,0.5276,0.504,0.459
"2661","201548",1995,474,296,178,306,108,198,66.89,0.6689,0.646,0.607
"2662","201645",1995,729,275,454,388,205,183,66.55,0.6655,0.532,0.452
"2663","201690",1995,597,262,335,25,5,20,7.63,0.0763,0.042,0.015
"2664","202134",1995,856,463,393,71,26,45,9.72,0.0972,0.083,0.066
"2665","202480",1995,1610,836,774,890,342,548,65.55,0.6555,0.553,0.442
"2666","202523",1995,701,357,344,488,221,267,74.79,0.7479,0.696,0.642
"2667","202763",1995,591,306,285,205,78,127,41.5,0.415,0.347,0.274
"2668","203085",1995,220,87,133,94,46,48,55.17,0.5517,0.427,0.346
"2669","203128",1995,217,119,98,124,47,77,64.71,0.6471,0.571,0.48
"2670","203368",1995,844,424,420,587,257,330,77.83,0.7783,0.695,0.612
"2671","203517",1995,2623,1580,1043,353,85,268,16.96,0.1696,0.135,0.081
"2672","203535",1995,438,223,215,350,161,189,84.75,0.8475,0.799,0.749
"2673","203580",1995,66,50,16,26,5,21,42,0.42,0.394,0.312
"2674","203775",1995,408,261,147,131,39,92,35.25,0.3525,0.321,0.265
"2675","203845",1995,292,120,172,124,51,73,60.83,0.6083,0.425,0.297
"2676","204024",1995,3211,1817,1394,1990,750,1240,68.24,0.6824,0.62,0.538
"2677","204185",1995,478,229,249,248,107,141,61.57,0.6157,0.519,0.43
"2678","204194",1995,379,228,151,121,51,70,30.7,0.307,0.319,0.338
"2679","204617",1995,172,110,62,46,12,34,30.91,0.3091,0.267,0.194
"2680","204796",1995,5788,2951,2837,1354,478,876,29.68,0.2968,0.234,0.168
"2681","204857",1995,3358,1939,1419,1459,479,980,50.54,0.5054,0.434,0.338
"2682","206330",1995,213,87,126,28,12,16,18.39,0.1839,0.131,0.095
"2683","206589",1995,433,228,205,347,147,200,87.72,0.8772,0.801,0.717
"2684","206604",1995,1910,1033,877,214,68,146,14.13,0.1413,0.112,0.078
"2685","206622",1995,698,396,302,394,177,217,54.8,0.548,0.564,0.586
"2686","206695",1995,1905,1004,901,208,85,123,12.25,0.1225,0.109,0.094
"2687","206914",1995,620,358,262,61,26,35,9.78,0.0978,0.098,0.099
"2688","207209",1995,485,220,265,24,7,17,7.73,0.0773,0.049,0.026
"2689","207306",1995,240,127,113,39,11,28,22.05,0.2205,0.162,0.097
"2690","207324",1995,320,158,162,78,28,50,31.65,0.3165,0.244,0.173
"2691","207388",1995,2362,1185,1177,475,186,289,24.39,0.2439,0.201,0.158
"2692","207500",1995,2712,1321,1391,519,191,328,24.83,0.2483,0.191,0.137
"2693","207722",1995,259,164,95,33,6,27,16.46,0.1646,0.127,0.063
"2694","207847",1995,570,282,288,91,48,43,15.25,0.1525,0.16,0.167
"2695","207865",1995,769,470,299,123,34,89,18.94,0.1894,0.16,0.114
"2696","208822",1995,347,232,115,162,54,108,46.55,0.4655,0.467,0.47
"2697","209056",1995,455,280,175,228,85,143,51.07,0.5107,0.501,0.486
"2698","209065",1995,438,260,178,276,105,171,65.77,0.6577,0.63,0.59
"2699","209542",1995,2018,965,1053,561,194,367,38.03,0.3803,0.278,0.184
"2700","209551",1995,2583,1429,1154,950,329,621,43.46,0.4346,0.368,0.285
"2701","209612",1995,242,153,89,108,33,75,49.02,0.4902,0.446,0.371
"2702","209807",1995,682,358,324,82,29,53,14.8,0.148,0.12,0.09
"2703","209922",1995,352,188,164,166,78,88,46.81,0.4681,0.472,0.476
"2704","210146",1995,661,362,299,89,33,56,15.47,0.1547,0.135,0.11
"2705","210401",1995,432,248,184,330,132,198,79.84,0.7984,0.764,0.717
"2706","210429",1995,641,380,261,95,22,73,19.21,0.1921,0.148,0.084
"2707","210571",1995,312,153,159,169,66,103,67.32,0.6732,0.542,0.415
"2708","210669",1995,564,284,280,353,162,191,67.25,0.6725,0.626,0.579
"2709","210775",1995,150,76,74,46,14,32,42.11,0.4211,0.307,0.189
"2710","211088",1995,257,186,71,145,36,109,58.6,0.586,0.564,0.507
"2711","211158",1995,1054,689,365,372,88,284,41.22,0.4122,0.353,0.241
"2712","211291",1995,910,474,436,736,342,394,83.12,0.8312,0.809,0.784
"2713","211352",1995,218,150,68,110,25,85,56.67,0.5667,0.505,0.368
"2714","211361",1995,892,465,427,124,45,79,16.99,0.1699,0.139,0.105
"2715","211431",1995,125,122,3,57,2,55,45.08,0.4508,0.456,0.667
"2716","211440",1995,1233,376,857,772,515,257,68.35,0.6835,0.626,0.601
"2717","211468",1995,164,164,0,90,0,90,54.88,0.5488,0.549,NA
"2718","211556",1995,109,109,0,48,0,48,44.04,0.4404,0.44,NA
"2719","211583",1995,83,83,0,53,0,53,63.86,0.6386,0.639,NA
"2720","211608",1995,256,131,125,20,5,15,11.45,0.1145,0.078,0.04
"2721","211644",1995,1241,768,473,210,46,164,21.35,0.2135,0.169,0.097
"2722","211981",1995,384,193,191,138,45,93,48.19,0.4819,0.359,0.236
"2723","212009",1995,520,286,234,393,174,219,76.57,0.7657,0.756,0.744
"2724","212054",1995,935,341,594,111,40,71,20.82,0.2082,0.119,0.067
"2725","212106",1995,1215,703,512,523,193,330,46.94,0.4694,0.43,0.377
"2726","212115",1995,820,457,363,169,45,124,27.13,0.2713,0.206,0.124
"2727","212133",1995,226,171,55,103,21,82,47.95,0.4795,0.456,0.382
"2728","212160",1995,1332,763,569,213,69,144,18.87,0.1887,0.16,0.121
"2729","212197",1995,434,307,127,282,72,210,68.4,0.684,0.65,0.567
"2730","212577",1995,498,234,264,372,179,193,82.48,0.8248,0.747,0.678
"2731","212601",1995,394,225,169,174,73,101,44.89,0.4489,0.442,0.432
"2732","212832",1995,40,35,5,16,0,16,45.71,0.4571,0.4,0
"2733","212911",1995,306,162,144,269,126,143,88.27,0.8827,0.879,0.875
"2734","213020",1995,2661,1552,1109,652,187,465,29.96,0.2996,0.245,0.169
"2735","213251",1995,282,175,107,196,73,123,70.29,0.7029,0.695,0.682
"2736","213321",1995,426,180,246,247,126,121,67.22,0.6722,0.58,0.512
"2737","213349",1995,1229,715,514,192,52,140,19.58,0.1958,0.156,0.101
"2738","213358",1995,147,85,62,37,9,28,32.94,0.3294,0.252,0.145
"2739","213367",1995,741,438,303,404,140,264,60.27,0.6027,0.545,0.462
"2740","213385",1995,525,241,284,415,208,207,85.89,0.8589,0.79,0.732
"2741","213507",1995,297,155,142,183,79,104,67.1,0.671,0.616,0.556
"2742","213543",1995,1045,412,633,734,404,330,80.1,0.801,0.702,0.638
"2743","213613",1995,693,359,334,133,43,90,25.07,0.2507,0.192,0.129
"2744","213668",1995,366,210,156,237,82,155,73.81,0.7381,0.648,0.526
"2745","213783",1995,577,340,237,135,41,94,27.65,0.2765,0.234,0.173
"2746","213826",1995,245,193,52,99,13,86,44.56,0.4456,0.404,0.25
"2747","213996",1995,671,416,255,428,163,265,63.7,0.637,0.638,0.639
"2748","214041",1995,1157,700,457,389,132,257,36.71,0.3671,0.336,0.289
"2749","214069",1995,280,204,76,88,28,60,29.41,0.2941,0.314,0.368
"2750","214157",1995,319,169,150,217,97,120,71.01,0.7101,0.68,0.647
"2751","214175",1995,486,277,209,392,161,231,83.39,0.8339,0.807,0.77
"2752","214272",1995,159,114,45,15,5,10,8.77,0.0877,0.094,0.111
"2753","214777",1995,5400,2712,2688,2410,947,1463,53.95,0.5395,0.446,0.352
"2754","215062",1995,2349,1158,1191,1954,952,1002,86.53,0.8653,0.832,0.799
"2755","215743",1995,334,145,189,135,61,74,51.03,0.5103,0.404,0.323
"2756","215798",1995,260,129,131,161,72,89,68.99,0.6899,0.619,0.55
"2757","215929",1995,907,515,392,590,261,329,63.88,0.6388,0.65,0.666
"2758","216010",1995,1278,665,613,497,188,309,46.47,0.4647,0.389,0.307
"2759","216038",1995,1279,715,564,254,82,172,24.06,0.2406,0.199,0.145
"2760","216287",1995,354,190,164,308,134,174,91.58,0.9158,0.87,0.817
"2761","216339",1995,2302,1366,936,440,143,297,21.74,0.2174,0.191,0.153
"2762","216524",1995,315,170,145,230,106,124,72.94,0.7294,0.73,0.731
"2763","216694",1995,295,141,154,109,46,63,44.68,0.4468,0.369,0.299
"2764","216764",1995,1384,873,511,363,85,278,31.84,0.3184,0.262,0.166
"2765","216807",1995,376,230,146,250,86,164,71.3,0.713,0.665,0.589
"2766","216852",1995,421,175,246,141,64,77,44,0.44,0.335,0.26
"2767","216931",1995,369,167,202,118,60,58,34.73,0.3473,0.32,0.297
"2768","217059",1995,851,483,368,350,121,229,47.41,0.4741,0.411,0.329
"2769","217156",1995,1370,739,631,1106,492,614,83.09,0.8309,0.807,0.78
"2770","217402",1995,954,589,365,795,297,498,84.55,0.8455,0.833,0.814
"2771","217536",1995,354,258,96,190,49,141,54.65,0.5465,0.537,0.51
"2772","217776",1995,69,32,37,11,3,8,25,0.25,0.159,0.081
"2773","217819",1995,1748,1190,558,596,136,460,38.66,0.3866,0.341,0.244
"2774","217882",1995,2556,1255,1301,905,319,586,46.69,0.4669,0.354,0.245
"2775","217998",1995,143,77,66,93,42,51,66.23,0.6623,0.65,0.636
"2776","218061",1995,757,405,352,140,43,97,23.95,0.2395,0.185,0.122
"2777","218229",1995,477,301,176,155,46,109,36.21,0.3621,0.325,0.261
"2778","218238",1995,164,82,82,40,18,22,26.83,0.2683,0.244,0.22
"2779","218399",1995,241,167,74,35,8,27,16.17,0.1617,0.145,0.108
"2780","218414",1995,166,70,96,50,19,31,44.29,0.4429,0.301,0.198
"2781","218663",1995,2593,1477,1116,799,282,517,35,0.35,0.308,0.253
"2782","218724",1995,734,411,323,117,27,90,21.9,0.219,0.159,0.084
"2783","218733",1995,859,447,412,279,100,179,40.04,0.4004,0.325,0.243
"2784","218742",1995,427,264,163,66,15,51,19.32,0.1932,0.155,0.092
"2785","218973",1995,286,140,146,219,99,120,85.71,0.8571,0.766,0.678
"2786","219000",1995,372,242,130,168,52,116,47.93,0.4793,0.452,0.4
"2787","219046",1995,435,234,201,33,8,25,10.68,0.1068,0.076,0.04
"2788","219082",1995,256,125,131,22,5,17,13.6,0.136,0.086,0.038
"2789","219198",1995,95,62,33,27,11,16,25.81,0.2581,0.284,0.333
"2790","219259",1995,574,343,231,75,19,56,16.33,0.1633,0.131,0.082
"2791","219356",1995,1659,813,846,359,135,224,27.55,0.2755,0.216,0.16
"2792","219471",1995,1160,660,500,224,60,164,24.85,0.2485,0.193,0.12
"2793","219602",1995,776,457,319,105,26,79,17.29,0.1729,0.135,0.082
"2794","219709",1995,347,221,126,14,3,11,4.98,0.0498,0.04,0.024
"2795","219718",1995,149,52,97,17,5,12,23.08,0.2308,0.114,0.052
"2796","219949",1995,171,64,107,38,17,21,32.81,0.3281,0.222,0.159
"2797","220075",1995,1505,867,638,178,59,119,13.73,0.1373,0.118,0.092
"2798","220215",1995,294,170,124,90,37,53,31.18,0.3118,0.306,0.298
"2799","220613",1995,493,287,206,115,37,78,27.18,0.2718,0.233,0.18
"2800","220631",1995,204,131,73,31,9,22,16.79,0.1679,0.152,0.123
"2801","220710",1995,217,106,111,86,32,54,50.94,0.5094,0.396,0.288
"2802","221351",1995,373,204,169,256,105,151,74.02,0.7402,0.686,0.621
"2803","221519",1995,370,197,173,275,120,155,78.68,0.7868,0.743,0.694
"2804","221731",1995,90,49,41,29,7,22,44.9,0.449,0.322,0.171
"2805","221847",1995,1113,513,600,130,37,93,18.13,0.1813,0.117,0.062
"2806","221892",1995,214,113,101,43,14,29,25.66,0.2566,0.201,0.139
"2807","222178",1995,917,506,411,250,93,157,31.03,0.3103,0.273,0.226
"2808","222983",1995,293,155,138,195,90,105,67.74,0.6774,0.666,0.652
"2809","223232",1995,2329,1390,939,1004,337,667,47.99,0.4799,0.431,0.359
"2810","224004",1995,90,55,35,18,5,13,23.64,0.2364,0.2,0.143
"2811","224323",1995,244,146,98,134,58,76,52.05,0.5205,0.549,0.592
"2812","225432",1995,624,351,273,10,3,7,1.99,0.0199,0.016,0.011
"2813","225548",1995,325,170,155,82,28,54,31.76,0.3176,0.252,0.181
"2814","225627",1995,370,259,111,50,11,39,15.06,0.1506,0.135,0.099
"2815","226231",1995,218,66,152,68,42,26,39.39,0.3939,0.312,0.276
"2816","226833",1995,578,276,302,49,16,33,11.96,0.1196,0.085,0.053
"2817","227216",1995,2134,1180,954,201,50,151,12.8,0.128,0.094,0.052
"2818","227331",1995,258,189,69,34,8,26,13.76,0.1376,0.132,0.116
"2819","227526",1995,1114,536,578,105,29,76,14.18,0.1418,0.094,0.05
"2820","227757",1995,688,338,350,472,213,259,76.63,0.7663,0.686,0.609
"2821","227845",1995,387,230,157,119,37,82,35.65,0.3565,0.307,0.236
"2822","227863",1995,232,145,87,58,17,41,28.28,0.2828,0.25,0.195
"2823","228042",1995,221,107,114,35,15,20,18.69,0.1869,0.158,0.132
"2824","228149",1995,452,254,198,123,34,89,35.04,0.3504,0.272,0.172
"2825","228246",1995,1228,662,566,743,287,456,68.88,0.6888,0.605,0.507
"2826","228343",1995,326,188,138,188,69,119,63.3,0.633,0.577,0.5
"2827","228431",1995,1714,986,728,275,69,206,20.89,0.2089,0.16,0.095
"2828","228459",1995,2426,1461,965,309,80,229,15.67,0.1567,0.127,0.083
"2829","228501",1995,393,140,253,34,16,18,12.86,0.1286,0.087,0.063
"2830","228529",1995,1021,531,490,140,52,88,16.57,0.1657,0.137,0.106
"2831","228705",1995,893,420,473,40,17,23,5.48,0.0548,0.045,0.036
"2832","228723",1995,5985,2986,2999,1643,498,1145,38.35,0.3835,0.275,0.166
"2833","228769",1995,1243,623,620,117,47,70,11.24,0.1124,0.094,0.076
"2834","228778",1995,6212,3139,3073,2207,865,1342,42.75,0.4275,0.355,0.281
"2835","228787",1995,351,154,197,113,45,68,44.16,0.4416,0.322,0.228
"2836","228796",1995,1618,887,731,36,12,24,2.71,0.0271,0.022,0.016
"2837","228875",1995,1325,813,512,511,146,365,44.9,0.449,0.386,0.285
"2838","228981",1995,213,142,71,78,20,58,40.85,0.4085,0.366,0.282
"2839","229018",1995,100,61,39,10,3,7,11.48,0.1148,0.1,0.077
"2840","229027",1995,1528,821,707,79,20,59,7.19,0.0719,0.052,0.028
"2841","229115",1995,3461,1764,1697,747,260,487,27.61,0.2761,0.216,0.153
"2842","229780",1995,167,102,65,26,7,19,18.63,0.1863,0.156,0.108
"2843","229814",1995,901,506,395,108,35,73,14.43,0.1443,0.12,0.089
"2844","230603",1995,643,471,172,90,16,74,15.71,0.1571,0.14,0.093
"2845","230728",1995,1175,803,372,251,43,208,25.9,0.259,0.214,0.116
"2846","230764",1995,1356,837,519,284,73,211,25.21,0.2521,0.209,0.141
"2847","230782",1995,1338,889,449,109,23,86,9.67,0.0967,0.081,0.051
"2848","231059",1995,529,301,228,383,160,223,74.09,0.7409,0.724,0.702
"2849","231174",1995,1853,1037,816,853,338,515,49.66,0.4966,0.46,0.414
"2850","231420",1995,147,79,68,35,13,22,27.85,0.2785,0.238,0.191
"2851","231554",1995,139,68,71,47,22,25,36.76,0.3676,0.338,0.31
"2852","231624",1995,1369,850,519,1086,378,708,83.29,0.8329,0.793,0.728
"2853","231712",1995,534,320,214,59,18,41,12.81,0.1281,0.11,0.084
"2854","232025",1995,221,107,114,103,47,56,52.34,0.5234,0.466,0.412
"2855","232043",1995,206,144,62,96,27,69,47.92,0.4792,0.466,0.435
"2856","232089",1995,297,109,188,66,28,38,34.86,0.3486,0.222,0.149
"2857","232186",1995,1852,1065,787,486,145,341,32.02,0.3202,0.262,0.184
"2858","232265",1995,1272,780,492,418,98,320,41.03,0.4103,0.329,0.199
"2859","232423",1995,2537,1484,1053,1548,523,1025,69.07,0.6907,0.61,0.497
"2860","232557",1995,1165,600,565,224,70,154,25.67,0.2567,0.192,0.124
"2861","232566",1995,671,445,226,283,57,226,50.79,0.5079,0.422,0.252
"2862","232609",1995,262,181,81,142,42,100,55.25,0.5525,0.542,0.519
"2863","232681",1995,758,497,261,443,138,305,61.37,0.6137,0.584,0.529
"2864","232706",1995,167,122,45,82,22,60,49.18,0.4918,0.491,0.489
"2865","232937",1995,1257,706,551,91,24,67,9.49,0.0949,0.072,0.044
"2866","232982",1995,1514,827,687,149,30,119,14.39,0.1439,0.098,0.044
"2867","233277",1995,1381,833,548,425,121,304,36.49,0.3649,0.308,0.221
"2868","233374",1995,762,398,364,581,251,330,82.91,0.8291,0.762,0.69
"2869","233426",1995,431,247,184,223,77,146,59.11,0.5911,0.517,0.418
"2870","233541",1995,212,118,94,53,16,37,31.36,0.3136,0.25,0.17
"2871","233897",1995,269,141,128,67,27,40,28.37,0.2837,0.249,0.211
"2872","233921",1995,4687,2050,2637,1819,745,1074,52.39,0.5239,0.388,0.283
"2873","234030",1995,1655,963,692,320,104,216,22.43,0.2243,0.193,0.15
"2874","234085",1995,335,0,335,182,182,0,NA,NA,0.543,0.543
"2875","234155",1995,734,431,303,131,35,96,22.27,0.2227,0.178,0.116
"2876","234164",1995,441,234,207,2,0,2,0.85,0.0085,0.005,0
"2877","235097",1995,687,464,223,109,18,91,19.61,0.1961,0.159,0.081
"2878","235167",1995,536,318,218,224,88,136,42.77,0.4277,0.418,0.404
"2879","236230",1995,667,394,273,264,81,183,46.45,0.4645,0.396,0.297
"2880","236328",1995,656,374,282,404,162,242,64.71,0.6471,0.616,0.574
"2881","236577",1995,397,254,143,138,58,80,31.5,0.315,0.348,0.406
"2882","236595",1995,426,245,181,165,56,109,44.49,0.4449,0.387,0.309
"2883","236896",1995,288,145,143,57,22,35,24.14,0.2414,0.198,0.154
"2884","236939",1995,2512,1217,1295,734,315,419,34.43,0.3443,0.292,0.243
"2885","236948",1995,3500,1783,1717,1405,562,843,47.28,0.4728,0.401,0.327
"2886","237011",1995,1745,1105,640,457,120,337,30.5,0.305,0.262,0.188
"2887","237057",1995,369,189,180,247,119,128,67.72,0.6772,0.669,0.661
"2888","237066",1995,395,229,166,198,73,125,54.59,0.5459,0.501,0.44
"2889","237215",1995,416,243,173,8,5,3,1.23,0.0123,0.019,0.029
"2890","237330",1995,542,282,260,148,62,86,30.5,0.305,0.273,0.238
"2891","237358",1995,180,101,79,35,13,22,21.78,0.2178,0.194,0.165
"2892","237367",1995,1123,618,505,96,36,60,9.71,0.0971,0.085,0.071
"2893","237792",1995,598,333,265,74,20,54,16.22,0.1622,0.124,0.075
"2894","237899",1995,572,292,280,28,13,15,5.14,0.0514,0.049,0.046
"2895","237932",1995,509,273,236,108,27,81,29.67,0.2967,0.212,0.114
"2896","237969",1995,453,240,213,200,77,123,51.25,0.5125,0.442,0.362
"2897","238032",1995,2938,1457,1481,783,324,459,31.5,0.315,0.267,0.219
"2898","238333",1995,291,163,128,187,74,113,69.33,0.6933,0.643,0.578
"2899","238430",1995,139,93,46,20,3,17,18.28,0.1828,0.144,0.065
"2900","238458",1995,429,296,133,202,41,161,54.39,0.5439,0.471,0.308
"2901","238476",1995,395,175,220,190,89,101,57.71,0.5771,0.481,0.405
"2902","238616",1995,234,132,102,59,21,38,28.79,0.2879,0.252,0.206
"2903","238661",1995,231,155,76,44,10,34,21.94,0.2194,0.19,0.132
"2904","239080",1995,184,117,67,44,15,29,24.79,0.2479,0.239,0.224
"2905","239105",1995,1627,883,744,870,327,543,61.49,0.6149,0.535,0.44
"2906","239628",1995,184,101,83,99,42,57,56.44,0.5644,0.538,0.506
"2907","239716",1995,520,296,224,319,112,207,69.93,0.6993,0.613,0.5
"2908","240107",1995,335,224,111,92,24,68,30.36,0.3036,0.275,0.216
"2909","240189",1995,1856,989,867,294,108,186,18.81,0.1881,0.158,0.125
"2910","240277",1995,780,522,258,98,30,68,13.03,0.1303,0.126,0.116
"2911","240329",1995,1731,1035,696,324,104,220,21.26,0.2126,0.187,0.149
"2912","240338",1995,109,63,46,51,18,33,52.38,0.5238,0.468,0.391
"2913","240365",1995,1487,844,643,211,74,137,16.23,0.1623,0.142,0.115
"2914","240374",1995,637,369,268,42,13,29,7.86,0.0786,0.066,0.049
"2915","240417",1995,1133,542,591,143,36,107,19.74,0.1974,0.126,0.061
"2916","240426",1995,288,173,115,52,17,35,20.23,0.2023,0.181,0.148
"2917","240444",1995,5101,2779,2322,2037,768,1269,45.66,0.4566,0.399,0.331
"2918","240453",1995,1785,926,859,186,75,111,11.99,0.1199,0.104,0.087
"2919","240462",1995,926,315,611,125,59,66,20.95,0.2095,0.135,0.097
"2920","240471",1995,957,548,409,204,73,131,23.91,0.2391,0.213,0.178
"2921","240480",1995,1474,817,657,285,82,203,24.85,0.2485,0.193,0.125
"2922","240727",1995,1267,661,606,276,88,188,28.44,0.2844,0.218,0.145
"2923","243443",1995,728,466,262,33,8,25,5.36,0.0536,0.045,0.031
"2924","243780",1995,6064,2696,3368,1625,786,839,31.12,0.3112,0.268,0.233
"2925","100654",1996,716,372,344,147,44,103,27.69,0.2769,0.205,0.128
"2926","100663",1996,1027,597,430,134,35,99,16.58,0.1658,0.13,0.081
"2927","100751",1996,2049,1195,854,744,240,504,42.18,0.4218,0.363,0.281
"2928","100858",1996,3287,1746,1541,1321,446,875,50.11,0.5011,0.402,0.289
"2929","101435",1996,165,95,70,62,16,46,48.42,0.4842,0.376,0.229
"2930","101480",1996,817,446,371,122,23,99,22.2,0.222,0.149,0.062
"2931","101675",1996,327,146,181,125,58,67,45.89,0.4589,0.382,0.32
"2932","101879",1996,790,459,331,99,28,71,15.47,0.1547,0.125,0.085
"2933","102049",1996,646,388,258,329,117,212,54.64,0.5464,0.509,0.453
"2934","102094",1996,1066,590,476,147,37,110,18.64,0.1864,0.138,0.078
"2935","102234",1996,201,121,80,96,32,64,52.89,0.5289,0.478,0.4
"2936","102368",1996,877,483,394,340,133,207,42.86,0.4286,0.388,0.338
"2937","102377",1996,810,497,313,180,34,146,29.38,0.2938,0.222,0.109
"2938","104151",1996,4001,2117,1884,1028,398,630,29.76,0.2976,0.257,0.211
"2939","104179",1996,4006,2102,1904,1145,441,704,33.49,0.3349,0.286,0.232
"2940","105330",1996,2267,1288,979,538,170,368,28.57,0.2857,0.237,0.174
"2941","106245",1996,691,429,262,65,18,47,10.96,0.1096,0.094,0.069
"2942","106342",1996,129,69,60,60,22,38,55.07,0.5507,0.465,0.367
"2943","106397",1996,2174,1105,1069,490,184,306,27.69,0.2769,0.225,0.172
"2944","106412",1996,575,302,273,47,12,35,11.59,0.1159,0.082,0.044
"2945","106458",1996,1592,893,699,216,64,152,17.02,0.1702,0.136,0.092
"2946","106467",1996,668,339,329,94,40,54,15.93,0.1593,0.141,0.122
"2947","106485",1996,453,240,213,44,19,25,10.42,0.1042,0.097,0.089
"2948","106704",1996,1478,928,550,239,69,170,18.32,0.1832,0.162,0.125
"2949","107044",1996,846,497,349,266,85,181,36.42,0.3642,0.314,0.244
"2950","107080",1996,306,185,121,188,78,110,59.46,0.5946,0.614,0.645
"2951","107141",1996,266,148,118,101,37,64,43.24,0.4324,0.38,0.314
"2952","107512",1996,451,237,214,184,69,115,48.52,0.4852,0.408,0.322
"2953","107558",1996,110,52,58,37,14,23,44.23,0.4423,0.336,0.241
"2954","110097",1996,407,268,139,184,62,122,45.52,0.4552,0.452,0.446
"2955","110404",1996,216,64,152,156,112,44,68.75,0.6875,0.722,0.737
"2956","110422",1996,2757,1202,1555,448,132,316,26.29,0.2629,0.162,0.085
"2957","110486",1996,418,253,165,56,14,42,16.6,0.166,0.134,0.085
"2958","110495",1996,381,244,137,85,22,63,25.82,0.2582,0.223,0.161
"2959","110510",1996,882,554,328,78,18,60,10.83,0.1083,0.088,0.055
"2960","110529",1996,1497,647,850,128,56,72,11.13,0.1113,0.086,0.066
"2961","110538",1996,1524,874,650,173,35,138,15.79,0.1579,0.114,0.054
"2962","110547",1996,475,358,117,24,3,21,5.87,0.0587,0.051,0.026
"2963","110556",1996,1503,846,657,198,54,144,17.02,0.1702,0.132,0.082
"2964","110565",1996,2028,1158,870,199,48,151,13.04,0.1304,0.098,0.055
"2965","110574",1996,661,420,241,83,26,57,13.57,0.1357,0.126,0.108
"2966","110583",1996,2299,1407,892,152,38,114,8.1,0.081,0.066,0.043
"2967","110592",1996,1313,763,550,51,15,36,4.72,0.0472,0.039,0.027
"2968","110617",1996,1396,826,570,84,23,61,7.38,0.0738,0.06,0.04
"2969","113698",1996,58,41,17,23,6,17,41.46,0.4146,0.397,0.353
"2970","115755",1996,823,471,352,62,13,49,10.4,0.104,0.075,0.037
"2971","119173",1996,112,112,0,61,0,61,54.46,0.5446,0.545,NA
"2972","120184",1996,124,75,49,49,16,33,44,0.44,0.395,0.327
"2973","121309",1996,515,313,202,218,70,148,47.28,0.4728,0.423,0.347
"2974","121345",1996,396,187,209,331,173,158,84.49,0.8449,0.836,0.828
"2975","122409",1996,2908,1752,1156,208,55,153,8.73,0.0873,0.072,0.048
"2976","122436",1996,1042,569,473,542,213,329,57.82,0.5782,0.52,0.45
"2977","122597",1996,1727,1102,625,111,35,76,6.9,0.069,0.064,0.056
"2978","122612",1996,616,413,203,307,89,218,52.78,0.5278,0.498,0.438
"2979","122931",1996,1075,586,489,798,349,449,76.62,0.7662,0.742,0.714
"2980","123554",1996,488,288,200,307,102,205,71.18,0.7118,0.629,0.51
"2981","123572",1996,781,502,279,156,36,120,23.9,0.239,0.2,0.129
"2982","126562",1996,373,215,158,54,20,34,15.81,0.1581,0.145,0.127
"2983","126580",1996,375,227,148,63,18,45,19.82,0.1982,0.168,0.122
"2984","126614",1996,3953,1983,1970,1529,623,906,45.69,0.4569,0.387,0.316
"2985","126818",1996,2695,1511,1184,847,307,540,35.74,0.3574,0.314,0.259
"2986","127060",1996,717,372,345,389,168,221,59.41,0.5941,0.543,0.487
"2987","127185",1996,1124,493,631,122,43,79,16.02,0.1602,0.109,0.068
"2988","127565",1996,1324,677,647,51,15,36,5.32,0.0532,0.039,0.023
"2989","127741",1996,1642,1000,642,413,120,293,29.3,0.293,0.252,0.187
"2990","128106",1996,574,305,269,68,19,49,16.07,0.1607,0.118,0.071
"2991","128744",1996,116,58,58,35,17,18,31.03,0.3103,0.302,0.293
"2992","128771",1996,1092,534,558,165,65,100,18.73,0.1873,0.151,0.116
"2993","129020",1996,2142,1156,986,908,311,597,51.64,0.5164,0.424,0.315
"2994","129242",1996,876,440,436,642,299,343,77.95,0.7795,0.733,0.686
"2995","129941",1996,329,109,220,68,40,28,25.69,0.2569,0.207,0.182
"2996","130253",1996,602,361,241,281,81,200,55.4,0.554,0.467,0.336
"2997","130314",1996,164,164,0,66,0,66,40.24,0.4024,0.402,NA
"2998","130493",1996,1009,587,422,137,39,98,16.7,0.167,0.136,0.092
"2999","130590",1996,504,238,266,387,195,192,80.67,0.8067,0.768,0.733
"3000","130697",1996,738,374,364,633,311,322,86.1,0.861,0.858,0.854
"3001","130776",1996,496,242,254,60,32,28,11.57,0.1157,0.121,0.126
"3002","130794",1996,1403,688,715,1235,611,624,90.7,0.907,0.88,0.855
"3003","130934",1996,544,305,239,87,21,66,21.64,0.2164,0.16,0.088
"3004","130943",1996,3290,1980,1310,1823,623,1200,60.61,0.6061,0.554,0.476
"3005","131159",1996,1107,703,404,643,224,419,59.6,0.596,0.581,0.554
"3006","131283",1996,452,264,188,261,100,161,60.98,0.6098,0.577,0.532
"3007","131450",1996,186,105,81,13,6,7,6.67,0.0667,0.07,0.074
"3008","131469",1996,1643,973,670,1082,427,655,67.32,0.6732,0.659,0.637
"3009","131496",1996,1408,760,648,1256,569,687,90.39,0.9039,0.892,0.878
"3010","131520",1996,1002,648,354,463,126,337,52.01,0.5201,0.462,0.356
"3011","132471",1996,177,101,76,40,16,24,23.76,0.2376,0.226,0.211
"3012","132602",1996,575,322,253,93,20,73,22.67,0.2267,0.162,0.079
"3013","132903",1996,2579,1316,1263,672,219,453,34.42,0.3442,0.261,0.173
"3014","133492",1996,429,260,169,242,84,158,60.77,0.6077,0.564,0.497
"3015","133553",1996,711,95,616,132,119,13,13.68,0.1368,0.186,0.193
"3016","133650",1996,1717,1017,700,281,83,198,19.47,0.1947,0.164,0.119
"3017","133669",1996,1001,551,450,155,57,98,17.79,0.1779,0.155,0.127
"3018","133711",1996,355,217,138,143,45,98,45.16,0.4516,0.403,0.326
"3019","133881",1996,491,149,342,171,101,70,46.98,0.4698,0.348,0.295
"3020","133951",1996,1846,1067,779,314,87,227,21.27,0.2127,0.17,0.112
"3021","134079",1996,458,287,171,224,67,157,54.7,0.547,0.489,0.392
"3022","134097",1996,3999,2329,1670,1583,536,1047,44.95,0.4495,0.396,0.321
"3023","134130",1996,5171,2899,2272,2599,929,1670,57.61,0.5761,0.503,0.409
"3024","134945",1996,365,197,168,113,44,69,35.03,0.3503,0.31,0.262
"3025","135726",1996,1678,893,785,887,381,506,56.66,0.5666,0.529,0.485
"3026","136172",1996,987,583,404,213,62,151,25.9,0.259,0.216,0.153
"3027","136950",1996,418,240,178,194,69,125,52.08,0.5208,0.464,0.388
"3028","137546",1996,416,229,187,211,83,128,55.9,0.559,0.507,0.444
"3029","138354",1996,459,261,198,107,39,68,26.05,0.2605,0.233,0.197
"3030","138716",1996,503,281,222,34,10,24,8.54,0.0854,0.068,0.045
"3031","138789",1996,805,519,286,60,14,46,8.86,0.0886,0.075,0.049
"3032","139144",1996,539,339,200,252,79,173,51.03,0.5103,0.468,0.395
"3033","139366",1996,616,383,233,43,10,33,8.62,0.0862,0.07,0.043
"3034","139393",1996,206,119,87,109,43,66,55.46,0.5546,0.529,0.494
"3035","139658",1996,1508,867,641,1076,438,638,73.59,0.7359,0.714,0.683
"3036","139719",1996,573,307,266,48,6,42,13.68,0.1368,0.084,0.023
"3037","139755",1996,2120,596,1524,484,288,196,32.89,0.3289,0.228,0.189
"3038","139764",1996,315,199,116,43,10,33,16.58,0.1658,0.137,0.086
"3039","139861",1996,715,483,232,119,23,96,19.88,0.1988,0.166,0.099
"3040","139931",1996,3159,1699,1460,385,115,270,15.89,0.1589,0.122,0.079
"3041","139940",1996,1551,985,566,211,58,153,15.53,0.1553,0.136,0.102
"3042","139959",1996,3671,2184,1487,1546,494,1052,48.17,0.4817,0.421,0.332
"3043","140447",1996,681,432,249,228,63,165,38.19,0.3819,0.335,0.253
"3044","140960",1996,483,268,215,13,3,10,3.73,0.0373,0.027,0.014
"3045","140988",1996,204,134,70,75,22,53,39.55,0.3955,0.368,0.314
"3046","141185",1996,187,120,67,66,22,44,36.67,0.3667,0.353,0.328
"3047","141264",1996,1838,1030,808,227,65,162,15.73,0.1573,0.124,0.08
"3048","141334",1996,1296,801,495,141,28,113,14.11,0.1411,0.109,0.057
"3049","141486",1996,152,100,52,31,10,21,21,0.21,0.204,0.192
"3050","141565",1996,333,207,126,35,11,24,11.59,0.1159,0.105,0.087
"3051","141574",1996,1357,769,588,154,45,109,14.17,0.1417,0.113,0.077
"3052","142276",1996,1378,789,589,49,15,34,4.31,0.0431,0.036,0.025
"3053","142285",1996,1201,574,627,222,85,137,23.87,0.2387,0.185,0.136
"3054","142461",1996,264,156,108,18,4,14,8.97,0.0897,0.068,0.037
"3055","143084",1996,574,345,229,397,153,244,70.72,0.7072,0.692,0.668
"3056","143288",1996,142,72,70,35,13,22,30.56,0.3056,0.246,0.186
"3057","144005",1996,563,409,154,17,4,13,3.18,0.0318,0.03,0.026
"3058","144281",1996,868,411,457,130,52,78,18.98,0.1898,0.15,0.114
"3059","144740",1996,1122,668,454,483,184,299,44.76,0.4476,0.43,0.405
"3060","144892",1996,1640,1000,640,505,126,379,37.9,0.379,0.308,0.197
"3061","144962",1996,222,137,85,130,49,81,59.12,0.5912,0.586,0.576
"3062","144971",1996,128,67,61,55,19,36,53.73,0.5373,0.43,0.311
"3063","145600",1996,2720,1505,1215,454,179,275,18.27,0.1827,0.167,0.147
"3064","145619",1996,231,112,119,82,30,52,46.43,0.4643,0.355,0.252
"3065","145637",1996,5938,2865,3073,3321,1507,1814,63.32,0.6332,0.559,0.49
"3066","145691",1996,200,123,77,87,22,65,52.85,0.5285,0.435,0.286
"3067","145813",1996,2888,1793,1095,877,245,632,35.25,0.3525,0.304,0.224
"3068","146481",1996,324,152,172,188,90,98,64.47,0.6447,0.58,0.523
"3069","146612",1996,312,137,175,120,57,63,45.99,0.4599,0.385,0.326
"3070","146719",1996,1063,690,373,562,175,387,56.09,0.5609,0.529,0.469
"3071","146825",1996,156,90,66,54,15,39,43.33,0.4333,0.346,0.227
"3072","147013",1996,309,142,167,106,46,60,42.25,0.4225,0.343,0.275
"3073","147244",1996,497,284,213,253,80,173,60.92,0.6092,0.509,0.376
"3074","147341",1996,282,167,115,139,52,87,52.1,0.521,0.493,0.452
"3075","147703",1996,2434,1339,1095,613,246,367,27.41,0.2741,0.252,0.225
"3076","147767",1996,1947,1035,912,1639,719,920,88.89,0.8889,0.842,0.788
"3077","147776",1996,799,474,325,12,6,6,1.27,0.0127,0.015,0.018
"3078","147828",1996,400,231,169,141,55,86,37.23,0.3723,0.352,0.325
"3079","148131",1996,283,135,148,112,50,62,45.93,0.4593,0.396,0.338
"3080","148496",1996,153,106,47,80,27,53,50,0.5,0.523,0.574
"3081","148584",1996,151,91,60,53,15,38,41.76,0.4176,0.351,0.25
"3082","148627",1996,203,116,87,56,14,42,36.21,0.3621,0.276,0.161
"3083","149222",1996,2404,1054,1350,376,152,224,21.25,0.2125,0.156,0.113
"3084","149231",1996,1176,741,435,170,36,134,18.08,0.1808,0.145,0.083
"3085","149772",1996,1477,720,757,428,171,257,35.69,0.3569,0.29,0.226
"3086","149781",1996,557,278,279,424,207,217,78.06,0.7806,0.761,0.742
"3087","150066",1996,406,222,184,144,47,97,43.69,0.4369,0.355,0.255
"3088","150136",1996,3763,1959,1804,726,241,485,24.76,0.2476,0.193,0.134
"3089","150145",1996,201,117,84,68,22,46,39.32,0.3932,0.338,0.262
"3090","150163",1996,777,475,302,426,137,289,60.84,0.6084,0.548,0.454
"3091","150400",1996,619,351,268,450,192,258,73.5,0.735,0.727,0.716
"3092","150534",1996,694,428,266,294,99,195,45.56,0.4556,0.424,0.372
"3093","150668",1996,197,107,90,90,39,51,47.66,0.4766,0.457,0.433
"3094","150941",1996,174,104,70,95,37,58,55.77,0.5577,0.546,0.529
"3095","151102",1996,1196,647,549,44,16,28,4.33,0.0433,0.037,0.029
"3096","151111",1996,2100,1172,928,87,30,57,4.86,0.0486,0.041,0.032
"3097","151306",1996,1573,912,661,173,45,128,14.04,0.1404,0.11,0.068
"3098","151324",1996,1911,1026,885,355,111,244,23.78,0.2378,0.186,0.125
"3099","151333",1996,339,227,112,20,6,14,6.17,0.0617,0.059,0.054
"3100","151342",1996,593,360,233,41,9,32,8.89,0.0889,0.069,0.039
"3101","151351",1996,5766,3376,2390,2660,975,1685,49.91,0.4991,0.461,0.408
"3102","151360",1996,560,355,205,37,14,23,6.48,0.0648,0.066,0.068
"3103","151379",1996,643,375,268,60,18,42,11.2,0.112,0.093,0.067
"3104","151388",1996,233,148,85,9,3,6,4.05,0.0405,0.039,0.035
"3105","151777",1996,305,151,154,113,46,67,44.37,0.4437,0.37,0.299
"3106","151786",1996,221,151,70,67,16,51,33.77,0.3377,0.303,0.229
"3107","152080",1996,1920,862,1058,1698,915,783,90.84,0.9084,0.884,0.865
"3108","152248",1996,1026,558,468,92,42,50,8.96,0.0896,0.09,0.09
"3109","152363",1996,212,107,105,93,40,53,49.53,0.4953,0.439,0.381
"3110","152530",1996,485,270,215,348,147,201,74.44,0.7444,0.718,0.684
"3111","152600",1996,656,348,308,381,149,232,66.67,0.6667,0.581,0.484
"3112","153001",1996,311,161,150,124,52,72,44.72,0.4472,0.399,0.347
"3113","153108",1996,303,178,125,160,58,102,57.3,0.573,0.528,0.464
"3114","153269",1996,638,385,253,352,145,207,53.77,0.5377,0.552,0.573
"3115","153384",1996,354,210,144,271,106,165,78.57,0.7857,0.766,0.736
"3116","153603",1996,3599,1592,2007,1022,455,567,35.62,0.3562,0.284,0.227
"3117","153834",1996,615,347,268,437,190,247,71.18,0.7118,0.711,0.709
"3118","154095",1996,2012,1234,778,673,224,449,36.39,0.3639,0.334,0.288
"3119","155089",1996,196,111,85,47,12,35,31.53,0.3153,0.24,0.141
"3120","155317",1996,3546,1902,1644,926,349,577,30.34,0.3034,0.261,0.212
"3121","155335",1996,96,61,35,29,10,19,31.15,0.3115,0.302,0.286
"3122","155399",1996,2681,1326,1355,583,208,375,28.28,0.2828,0.217,0.154
"3123","155520",1996,230,129,101,70,21,49,37.98,0.3798,0.304,0.208
"3124","155627",1996,130,48,82,52,23,29,60.42,0.6042,0.4,0.28
"3125","155937",1996,146,72,74,50,18,32,44.44,0.4444,0.342,0.243
"3126","156213",1996,289,184,105,133,50,83,45.11,0.4511,0.46,0.476
"3127","156286",1996,327,203,124,164,57,107,52.71,0.5271,0.502,0.46
"3128","156295",1996,396,225,171,125,53,72,32,0.32,0.316,0.31
"3129","156365",1996,295,151,144,66,21,45,29.8,0.298,0.224,0.146
"3130","156541",1996,421,210,211,95,40,55,26.19,0.2619,0.226,0.19
"3131","156745",1996,326,193,133,131,41,90,46.63,0.4663,0.402,0.308
"3132","157058",1996,364,163,201,27,7,20,12.27,0.1227,0.074,0.035
"3133","157076",1996,179,103,76,44,22,22,21.36,0.2136,0.246,0.289
"3134","157085",1996,2640,1459,1181,720,253,467,32.01,0.3201,0.273,0.214
"3135","157289",1996,1861,950,911,197,69,128,13.47,0.1347,0.106,0.076
"3136","157386",1996,1271,687,584,157,55,102,14.85,0.1485,0.124,0.094
"3137","157401",1996,1366,749,617,339,105,234,31.24,0.3124,0.248,0.17
"3138","157447",1996,1487,823,664,71,16,55,6.68,0.0668,0.048,0.024
"3139","157535",1996,211,144,67,34,11,23,15.97,0.1597,0.161,0.164
"3140","157951",1996,2257,1234,1023,471,164,307,24.88,0.2488,0.209,0.16
"3141","158477",1996,190,103,87,74,29,45,43.69,0.4369,0.389,0.333
"3142","159009",1996,1091,574,517,90,27,63,10.98,0.1098,0.082,0.052
"3143","159391",1996,3992,2169,1823,867,264,603,27.8,0.278,0.217,0.145
"3144","159647",1996,1279,618,661,330,133,197,31.88,0.3188,0.258,0.201
"3145","159717",1996,1357,750,607,105,24,81,10.8,0.108,0.077,0.04
"3146","159966",1996,1008,603,405,54,13,41,6.8,0.068,0.054,0.032
"3147","160038",1996,1480,891,589,22,5,17,1.91,0.0191,0.015,0.008
"3148","160612",1996,2337,1273,1064,107,33,74,5.81,0.0581,0.046,0.031
"3149","160621",1996,1910,1041,869,129,24,105,10.09,0.1009,0.068,0.028
"3150","160658",1996,2674,1461,1213,161,41,120,8.21,0.0821,0.06,0.034
"3151","161004",1996,443,223,220,369,175,194,87,0.87,0.833,0.795
"3152","161226",1996,477,332,145,147,32,115,34.64,0.3464,0.308,0.221
"3153","161235",1996,84,49,35,9,1,8,16.33,0.1633,0.107,0.029
"3154","161244",1996,143,86,57,9,3,6,6.98,0.0698,0.063,0.053
"3155","161253",1996,1264,549,715,340,156,184,33.52,0.3352,0.269,0.218
"3156","161554",1996,683,383,300,56,17,39,10.18,0.1018,0.082,0.057
"3157","162007",1996,301,169,132,41,9,32,18.93,0.1893,0.136,0.068
"3158","162210",1996,154,79,75,20,6,14,17.72,0.1772,0.13,0.08
"3159","162283",1996,513,357,156,33,11,22,6.16,0.0616,0.064,0.071
"3160","162584",1996,975,482,493,195,70,125,25.93,0.2593,0.2,0.142
"3161","162654",1996,268,188,80,165,38,127,67.55,0.6755,0.616,0.475
"3162","162760",1996,129,128,1,73,0,73,57.03,0.5703,0.566,0
"3163","162928",1996,1018,408,610,826,483,343,84.07,0.8407,0.811,0.792
"3164","163046",1996,812,443,369,592,245,347,78.33,0.7833,0.729,0.664
"3165","163268",1996,1005,505,500,280,106,174,34.46,0.3446,0.279,0.212
"3166","163286",1996,3539,1720,1819,1449,585,864,50.23,0.5023,0.409,0.322
"3167","163453",1996,917,546,371,162,27,135,24.73,0.2473,0.177,0.073
"3168","163462",1996,367,207,160,214,80,134,64.73,0.6473,0.583,0.5
"3169","163851",1996,689,393,296,311,98,213,54.2,0.542,0.451,0.331
"3170","163912",1996,312,180,132,221,93,128,71.11,0.7111,0.708,0.705
"3171","164076",1996,1851,1127,724,513,127,386,34.25,0.3425,0.277,0.175
"3172","164173",1996,286,205,81,89,20,69,33.66,0.3366,0.311,0.247
"3173","164216",1996,312,198,114,203,67,136,68.69,0.6869,0.651,0.588
"3174","164270",1996,385,199,186,236,100,136,68.34,0.6834,0.613,0.538
"3175","164447",1996,253,133,120,79,30,49,36.84,0.3684,0.312,0.25
"3176","164492",1996,112,69,43,53,24,29,42.03,0.4203,0.473,0.558
"3177","164562",1996,431,266,165,296,112,184,69.17,0.6917,0.687,0.679
"3178","165015",1996,761,393,368,608,275,333,84.73,0.8473,0.799,0.747
"3179","165024",1996,1155,697,458,222,52,170,24.39,0.2439,0.192,0.114
"3180","165334",1996,527,301,226,336,128,208,69.1,0.691,0.638,0.566
"3181","165662",1996,547,318,229,358,161,197,61.95,0.6195,0.654,0.703
"3182","165671",1996,86,86,0,45,0,45,52.33,0.5233,0.523,NA
"3183","165820",1996,436,265,171,95,19,76,28.68,0.2868,0.218,0.111
"3184","165866",1996,644,429,215,127,26,101,23.54,0.2354,0.197,0.121
"3185","165936",1996,326,210,116,152,41,111,52.86,0.5286,0.466,0.353
"3186","166027",1996,1611,721,890,1390,754,636,88.21,0.8821,0.863,0.847
"3187","166124",1996,688,349,339,611,287,324,92.84,0.9284,0.888,0.847
"3188","166513",1996,1022,428,594,228,96,132,30.84,0.3084,0.223,0.162
"3189","166629",1996,4073,1964,2109,1577,660,917,46.69,0.4669,0.387,0.313
"3190","166638",1996,538,274,264,55,14,41,14.96,0.1496,0.102,0.053
"3191","166683",1996,1065,446,619,875,498,377,84.53,0.8453,0.822,0.805
"3192","167288",1996,311,176,135,101,35,66,37.5,0.375,0.325,0.259
"3193","167987",1996,825,429,396,240,71,169,39.39,0.3939,0.291,0.179
"3194","167996",1996,551,310,241,419,169,250,80.65,0.8065,0.76,0.701
"3195","168005",1996,507,288,219,140,46,94,32.64,0.3264,0.276,0.21
"3196","168148",1996,1179,597,582,950,452,498,83.42,0.8342,0.806,0.777
"3197","168254",1996,478,174,304,173,104,69,39.66,0.3966,0.362,0.342
"3198","168281",1996,445,315,130,295,82,213,67.62,0.6762,0.663,0.631
"3199","168342",1996,553,276,277,507,248,259,93.84,0.9384,0.917,0.895
"3200","168546",1996,433,227,206,278,120,158,69.6,0.696,0.642,0.583
"3201","168786",1996,283,177,106,92,28,64,36.16,0.3616,0.325,0.264
"3202","169080",1996,960,565,395,545,209,336,59.47,0.5947,0.568,0.529
"3203","169798",1996,2298,1371,927,225,77,148,10.8,0.108,0.098,0.083
"3204","169910",1996,1831,731,1100,48,28,20,2.74,0.0274,0.026,0.025
"3205","170082",1996,2039,1200,839,356,112,244,20.33,0.2033,0.175,0.133
"3206","170301",1996,695,415,280,474,166,308,74.22,0.7422,0.682,0.593
"3207","170532",1996,360,202,158,239,108,131,64.85,0.6485,0.664,0.684
"3208","170639",1996,540,247,293,63,27,36,14.57,0.1457,0.117,0.092
"3209","170976",1996,5328,2710,2618,3399,1533,1866,68.86,0.6886,0.638,0.586
"3210","171100",1996,6708,3728,2980,2358,809,1549,41.55,0.4155,0.352,0.271
"3211","171128",1996,1068,260,808,298,199,99,38.08,0.3808,0.279,0.246
"3212","171137",1996,666,321,345,67,23,44,13.71,0.1371,0.101,0.067
"3213","171146",1996,551,352,199,53,15,38,10.8,0.108,0.096,0.075
"3214","171599",1996,241,93,148,45,21,24,25.81,0.2581,0.187,0.142
"3215","172051",1996,747,425,322,33,8,25,5.88,0.0588,0.044,0.025
"3216","172699",1996,3121,1801,1320,557,177,380,21.1,0.211,0.178,0.134
"3217","173160",1996,468,284,184,292,103,189,66.55,0.6655,0.624,0.56
"3218","173258",1996,471,256,215,387,164,223,87.11,0.8711,0.822,0.763
"3219","173328",1996,161,82,79,53,25,28,34.15,0.3415,0.329,0.316
"3220","173647",1996,633,375,258,504,202,302,80.53,0.8053,0.796,0.783
"3221","173902",1996,491,293,198,377,151,226,77.13,0.7713,0.768,0.763
"3222","174066",1996,4057,2049,2008,1050,451,599,29.23,0.2923,0.259,0.225
"3223","174233",1996,1736,886,850,411,156,255,28.78,0.2878,0.237,0.184
"3224","174251",1996,522,310,212,223,71,152,49.03,0.4903,0.427,0.335
"3225","174491",1996,358,223,135,140,36,104,46.64,0.4664,0.391,0.267
"3226","174792",1996,426,0,426,296,296,0,NA,NA,0.695,0.695
"3227","174844",1996,771,448,323,565,228,337,75.22,0.7522,0.733,0.706
"3228","174899",1996,295,229,66,145,36,109,47.6,0.476,0.492,0.545
"3229","174914",1996,991,540,451,519,204,315,58.33,0.5833,0.524,0.452
"3230","175342",1996,621,384,237,175,44,131,34.11,0.3411,0.282,0.186
"3231","175421",1996,84,42,42,21,11,10,23.81,0.2381,0.25,0.262
"3232","175616",1996,449,278,171,94,27,67,24.1,0.241,0.209,0.158
"3233","175856",1996,906,508,398,140,33,107,21.06,0.2106,0.155,0.083
"3234","175980",1996,292,163,129,166,64,102,62.58,0.6258,0.568,0.496
"3235","176017",1996,1736,909,827,580,199,381,41.91,0.4191,0.334,0.241
"3236","176035",1996,291,248,43,58,2,56,22.58,0.2258,0.199,0.047
"3237","176044",1996,367,170,197,59,26,33,19.41,0.1941,0.161,0.132
"3238","176080",1996,1864,869,995,463,175,288,33.14,0.3314,0.248,0.176
"3239","176406",1996,211,144,67,68,11,57,39.58,0.3958,0.322,0.164
"3240","176628",1996,91,56,35,20,5,15,26.79,0.2679,0.22,0.143
"3241","176947",1996,212,82,130,48,19,29,35.37,0.3537,0.226,0.146
"3242","176965",1996,1252,655,597,221,77,144,21.98,0.2198,0.177,0.129
"3243","177418",1996,146,104,42,66,13,53,50.96,0.5096,0.452,0.31
"3244","178059",1996,185,127,58,100,28,72,56.69,0.5669,0.541,0.483
"3245","178341",1996,685,373,312,77,25,52,13.94,0.1394,0.112,0.08
"3246","178387",1996,963,564,399,113,28,85,15.07,0.1507,0.117,0.07
"3247","178396",1996,3687,2046,1641,1282,462,820,40.08,0.4008,0.348,0.282
"3248","178402",1996,567,299,268,86,33,53,17.73,0.1773,0.152,0.123
"3249","178411",1996,777,179,598,121,77,44,24.58,0.2458,0.156,0.129
"3250","178420",1996,632,351,281,78,20,58,16.52,0.1652,0.123,0.071
"3251","178615",1996,1480,868,612,592,185,407,46.89,0.4689,0.4,0.302
"3252","179043",1996,362,196,166,9,3,6,3.06,0.0306,0.025,0.018
"3253","179159",1996,1047,609,438,577,202,375,61.58,0.6158,0.551,0.461
"3254","179557",1996,1212,681,531,294,82,212,31.13,0.3113,0.243,0.154
"3255","179566",1996,2447,1404,1043,433,127,306,21.79,0.2179,0.177,0.122
"3256","179867",1996,1275,642,633,1006,463,543,84.58,0.8458,0.789,0.731
"3257","179894",1996,270,139,131,116,50,66,47.48,0.4748,0.43,0.382
"3258","179946",1996,214,84,130,100,62,38,45.24,0.4524,0.467,0.477
"3259","180179",1996,520,332,188,79,28,51,15.36,0.1536,0.152,0.149
"3260","180461",1996,1740,780,960,246,120,126,16.15,0.1615,0.141,0.125
"3261","180522",1996,218,96,122,24,13,11,11.46,0.1146,0.11,0.107
"3262","180984",1996,247,133,114,67,27,40,30.08,0.3008,0.271,0.237
"3263","181002",1996,832,494,338,489,194,295,59.72,0.5972,0.588,0.574
"3264","181020",1996,276,139,137,146,62,84,60.43,0.6043,0.529,0.453
"3265","181127",1996,262,140,122,138,51,87,62.14,0.6214,0.527,0.418
"3266","181215",1996,1279,707,572,174,59,115,16.27,0.1627,0.136,0.103
"3267","181394",1996,1129,588,541,87,32,55,9.35,0.0935,0.077,0.059
"3268","181446",1996,383,225,158,202,79,123,54.67,0.5467,0.527,0.5
"3269","181464",1996,3625,1814,1811,654,248,406,22.38,0.2238,0.18,0.137
"3270","181534",1996,223,97,126,38,11,27,27.84,0.2784,0.17,0.087
"3271","181783",1996,690,397,293,147,53,94,23.68,0.2368,0.213,0.181
"3272","182281",1996,1509,797,712,179,49,130,16.31,0.1631,0.119,0.069
"3273","182290",1996,1123,605,518,163,46,117,19.34,0.1934,0.145,0.089
"3274","182634",1996,227,158,69,91,31,60,37.97,0.3797,0.401,0.449
"3275","182795",1996,438,210,228,181,81,100,47.62,0.4762,0.413,0.355
"3276","183062",1996,839,499,340,211,68,143,28.66,0.2866,0.251,0.2
"3277","183080",1996,894,433,461,196,87,109,25.17,0.2517,0.219,0.189
"3278","183239",1996,549,301,248,397,172,225,74.75,0.7475,0.723,0.694
"3279","183822",1996,227,150,77,36,6,30,20,0.2,0.159,0.078
"3280","183974",1996,86,63,23,21,0,21,33.33,0.3333,0.244,0
"3281","184348",1996,371,203,168,265,118,147,72.41,0.7241,0.714,0.702
"3282","184603",1996,915,494,421,187,76,111,22.47,0.2247,0.204,0.181
"3283","184612",1996,141,92,49,8,3,5,5.43,0.0543,0.057,0.061
"3284","184782",1996,1132,609,523,414,173,241,39.57,0.3957,0.366,0.331
"3285","185129",1996,531,283,248,32,10,22,7.77,0.0777,0.06,0.04
"3286","185572",1996,799,411,388,261,99,162,39.42,0.3942,0.327,0.255
"3287","185590",1996,1194,706,488,243,64,179,25.35,0.2535,0.204,0.131
"3288","185828",1996,599,116,483,60,39,21,18.1,0.181,0.1,0.081
"3289","186131",1996,1123,525,598,1032,540,492,93.71,0.9371,0.919,0.903
"3290","186201",1996,413,240,173,101,29,72,30,0.3,0.245,0.168
"3291","186283",1996,678,394,284,311,113,198,50.25,0.5025,0.459,0.398
"3292","186584",1996,968,547,421,349,112,237,43.33,0.4333,0.361,0.266
"3293","186876",1996,705,404,301,278,110,168,41.58,0.4158,0.394,0.365
"3294","187134",1996,1009,675,334,648,187,461,68.3,0.683,0.642,0.56
"3295","187444",1996,918,523,395,148,41,107,20.46,0.2046,0.161,0.104
"3296","187985",1996,1600,875,725,217,67,150,17.14,0.1714,0.136,0.092
"3297","188030",1996,1510,807,703,188,51,137,16.98,0.1698,0.125,0.073
"3298","188429",1996,316,204,112,128,40,88,43.14,0.4314,0.405,0.357
"3299","188641",1996,330,166,164,178,76,102,61.45,0.6145,0.539,0.463
"3300","190044",1996,664,176,488,349,253,96,54.55,0.5455,0.526,0.518
"3301","190099",1996,718,351,367,592,282,310,88.32,0.8832,0.825,0.768
"3302","190150",1996,1260,576,684,1041,542,499,86.63,0.8663,0.826,0.792
"3303","190248",1996,94,43,51,19,7,12,27.91,0.2791,0.202,0.137
"3304","190415",1996,2001,870,1131,1570,872,698,80.23,0.8023,0.785,0.771
"3305","190512",1996,1365,797,568,196,82,114,14.3,0.143,0.144,0.144
"3306","190549",1996,1211,739,472,183,49,134,18.13,0.1813,0.151,0.104
"3307","190558",1996,1434,727,707,32,9,23,3.16,0.0316,0.022,0.013
"3308","190567",1996,768,352,416,28,14,14,3.98,0.0398,0.036,0.034
"3309","190594",1996,1456,1008,448,127,28,99,9.82,0.0982,0.087,0.062
"3310","190637",1996,605,422,183,45,8,37,8.77,0.0877,0.074,0.044
"3311","190664",1996,1040,621,419,225,56,169,27.21,0.2721,0.216,0.134
"3312","190691",1996,543,368,175,47,16,31,8.42,0.0842,0.087,0.091
"3313","190725",1996,372,259,113,69,11,58,22.39,0.2239,0.185,0.097
"3314","191241",1996,1206,694,512,822,338,484,69.74,0.6974,0.682,0.66
"3315","191515",1996,497,239,258,392,196,196,82.01,0.8201,0.789,0.76
"3316","191533",1996,482,257,225,228,93,135,52.53,0.5253,0.473,0.413
"3317","191630",1996,530,267,263,356,161,195,73.03,0.7303,0.672,0.612
"3318","191649",1996,1735,996,739,653,217,436,43.78,0.4378,0.376,0.294
"3319","191676",1996,288,194,94,164,47,117,60.31,0.6031,0.569,0.5
"3320","191931",1996,662,320,342,260,100,160,50,0.5,0.393,0.292
"3321","191968",1996,1426,820,606,908,355,553,67.44,0.6744,0.637,0.586
"3322","192192",1996,234,168,66,61,17,44,26.19,0.2619,0.261,0.258
"3323","192323",1996,434,255,179,305,115,190,74.51,0.7451,0.703,0.642
"3324","192439",1996,956,654,302,51,17,34,5.2,0.052,0.053,0.056
"3325","192703",1996,557,258,299,313,143,170,65.89,0.6589,0.562,0.478
"3326","192749",1996,271,181,90,117,33,84,46.41,0.4641,0.432,0.367
"3327","192819",1996,839,482,357,510,187,323,67.01,0.6701,0.608,0.524
"3328","192925",1996,81,58,23,6,2,4,6.9,0.069,0.074,0.087
"3329","193016",1996,551,336,215,62,12,50,14.88,0.1488,0.113,0.056
"3330","193292",1996,183,125,58,21,5,16,12.8,0.128,0.115,0.086
"3331","193353",1996,266,199,67,105,20,85,42.71,0.4271,0.395,0.299
"3332","193399",1996,208,162,46,111,26,85,52.47,0.5247,0.534,0.565
"3333","193584",1996,337,242,95,208,55,153,63.22,0.6322,0.617,0.579
"3334","193645",1996,931,787,144,129,13,116,14.74,0.1474,0.139,0.09
"3335","193654",1996,401,272,129,132,27,105,38.6,0.386,0.329,0.209
"3336","193900",1996,3393,2002,1391,1838,770,1068,53.35,0.5335,0.542,0.554
"3337","193973",1996,552,314,238,253,107,146,46.5,0.465,0.458,0.45
"3338","194161",1996,208,129,79,69,23,46,35.66,0.3566,0.332,0.291
"3339","194310",1996,1388,788,600,487,180,307,38.96,0.3896,0.351,0.3
"3340","194824",1996,898,225,673,454,318,136,60.44,0.6044,0.506,0.473
"3341","195003",1996,1725,571,1154,690,419,271,47.46,0.4746,0.4,0.363
"3342","195030",1996,1011,501,510,719,336,383,76.45,0.7645,0.711,0.659
"3343","195164",1996,590,311,279,327,153,174,55.95,0.5595,0.554,0.548
"3344","195173",1996,305,181,124,93,35,58,32.04,0.3204,0.305,0.282
"3345","195216",1996,592,281,311,388,209,179,63.7,0.637,0.655,0.672
"3346","195234",1996,319,226,93,146,30,116,51.33,0.5133,0.458,0.323
"3347","195243",1996,238,142,96,65,16,49,34.51,0.3451,0.273,0.167
"3348","195304",1996,294,219,75,193,47,146,66.67,0.6667,0.656,0.627
"3349","195474",1996,558,325,233,354,137,217,66.77,0.6677,0.634,0.588
"3350","195526",1996,702,424,278,501,196,305,71.93,0.7193,0.714,0.705
"3351","195544",1996,97,76,21,59,8,51,67.11,0.6711,0.608,0.381
"3352","195809",1996,2157,1146,1011,629,229,400,34.9,0.349,0.292,0.227
"3353","196413",1996,2652,1429,1223,1722,735,987,69.07,0.6907,0.649,0.601
"3354","196592",1996,2337,1646,691,73,40,33,2,0.02,0.031,0.058
"3355","197045",1996,338,223,115,126,34,92,41.26,0.4126,0.373,0.296
"3356","197133",1996,614,375,239,499,191,308,82.13,0.8213,0.813,0.799
"3357","197869",1996,2026,1111,915,689,226,463,41.67,0.4167,0.34,0.247
"3358","197984",1996,181,93,88,62,30,32,34.41,0.3441,0.343,0.341
"3359","198385",1996,439,230,209,385,181,204,88.7,0.887,0.877,0.866
"3360","198464",1996,2626,1581,1045,673,216,457,28.91,0.2891,0.256,0.207
"3361","198507",1996,380,205,175,130,44,86,41.95,0.4195,0.342,0.251
"3362","198516",1996,941,569,372,551,204,347,60.98,0.6098,0.586,0.548
"3363","198835",1996,232,135,97,96,32,64,47.41,0.4741,0.414,0.33
"3364","198969",1996,320,100,220,55,30,25,25,0.25,0.172,0.136
"3365","199102",1996,1313,692,621,300,90,210,30.35,0.3035,0.228,0.145
"3366","199111",1996,450,275,175,139,42,97,35.27,0.3527,0.309,0.24
"3367","199120",1996,3270,2065,1205,2185,718,1467,71.04,0.7104,0.668,0.596
"3368","199139",1996,1682,952,730,359,113,246,25.84,0.2584,0.213,0.155
"3369","199148",1996,1552,1075,477,390,77,313,29.12,0.2912,0.251,0.161
"3370","199157",1996,681,441,240,179,38,141,31.97,0.3197,0.263,0.158
"3371","199193",1996,3630,1457,2173,968,442,526,36.1,0.361,0.267,0.203
"3372","199218",1996,1619,990,629,602,196,406,41.01,0.4101,0.372,0.312
"3373","199281",1996,450,211,239,80,30,50,23.7,0.237,0.178,0.126
"3374","199306",1996,120,54,66,26,12,14,25.93,0.2593,0.217,0.182
"3375","199412",1996,155,116,39,80,14,66,56.9,0.569,0.516,0.359
"3376","199582",1996,408,228,180,46,21,25,10.96,0.1096,0.113,0.117
"3377","199643",1996,374,232,142,67,17,50,21.55,0.2155,0.179,0.12
"3378","199847",1996,934,500,434,707,297,410,82,0.82,0.757,0.684
"3379","199962",1996,331,137,194,101,43,58,42.34,0.4234,0.305,0.222
"3380","199999",1996,480,351,129,95,19,76,21.65,0.2165,0.198,0.147
"3381","200004",1996,1177,560,617,260,87,173,30.89,0.3089,0.221,0.141
"3382","200059",1996,397,193,204,24,9,15,7.77,0.0777,0.06,0.044
"3383","200156",1996,288,159,129,90,25,65,40.88,0.4088,0.312,0.194
"3384","200217",1996,440,266,174,117,36,81,30.45,0.3045,0.266,0.207
"3385","200226",1996,148,79,69,22,7,15,18.99,0.1899,0.149,0.101
"3386","200253",1996,457,304,153,35,10,25,8.22,0.0822,0.077,0.065
"3387","200280",1996,1365,630,735,194,92,102,16.19,0.1619,0.142,0.125
"3388","200332",1996,1295,543,752,169,83,86,15.84,0.1584,0.131,0.11
"3389","200572",1996,178,99,79,38,15,23,23.23,0.2323,0.213,0.19
"3390","201104",1996,432,240,192,150,47,103,42.92,0.4292,0.347,0.245
"3391","201371",1996,183,115,68,97,38,59,51.3,0.513,0.53,0.559
"3392","201548",1996,468,285,183,275,90,185,64.91,0.6491,0.588,0.492
"3393","201645",1996,738,284,454,387,202,185,65.14,0.6514,0.524,0.445
"3394","201690",1996,330,161,169,28,12,16,9.94,0.0994,0.085,0.071
"3395","202134",1996,845,443,402,80,25,55,12.42,0.1242,0.095,0.062
"3396","202480",1996,1553,845,708,890,310,580,68.64,0.6864,0.573,0.438
"3397","202523",1996,642,305,337,464,229,235,77.05,0.7705,0.723,0.68
"3398","202763",1996,553,302,251,210,83,127,42.05,0.4205,0.38,0.331
"3399","203085",1996,303,141,162,141,68,73,51.77,0.5177,0.465,0.42
"3400","203128",1996,232,129,103,144,60,84,65.12,0.6512,0.621,0.583
"3401","203368",1996,775,425,350,483,201,282,66.35,0.6635,0.623,0.574
"3402","203517",1996,2600,1516,1084,448,150,298,19.66,0.1966,0.172,0.138
"3403","203535",1996,423,238,185,338,147,191,80.25,0.8025,0.799,0.795
"3404","203580",1996,61,44,17,32,10,22,50,0.5,0.525,0.588
"3405","203775",1996,400,234,166,141,41,100,42.74,0.4274,0.352,0.247
"3406","203845",1996,271,111,160,110,50,60,54.05,0.5405,0.406,0.312
"3407","204024",1996,3342,1935,1407,2180,798,1382,71.42,0.7142,0.652,0.567
"3408","204185",1996,483,217,266,254,113,141,64.98,0.6498,0.526,0.425
"3409","204194",1996,407,252,155,154,43,111,44.05,0.4405,0.378,0.277
"3410","204617",1996,180,113,67,52,11,41,36.28,0.3628,0.289,0.164
"3411","204796",1996,6027,3018,3009,1526,565,961,31.84,0.3184,0.253,0.188
"3412","204857",1996,3123,1832,1291,1390,446,944,51.53,0.5153,0.445,0.345
"3413","206330",1996,235,94,141,31,12,19,20.21,0.2021,0.132,0.085
"3414","206589",1996,516,255,261,302,136,166,65.1,0.651,0.585,0.521
"3415","206604",1996,1859,995,864,281,78,203,20.4,0.204,0.151,0.09
"3416","206622",1996,778,461,317,458,184,274,59.44,0.5944,0.589,0.58
"3417","206695",1996,1685,859,826,212,88,124,14.44,0.1444,0.126,0.107
"3418","206914",1996,616,353,263,63,25,38,10.76,0.1076,0.102,0.095
"3419","207209",1996,518,259,259,33,8,25,9.65,0.0965,0.064,0.031
"3420","207306",1996,234,110,124,22,11,11,10,0.1,0.094,0.089
"3421","207324",1996,464,234,230,106,41,65,27.78,0.2778,0.228,0.178
"3422","207388",1996,2336,1223,1113,488,155,333,27.23,0.2723,0.209,0.139
"3423","207500",1996,2605,1264,1341,525,200,325,25.71,0.2571,0.202,0.149
"3424","207722",1996,261,138,123,26,11,15,10.87,0.1087,0.1,0.089
"3425","207847",1996,579,266,313,78,41,37,13.91,0.1391,0.135,0.131
"3426","207865",1996,737,386,351,92,34,58,15.03,0.1503,0.125,0.097
"3427","208822",1996,386,250,136,200,71,129,51.6,0.516,0.518,0.522
"3428","209056",1996,443,262,181,249,91,158,60.31,0.6031,0.562,0.503
"3429","209065",1996,445,238,207,272,109,163,68.49,0.6849,0.611,0.527
"3430","209542",1996,1833,883,950,492,181,311,35.22,0.3522,0.268,0.191
"3431","209551",1996,2580,1444,1136,958,349,609,42.17,0.4217,0.371,0.307
"3432","209612",1996,268,179,89,117,36,81,45.25,0.4525,0.437,0.404
"3433","209807",1996,726,351,375,97,34,63,17.95,0.1795,0.134,0.091
"3434","209922",1996,357,200,157,159,59,100,50,0.5,0.445,0.376
"3435","210146",1996,701,388,313,111,48,63,16.24,0.1624,0.158,0.153
"3436","210401",1996,419,241,178,304,115,189,78.42,0.7842,0.726,0.646
"3437","210429",1996,742,448,294,107,33,74,16.52,0.1652,0.144,0.112
"3438","210571",1996,354,190,164,215,77,138,72.63,0.7263,0.607,0.47
"3439","210669",1996,523,311,212,346,125,221,71.06,0.7106,0.662,0.59
"3440","210775",1996,143,73,70,44,16,28,38.36,0.3836,0.308,0.229
"3441","211088",1996,292,219,73,131,29,102,46.58,0.4658,0.449,0.397
"3442","211158",1996,1556,994,562,567,147,420,42.25,0.4225,0.364,0.262
"3443","211291",1996,895,440,455,761,365,396,90,0.9,0.85,0.802
"3444","211352",1996,247,186,61,114,23,91,48.92,0.4892,0.462,0.377
"3445","211361",1996,805,398,407,140,47,93,23.37,0.2337,0.174,0.115
"3446","211431",1996,148,145,3,65,0,65,44.83,0.4483,0.439,0
"3447","211440",1996,1386,472,914,903,563,340,72.03,0.7203,0.652,0.616
"3448","211468",1996,329,328,1,189,0,189,57.62,0.5762,0.574,0
"3449","211556",1996,102,102,0,60,0,60,58.82,0.5882,0.588,NA
"3450","211583",1996,77,77,0,46,0,46,59.74,0.5974,0.597,NA
"3451","211608",1996,236,124,112,16,2,14,11.29,0.1129,0.068,0.018
"3452","211644",1996,1215,711,504,284,79,205,28.83,0.2883,0.234,0.157
"3453","211981",1996,385,177,208,149,67,82,46.33,0.4633,0.387,0.322
"3454","212009",1996,491,264,227,371,168,203,76.89,0.7689,0.756,0.74
"3455","212054",1996,1348,476,872,172,76,96,20.17,0.2017,0.128,0.087
"3456","212106",1996,1196,690,506,558,204,354,51.3,0.513,0.467,0.403
"3457","212115",1996,872,499,373,198,50,148,29.66,0.2966,0.227,0.134
"3458","212133",1996,245,168,77,138,34,104,61.9,0.619,0.563,0.442
"3459","212160",1996,1250,707,543,214,69,145,20.51,0.2051,0.171,0.127
"3460","212197",1996,429,295,134,263,73,190,64.41,0.6441,0.613,0.545
"3461","212577",1996,522,272,250,408,175,233,85.66,0.8566,0.782,0.7
"3462","212601",1996,504,305,199,229,72,157,51.48,0.5148,0.454,0.362
"3463","212832",1996,44,32,12,16,3,13,40.62,0.4062,0.364,0.25
"3464","212911",1996,313,172,141,267,116,151,87.79,0.8779,0.853,0.823
"3465","213020",1996,2617,1493,1124,613,163,450,30.14,0.3014,0.234,0.145
"3466","213251",1996,349,182,167,237,100,137,75.27,0.7527,0.679,0.599
"3467","213321",1996,432,236,196,284,116,168,71.19,0.7119,0.657,0.592
"3468","213349",1996,1440,883,557,245,56,189,21.4,0.214,0.17,0.101
"3469","213358",1996,152,106,46,57,19,38,35.85,0.3585,0.375,0.413
"3470","213367",1996,648,355,293,362,146,216,60.85,0.6085,0.559,0.498
"3471","213385",1996,572,281,291,460,215,245,87.19,0.8719,0.804,0.739
"3472","213507",1996,287,172,115,165,53,112,65.12,0.6512,0.575,0.461
"3473","213543",1996,1101,409,692,768,433,335,81.91,0.8191,0.698,0.626
"3474","213613",1996,780,419,361,179,62,117,27.92,0.2792,0.229,0.172
"3475","213668",1996,386,186,200,226,102,124,66.67,0.6667,0.585,0.51
"3476","213783",1996,590,316,274,154,57,97,30.7,0.307,0.261,0.208
"3477","213826",1996,251,191,60,103,18,85,44.5,0.445,0.41,0.3
"3478","213996",1996,672,407,265,448,168,280,68.8,0.688,0.667,0.634
"3479","214041",1996,979,587,392,327,121,206,35.09,0.3509,0.334,0.309
"3480","214069",1996,251,186,65,59,16,43,23.12,0.2312,0.235,0.246
"3481","214157",1996,284,138,146,194,90,104,75.36,0.7536,0.683,0.616
"3482","214175",1996,532,307,225,414,161,253,82.41,0.8241,0.778,0.716
"3483","214272",1996,114,82,32,41,11,30,36.59,0.3659,0.36,0.344
"3484","214777",1996,4701,2344,2357,2052,837,1215,51.83,0.5183,0.437,0.355
"3485","215062",1996,2307,1169,1138,1976,924,1052,89.99,0.8999,0.857,0.812
"3486","215743",1996,346,205,141,95,24,71,34.63,0.3463,0.275,0.17
"3487","215798",1996,271,136,135,168,76,92,67.65,0.6765,0.62,0.563
"3488","215929",1996,948,550,398,623,254,369,67.09,0.6709,0.657,0.638
"3489","216010",1996,1272,674,598,455,168,287,42.58,0.4258,0.358,0.281
"3490","216038",1996,1197,677,520,247,85,162,23.93,0.2393,0.206,0.163
"3491","216287",1996,412,217,195,354,167,187,86.18,0.8618,0.859,0.856
"3492","216339",1996,2155,1284,871,442,138,304,23.68,0.2368,0.205,0.158
"3493","216524",1996,327,180,147,244,105,139,77.22,0.7722,0.746,0.714
"3494","216694",1996,305,134,171,138,59,79,58.96,0.5896,0.452,0.345
"3495","216764",1996,1454,943,511,376,88,288,30.54,0.3054,0.259,0.172
"3496","216807",1996,304,176,128,208,78,130,73.86,0.7386,0.684,0.609
"3497","216852",1996,462,217,245,172,73,99,45.62,0.4562,0.372,0.298
"3498","216931",1996,448,181,267,154,83,71,39.23,0.3923,0.344,0.311
"3499","217059",1996,805,443,362,319,122,197,44.47,0.4447,0.396,0.337
"3500","217156",1996,1469,810,659,1220,536,684,84.44,0.8444,0.83,0.813
"3501","217402",1996,938,556,382,786,310,476,85.61,0.8561,0.838,0.812
"3502","217536",1996,393,271,122,209,61,148,54.61,0.5461,0.532,0.5
"3503","217776",1996,73,36,37,19,8,11,30.56,0.3056,0.26,0.216
"3504","217819",1996,1867,1236,631,624,149,475,38.43,0.3843,0.334,0.236
"3505","217882",1996,2538,1234,1304,945,327,618,50.08,0.5008,0.372,0.251
"3506","217998",1996,134,82,52,89,34,55,67.07,0.6707,0.664,0.654
"3507","218061",1996,636,365,271,119,39,80,21.92,0.2192,0.187,0.144
"3508","218229",1996,437,273,164,134,40,94,34.43,0.3443,0.307,0.244
"3509","218238",1996,87,38,49,16,5,11,28.95,0.2895,0.184,0.102
"3510","218399",1996,246,145,101,45,11,34,23.45,0.2345,0.183,0.109
"3511","218414",1996,234,103,131,91,36,55,53.4,0.534,0.389,0.275
"3512","218663",1996,2635,1518,1117,857,289,568,37.42,0.3742,0.325,0.259
"3513","218724",1996,823,408,415,120,44,76,18.63,0.1863,0.146,0.106
"3514","218733",1996,801,452,349,159,24,135,29.87,0.2987,0.199,0.069
"3515","218742",1996,438,284,154,75,12,63,22.18,0.2218,0.171,0.078
"3516","218973",1996,291,132,159,204,106,98,74.24,0.7424,0.701,0.667
"3517","219000",1996,383,244,139,190,55,135,55.33,0.5533,0.496,0.396
"3518","219046",1996,452,260,192,58,15,43,16.54,0.1654,0.128,0.078
"3519","219082",1996,189,100,89,25,5,20,20,0.2,0.132,0.056
"3520","219198",1996,117,77,40,42,11,31,40.26,0.4026,0.359,0.275
"3521","219259",1996,560,324,236,68,24,44,13.58,0.1358,0.121,0.102
"3522","219356",1996,1481,733,748,303,129,174,23.74,0.2374,0.205,0.172
"3523","219471",1996,875,489,386,175,62,113,23.11,0.2311,0.2,0.161
"3524","219602",1996,777,498,279,156,38,118,23.69,0.2369,0.201,0.136
"3525","219709",1996,418,262,156,185,66,119,45.42,0.4542,0.443,0.423
"3526","219718",1996,180,82,98,24,6,18,21.95,0.2195,0.133,0.061
"3527","219949",1996,154,78,76,37,10,27,34.62,0.3462,0.24,0.132
"3528","220075",1996,1532,894,638,186,62,124,13.87,0.1387,0.121,0.097
"3529","220215",1996,314,194,120,107,30,77,39.69,0.3969,0.341,0.25
"3530","220613",1996,525,304,221,128,45,83,27.3,0.273,0.244,0.204
"3531","220631",1996,212,134,78,58,23,35,26.12,0.2612,0.274,0.295
"3532","220710",1996,259,134,125,134,54,80,59.7,0.597,0.517,0.432
"3533","221351",1996,375,196,179,264,128,136,69.39,0.6939,0.704,0.715
"3534","221519",1996,365,205,160,264,115,149,72.68,0.7268,0.723,0.719
"3535","221731",1996,145,98,47,2,0,2,2.04,0.0204,0.014,0
"3536","221847",1996,1130,497,633,134,39,95,19.11,0.1911,0.119,0.062
"3537","221892",1996,189,108,81,37,9,28,25.93,0.2593,0.196,0.111
"3538","222178",1996,898,478,420,241,97,144,30.13,0.3013,0.268,0.231
"3539","222983",1996,344,181,163,254,106,148,81.77,0.8177,0.738,0.65
"3540","223232",1996,2463,1444,1019,1062,350,712,49.31,0.4931,0.431,0.343
"3541","224004",1996,121,74,47,42,12,30,40.54,0.4054,0.347,0.255
"3542","224323",1996,251,157,94,141,46,95,60.51,0.6051,0.562,0.489
"3543","225432",1996,638,385,253,13,5,8,2.08,0.0208,0.02,0.02
"3544","225548",1996,335,151,184,83,27,56,37.09,0.3709,0.248,0.147
"3545","225627",1996,404,288,116,46,6,40,13.89,0.1389,0.114,0.052
"3546","226231",1996,163,35,128,26,19,7,20,0.2,0.16,0.148
"3547","226833",1996,602,312,290,52,17,35,11.22,0.1122,0.086,0.059
"3548","227216",1996,2268,1304,964,256,70,186,14.26,0.1426,0.113,0.073
"3549","227331",1996,355,257,98,66,12,54,21.01,0.2101,0.186,0.122
"3550","227526",1996,1166,568,598,133,48,85,14.96,0.1496,0.114,0.08
"3551","227757",1996,668,314,354,499,240,259,82.48,0.8248,0.747,0.678
"3552","227845",1996,373,239,134,107,35,72,30.13,0.3013,0.287,0.261
"3553","227863",1996,222,136,86,55,19,36,26.47,0.2647,0.248,0.221
"3554","228042",1996,180,112,68,34,10,24,21.43,0.2143,0.189,0.147
"3555","228149",1996,507,312,195,177,56,121,38.78,0.3878,0.349,0.287
"3556","228246",1996,1217,663,554,687,270,417,62.9,0.629,0.565,0.487
"3557","228343",1996,310,198,112,179,60,119,60.1,0.601,0.577,0.536
"3558","228431",1996,2007,1188,819,332,71,261,21.97,0.2197,0.165,0.087
"3559","228459",1996,2396,1472,924,408,88,320,21.74,0.2174,0.17,0.095
"3560","228501",1996,355,135,220,22,8,14,10.37,0.1037,0.062,0.036
"3561","228529",1996,919,455,464,117,35,82,18.02,0.1802,0.127,0.075
"3562","228705",1996,916,406,510,55,22,33,8.13,0.0813,0.06,0.043
"3563","228723",1996,6326,3218,3108,1931,625,1306,40.58,0.4058,0.305,0.201
"3564","228769",1996,1208,617,591,235,90,145,23.5,0.235,0.195,0.152
"3565","228778",1996,6281,3087,3194,2420,985,1435,46.49,0.4649,0.385,0.308
"3566","228787",1996,451,199,252,138,59,79,39.7,0.397,0.306,0.234
"3567","228796",1996,1393,728,665,38,13,25,3.43,0.0343,0.027,0.02
"3568","228875",1996,1238,735,503,502,181,321,43.67,0.4367,0.405,0.36
"3569","228981",1996,210,132,78,79,23,56,42.42,0.4242,0.376,0.295
"3570","229018",1996,108,58,50,10,6,4,6.9,0.069,0.093,0.12
"3571","229027",1996,1679,852,827,93,39,54,6.34,0.0634,0.055,0.047
"3572","229115",1996,3632,1860,1772,746,252,494,26.56,0.2656,0.205,0.142
"3573","229780",1996,228,134,94,41,10,31,23.13,0.2313,0.18,0.106
"3574","229814",1996,849,411,438,167,69,98,23.84,0.2384,0.197,0.158
"3575","230603",1996,626,443,183,69,19,50,11.29,0.1129,0.11,0.104
"3576","230728",1996,967,685,282,267,41,226,32.99,0.3299,0.276,0.145
"3577","230764",1996,1800,1019,781,436,155,281,27.58,0.2758,0.242,0.198
"3578","230782",1996,1237,833,404,136,25,111,13.33,0.1333,0.11,0.062
"3579","231059",1996,486,284,202,335,138,197,69.37,0.6937,0.689,0.683
"3580","231174",1996,1779,971,808,915,374,541,55.72,0.5572,0.514,0.463
"3581","231420",1996,149,81,68,42,20,22,27.16,0.2716,0.282,0.294
"3582","231554",1996,109,56,53,39,20,19,33.93,0.3393,0.358,0.377
"3583","231624",1996,1328,789,539,1053,381,672,85.17,0.8517,0.793,0.707
"3584","231712",1996,517,304,213,65,16,49,16.12,0.1612,0.126,0.075
"3585","232025",1996,256,121,135,123,52,71,58.68,0.5868,0.48,0.385
"3586","232043",1996,228,143,85,90,26,64,44.76,0.4476,0.395,0.306
"3587","232089",1996,309,111,198,59,24,35,31.53,0.3153,0.191,0.121
"3588","232186",1996,1875,1040,835,480,150,330,31.73,0.3173,0.256,0.18
"3589","232265",1996,917,591,326,358,70,288,48.73,0.4873,0.39,0.215
"3590","232423",1996,3258,1878,1380,1958,704,1254,66.77,0.6677,0.601,0.51
"3591","232557",1996,1253,635,618,253,91,162,25.51,0.2551,0.202,0.147
"3592","232566",1996,657,447,210,242,53,189,42.28,0.4228,0.368,0.252
"3593","232609",1996,287,169,118,151,51,100,59.17,0.5917,0.526,0.432
"3594","232681",1996,729,504,225,450,112,338,67.06,0.6706,0.617,0.498
"3595","232706",1996,212,145,67,102,27,75,51.72,0.5172,0.481,0.403
"3596","232937",1996,1329,809,520,124,34,90,11.12,0.1112,0.093,0.065
"3597","232982",1996,1478,803,675,210,60,150,18.68,0.1868,0.142,0.089
"3598","233277",1996,1419,867,552,476,141,335,38.64,0.3864,0.335,0.255
"3599","233374",1996,793,399,394,610,284,326,81.7,0.817,0.769,0.721
"3600","233426",1996,437,278,159,263,84,179,64.39,0.6439,0.602,0.528
"3601","233541",1996,251,149,102,59,14,45,30.2,0.302,0.235,0.137
"3602","233897",1996,247,132,115,69,31,38,28.79,0.2879,0.279,0.27
"3603","233921",1996,5057,2061,2996,2120,970,1150,55.8,0.558,0.419,0.324
"3604","234030",1996,1875,1146,729,352,103,249,21.73,0.2173,0.188,0.141
"3605","234085",1996,339,0,339,170,170,0,NA,NA,0.501,0.501
"3606","234155",1996,782,465,317,186,47,139,29.89,0.2989,0.238,0.148
"3607","234164",1996,380,211,169,75,16,59,27.96,0.2796,0.197,0.095
"3608","235097",1996,639,399,240,114,29,85,21.3,0.213,0.178,0.121
"3609","235167",1996,530,308,222,200,74,126,40.91,0.4091,0.377,0.333
"3610","236230",1996,610,359,251,284,97,187,52.09,0.5209,0.466,0.386
"3611","236328",1996,740,445,295,459,171,288,64.72,0.6472,0.62,0.58
"3612","236577",1996,465,323,142,173,52,121,37.46,0.3746,0.372,0.366
"3613","236595",1996,576,358,218,245,78,167,46.65,0.4665,0.425,0.358
"3614","236896",1996,292,144,148,40,18,22,15.28,0.1528,0.137,0.122
"3615","236939",1996,2272,1169,1103,694,263,431,36.87,0.3687,0.305,0.238
"3616","236948",1996,3789,1964,1825,1613,648,965,49.13,0.4913,0.426,0.355
"3617","237011",1996,2026,1177,849,507,176,331,28.12,0.2812,0.25,0.207
"3618","237057",1996,355,207,148,274,111,163,78.74,0.7874,0.772,0.75
"3619","237066",1996,315,193,122,177,56,121,62.69,0.6269,0.562,0.459
"3620","237215",1996,384,207,177,4,1,3,1.45,0.0145,0.01,0.006
"3621","237330",1996,582,301,281,107,34,73,24.25,0.2425,0.184,0.121
"3622","237358",1996,120,66,54,27,16,11,16.67,0.1667,0.225,0.296
"3623","237367",1996,1049,570,479,119,43,76,13.33,0.1333,0.113,0.09
"3624","237792",1996,617,363,254,97,24,73,20.11,0.2011,0.157,0.094
"3625","237899",1996,529,254,275,28,10,18,7.09,0.0709,0.053,0.036
"3626","237932",1996,464,250,214,77,20,57,22.8,0.228,0.166,0.093
"3627","237969",1996,377,204,173,161,57,104,50.98,0.5098,0.427,0.329
"3628","238032",1996,3065,1499,1566,817,335,482,32.15,0.3215,0.267,0.214
"3629","238333",1996,284,147,137,175,76,99,67.35,0.6735,0.616,0.555
"3630","238430",1996,253,174,79,40,16,24,13.79,0.1379,0.158,0.203
"3631","238458",1996,450,295,155,214,67,147,49.83,0.4983,0.476,0.432
"3632","238476",1996,401,210,191,215,87,128,60.95,0.6095,0.536,0.455
"3633","238616",1996,254,138,116,117,44,73,52.9,0.529,0.461,0.379
"3634","238661",1996,210,152,58,40,4,36,23.68,0.2368,0.19,0.069
"3635","239080",1996,199,126,73,53,21,32,25.4,0.254,0.266,0.288
"3636","239105",1996,1420,799,621,803,303,500,62.58,0.6258,0.565,0.488
"3637","239628",1996,169,97,72,81,28,53,54.64,0.5464,0.479,0.389
"3638","239716",1996,508,321,187,339,121,218,67.91,0.6791,0.667,0.647
"3639","240107",1996,284,195,89,70,10,60,30.77,0.3077,0.246,0.112
"3640","240189",1996,1825,995,830,369,137,232,23.32,0.2332,0.202,0.165
"3641","240277",1996,939,581,358,138,48,90,15.49,0.1549,0.147,0.134
"3642","240329",1996,1721,1074,647,393,109,284,26.44,0.2644,0.228,0.168
"3643","240338",1996,101,71,30,55,12,43,60.56,0.6056,0.545,0.4
"3644","240365",1996,1501,855,646,227,65,162,18.95,0.1895,0.151,0.101
"3645","240374",1996,606,354,252,49,14,35,9.89,0.0989,0.081,0.056
"3646","240417",1996,1275,644,631,194,61,133,20.65,0.2065,0.152,0.097
"3647","240426",1996,308,158,150,42,13,29,18.35,0.1835,0.136,0.087
"3648","240444",1996,5394,2954,2440,2090,769,1321,44.72,0.4472,0.387,0.315
"3649","240453",1996,2033,1113,920,233,88,145,13.03,0.1303,0.115,0.096
"3650","240462",1996,933,300,633,120,59,61,20.33,0.2033,0.129,0.093
"3651","240471",1996,1149,688,461,249,82,167,24.27,0.2427,0.217,0.178
"3652","240480",1996,1555,806,749,301,97,204,25.31,0.2531,0.194,0.13
"3653","240727",1996,1203,628,575,297,101,196,31.21,0.3121,0.247,0.176
"3654","243443",1996,780,483,297,46,11,35,7.25,0.0725,0.059,0.037
"3655","243780",1996,6339,2713,3626,1843,903,940,34.65,0.3465,0.291,0.249
"3656","100654",1997,789,412,377,159,41,118,28.64,0.2864,0.202,0.109
"3657","100663",1997,1115,657,458,161,52,109,16.59,0.1659,0.144,0.114
"3658","100751",1997,2572,1403,1169,859,307,552,39.34,0.3934,0.334,0.263
"3659","100858",1997,3140,1676,1464,1165,385,780,46.54,0.4654,0.371,0.263
"3660","101435",1997,191,114,77,89,28,61,53.51,0.5351,0.466,0.364
"3661","101480",1997,764,401,363,123,43,80,19.95,0.1995,0.161,0.118
"3662","101675",1997,374,169,205,3,2,1,0.59,0.0059,0.008,0.01
"3663","101879",1997,751,448,303,111,20,91,20.31,0.2031,0.148,0.066
"3664","102049",1997,745,470,275,405,139,266,56.6,0.566,0.544,0.505
"3665","102094",1997,1132,663,469,138,38,100,15.08,0.1508,0.122,0.081
"3666","102234",1997,254,144,110,118,55,63,43.75,0.4375,0.465,0.5
"3667","102368",1997,803,474,329,307,109,198,41.77,0.4177,0.382,0.331
"3668","102377",1997,713,466,247,179,29,150,32.19,0.3219,0.251,0.117
"3669","104151",1997,4938,2646,2292,1284,448,836,31.59,0.3159,0.26,0.195
"3670","104179",1997,4431,2409,2022,1294,463,831,34.5,0.345,0.292,0.229
"3671","105330",1997,1983,1169,814,530,154,376,32.16,0.3216,0.267,0.189
"3672","106245",1997,841,503,338,46,13,33,6.56,0.0656,0.055,0.038
"3673","106342",1997,125,63,62,54,19,35,55.56,0.5556,0.432,0.306
"3674","106397",1997,2125,1077,1048,515,191,324,30.08,0.3008,0.242,0.182
"3675","106412",1997,608,297,311,51,12,39,13.13,0.1313,0.084,0.039
"3676","106458",1997,1687,922,765,249,89,160,17.35,0.1735,0.148,0.116
"3677","106467",1997,725,376,349,83,32,51,13.56,0.1356,0.114,0.092
"3678","106485",1997,620,342,278,47,8,39,11.4,0.114,0.076,0.029
"3679","106704",1997,1598,1031,567,284,55,229,22.21,0.2221,0.178,0.097
"3680","107044",1997,863,495,368,271,85,186,37.58,0.3758,0.314,0.231
"3681","107080",1997,329,193,136,184,76,108,55.96,0.5596,0.559,0.559
"3682","107141",1997,225,121,104,83,37,46,38.02,0.3802,0.369,0.356
"3683","107512",1997,404,230,174,164,59,105,45.65,0.4565,0.406,0.339
"3684","107558",1997,155,66,89,44,21,23,34.85,0.3485,0.284,0.236
"3685","110097",1997,437,296,141,204,60,144,48.65,0.4865,0.467,0.426
"3686","110404",1997,217,64,153,169,119,50,78.12,0.7812,0.779,0.778
"3687","110422",1997,2114,951,1163,318,108,210,22.08,0.2208,0.15,0.093
"3688","110486",1997,467,288,179,49,15,34,11.81,0.1181,0.105,0.084
"3689","110495",1997,409,270,139,84,19,65,24.07,0.2407,0.205,0.137
"3690","110510",1997,890,559,331,83,26,57,10.2,0.102,0.093,0.079
"3691","110529",1997,1856,810,1046,157,56,101,12.47,0.1247,0.085,0.054
"3692","110538",1997,1618,948,670,246,45,201,21.2,0.212,0.152,0.067
"3693","110547",1997,512,363,149,17,2,15,4.13,0.0413,0.033,0.013
"3694","110556",1997,1510,901,609,180,69,111,12.32,0.1232,0.119,0.113
"3695","110565",1997,2192,1317,875,215,48,167,12.68,0.1268,0.098,0.055
"3696","110574",1997,711,451,260,94,26,68,15.08,0.1508,0.132,0.1
"3697","110583",1997,2498,1597,901,205,60,145,9.08,0.0908,0.082,0.067
"3698","110592",1997,1274,828,446,82,17,65,7.85,0.0785,0.064,0.038
"3699","110617",1997,1350,777,573,95,31,64,8.24,0.0824,0.07,0.054
"3700","113698",1997,74,55,19,24,5,19,34.55,0.3455,0.324,0.263
"3701","115755",1997,718,401,317,85,14,71,17.71,0.1771,0.118,0.044
"3702","119173",1997,258,258,0,82,0,82,31.78,0.3178,0.318,NA
"3703","120184",1997,129,79,50,38,15,23,29.11,0.2911,0.295,0.3
"3704","121309",1997,494,306,188,187,64,123,40.2,0.402,0.379,0.34
"3705","121345",1997,393,195,198,338,166,172,88.21,0.8821,0.86,0.838
"3706","122409",1997,3008,1766,1242,280,73,207,11.72,0.1172,0.093,0.059
"3707","122436",1997,1036,630,406,589,194,395,62.7,0.627,0.569,0.478
"3708","122597",1997,1732,1086,646,115,36,79,7.27,0.0727,0.066,0.056
"3709","122612",1997,600,385,215,285,96,189,49.09,0.4909,0.475,0.447
"3710","122931",1997,1004,543,461,766,328,438,80.66,0.8066,0.763,0.711
"3711","123554",1997,596,348,248,390,144,246,70.69,0.7069,0.654,0.581
"3712","123572",1997,872,581,291,192,43,149,25.65,0.2565,0.22,0.148
"3713","126562",1997,439,245,194,63,23,40,16.33,0.1633,0.144,0.119
"3714","126580",1997,519,298,221,83,27,56,18.79,0.1879,0.16,0.122
"3715","126614",1997,4259,2157,2102,1565,633,932,43.21,0.4321,0.367,0.301
"3716","126818",1997,2615,1435,1180,861,304,557,38.82,0.3882,0.329,0.258
"3717","127060",1997,689,354,335,387,173,214,60.45,0.6045,0.562,0.516
"3718","127185",1997,1056,450,606,97,39,58,12.89,0.1289,0.092,0.064
"3719","127565",1997,1478,787,691,69,19,50,6.35,0.0635,0.047,0.027
"3720","127741",1997,1905,1147,758,490,107,383,33.39,0.3339,0.257,0.141
"3721","128106",1997,580,299,281,49,20,29,9.7,0.097,0.084,0.071
"3722","128744",1997,187,93,94,58,24,34,36.56,0.3656,0.31,0.255
"3723","128771",1997,1213,626,587,82,36,46,7.35,0.0735,0.068,0.061
"3724","129020",1997,2172,1181,991,977,340,637,53.94,0.5394,0.45,0.343
"3725","129242",1997,876,462,414,649,286,363,78.57,0.7857,0.741,0.691
"3726","129941",1997,324,130,194,87,46,41,31.54,0.3154,0.269,0.237
"3727","130253",1997,632,377,255,297,113,184,48.81,0.4881,0.47,0.443
"3728","130314",1997,174,174,0,87,0,87,50,0.5,0.5,NA
"3729","130493",1997,1089,624,465,146,39,107,17.15,0.1715,0.134,0.084
"3730","130590",1997,500,220,280,386,205,181,82.27,0.8227,0.772,0.732
"3731","130697",1997,700,371,329,583,263,320,86.25,0.8625,0.833,0.799
"3732","130776",1997,668,303,365,90,35,55,18.15,0.1815,0.135,0.096
"3733","130794",1997,1307,662,645,1170,552,618,93.35,0.9335,0.895,0.856
"3734","130934",1997,637,359,278,121,35,86,23.96,0.2396,0.19,0.126
"3735","130943",1997,3179,1881,1298,1823,622,1201,63.85,0.6385,0.573,0.479
"3736","131159",1997,1056,665,391,678,239,439,66.02,0.6602,0.642,0.611
"3737","131283",1997,567,313,254,337,148,189,60.38,0.6038,0.594,0.583
"3738","131450",1997,211,116,95,10,3,7,6.03,0.0603,0.047,0.032
"3739","131469",1997,1716,972,744,1185,485,700,72.02,0.7202,0.691,0.652
"3740","131496",1997,1394,757,637,1247,561,686,90.62,0.9062,0.895,0.881
"3741","131520",1997,1098,715,383,402,98,304,42.52,0.4252,0.366,0.256
"3742","132471",1997,176,112,64,58,18,40,35.71,0.3571,0.33,0.281
"3743","132602",1997,749,388,361,77,25,52,13.4,0.134,0.103,0.069
"3744","132903",1997,2839,1510,1329,785,265,520,34.44,0.3444,0.277,0.199
"3745","133492",1997,386,230,156,230,88,142,61.74,0.6174,0.596,0.564
"3746","133553",1997,1020,136,884,213,184,29,21.32,0.2132,0.209,0.208
"3747","133650",1997,1947,1148,799,328,84,244,21.25,0.2125,0.168,0.105
"3748","133669",1997,1174,669,505,161,54,107,15.99,0.1599,0.137,0.107
"3749","133711",1997,424,272,152,176,55,121,44.49,0.4449,0.415,0.362
"3750","133881",1997,367,112,255,128,84,44,39.29,0.3929,0.349,0.329
"3751","133951",1997,1987,1144,843,352,91,261,22.81,0.2281,0.177,0.108
"3752","134079",1997,428,270,158,196,67,129,47.78,0.4778,0.458,0.424
"3753","134097",1997,4491,2525,1966,1822,606,1216,48.16,0.4816,0.406,0.308
"3754","134130",1997,5959,3307,2652,2950,1073,1877,56.76,0.5676,0.495,0.405
"3755","134945",1997,290,125,165,65,19,46,36.8,0.368,0.224,0.115
"3756","135726",1997,1814,960,854,962,421,541,56.35,0.5635,0.53,0.493
"3757","136172",1997,1105,646,459,269,77,192,29.72,0.2972,0.243,0.168
"3758","136950",1997,415,253,162,192,65,127,50.2,0.502,0.463,0.401
"3759","137546",1997,504,289,215,283,104,179,61.94,0.6194,0.562,0.484
"3760","138354",1997,620,372,248,101,28,73,19.62,0.1962,0.163,0.113
"3761","138716",1997,575,359,216,35,9,26,7.24,0.0724,0.061,0.042
"3762","138789",1997,690,470,220,50,7,43,9.15,0.0915,0.072,0.032
"3763","139144",1997,504,332,172,295,99,196,59.04,0.5904,0.585,0.576
"3764","139366",1997,612,354,258,53,14,39,11.02,0.1102,0.087,0.054
"3765","139393",1997,197,112,85,89,31,58,51.79,0.5179,0.452,0.365
"3766","139658",1997,1477,762,715,1120,525,595,78.08,0.7808,0.758,0.734
"3767","139719",1997,502,270,232,75,19,56,20.74,0.2074,0.149,0.082
"3768","139755",1997,2069,565,1504,487,305,182,32.21,0.3221,0.235,0.203
"3769","139764",1997,449,283,166,85,29,56,19.79,0.1979,0.189,0.175
"3770","139861",1997,818,528,290,130,31,99,18.75,0.1875,0.159,0.107
"3771","139931",1997,2596,1387,1209,306,81,225,16.22,0.1622,0.118,0.067
"3772","139940",1997,1906,1172,734,211,60,151,12.88,0.1288,0.111,0.082
"3773","139959",1997,4348,2544,1804,1729,569,1160,45.6,0.456,0.398,0.315
"3774","140447",1997,679,428,251,215,70,145,33.88,0.3388,0.317,0.279
"3775","140960",1997,455,240,215,19,4,15,6.25,0.0625,0.042,0.019
"3776","140988",1997,242,162,80,90,26,64,39.51,0.3951,0.372,0.325
"3777","141185",1997,263,157,106,79,29,50,31.85,0.3185,0.3,0.274
"3778","141264",1997,1594,947,647,179,50,129,13.62,0.1362,0.112,0.077
"3779","141334",1997,1208,718,490,135,29,106,14.76,0.1476,0.112,0.059
"3780","141486",1997,146,105,41,30,9,21,20,0.2,0.205,0.22
"3781","141565",1997,335,202,133,36,11,25,12.38,0.1238,0.107,0.083
"3782","141574",1997,1439,807,632,174,50,124,15.37,0.1537,0.121,0.079
"3783","142276",1997,1400,793,607,44,11,33,4.16,0.0416,0.031,0.018
"3784","142285",1997,1360,687,673,240,82,158,23,0.23,0.176,0.122
"3785","142461",1997,277,148,129,91,37,54,36.49,0.3649,0.329,0.287
"3786","143084",1997,564,328,236,400,146,254,77.44,0.7744,0.709,0.619
"3787","143288",1997,155,81,74,39,11,28,34.57,0.3457,0.252,0.149
"3788","144005",1997,487,332,155,6,1,5,1.51,0.0151,0.012,0.006
"3789","144281",1997,1078,519,559,147,61,86,16.57,0.1657,0.136,0.109
"3790","144740",1997,1211,713,498,566,212,354,49.65,0.4965,0.467,0.426
"3791","144892",1997,1552,950,602,479,121,358,37.68,0.3768,0.309,0.201
"3792","144962",1997,289,155,134,2,1,1,0.65,0.0065,0.007,0.007
"3793","144971",1997,141,50,91,54,25,29,58,0.58,0.383,0.275
"3794","145600",1997,2820,1560,1260,460,165,295,18.91,0.1891,0.163,0.131
"3795","145619",1997,300,129,171,117,56,61,47.29,0.4729,0.39,0.327
"3796","145637",1997,5789,2865,2924,3331,1523,1808,63.11,0.6311,0.575,0.521
"3797","145691",1997,242,148,94,102,30,72,48.65,0.4865,0.421,0.319
"3798","145813",1997,3253,1981,1272,1016,297,719,36.29,0.3629,0.312,0.233
"3799","146481",1997,337,191,146,205,77,128,67.02,0.6702,0.608,0.527
"3800","146612",1997,386,176,210,145,70,75,42.61,0.4261,0.376,0.333
"3801","146719",1997,1189,758,431,558,189,369,48.68,0.4868,0.469,0.439
"3802","146825",1997,127,49,78,47,24,23,46.94,0.4694,0.37,0.308
"3803","147013",1997,242,131,111,98,35,63,48.09,0.4809,0.405,0.315
"3804","147244",1997,569,302,267,286,112,174,57.62,0.5762,0.503,0.419
"3805","147341",1997,272,176,96,150,48,102,57.95,0.5795,0.551,0.5
"3806","147703",1997,2673,1444,1229,691,252,439,30.4,0.304,0.259,0.205
"3807","147767",1997,1889,959,930,1578,743,835,87.07,0.8707,0.835,0.799
"3808","147776",1997,1007,630,377,25,9,16,2.54,0.0254,0.025,0.024
"3809","147828",1997,426,229,197,170,53,117,51.09,0.5109,0.399,0.269
"3810","148131",1997,224,116,108,77,26,51,43.97,0.4397,0.344,0.241
"3811","148496",1997,199,140,59,99,28,71,50.71,0.5071,0.497,0.475
"3812","148584",1997,134,82,52,48,13,35,42.68,0.4268,0.358,0.25
"3813","148627",1997,270,180,90,82,21,61,33.89,0.3389,0.304,0.233
"3814","149222",1997,2400,1051,1349,451,188,263,25.02,0.2502,0.188,0.139
"3815","149231",1997,1219,734,485,242,65,177,24.11,0.2411,0.199,0.134
"3816","149772",1997,1602,833,769,450,180,270,32.41,0.3241,0.281,0.234
"3817","149781",1997,546,290,256,418,189,229,78.97,0.7897,0.766,0.738
"3818","150066",1997,451,266,185,172,54,118,44.36,0.4436,0.381,0.292
"3819","150136",1997,4047,2177,1870,837,242,595,27.33,0.2733,0.207,0.129
"3820","150145",1997,223,144,79,97,33,64,44.44,0.4444,0.435,0.418
"3821","150163",1997,699,458,241,369,120,249,54.37,0.5437,0.528,0.498
"3822","150400",1997,673,363,310,493,228,265,73,0.73,0.733,0.735
"3823","150534",1997,719,424,295,312,108,204,48.11,0.4811,0.434,0.366
"3824","150668",1997,209,116,93,89,32,57,49.14,0.4914,0.426,0.344
"3825","150941",1997,197,129,68,95,21,74,57.36,0.5736,0.482,0.309
"3826","151102",1997,1196,659,537,49,7,42,6.37,0.0637,0.041,0.013
"3827","151111",1997,2154,1198,956,113,55,58,4.84,0.0484,0.052,0.058
"3828","151306",1997,1839,1053,786,239,63,176,16.71,0.1671,0.13,0.08
"3829","151324",1997,1878,998,880,356,127,229,22.95,0.2295,0.19,0.144
"3830","151333",1997,306,204,102,17,5,12,5.88,0.0588,0.056,0.049
"3831","151342",1997,629,384,245,47,20,27,7.03,0.0703,0.075,0.082
"3832","151351",1997,6036,3497,2539,2827,1045,1782,50.96,0.5096,0.468,0.412
"3833","151360",1997,508,340,168,21,7,14,4.12,0.0412,0.041,0.042
"3834","151379",1997,641,376,265,57,12,45,11.97,0.1197,0.089,0.045
"3835","151388",1997,278,193,85,14,7,7,3.63,0.0363,0.05,0.082
"3836","151777",1997,288,135,153,122,47,75,55.56,0.5556,0.424,0.307
"3837","151786",1997,255,156,99,73,21,52,33.33,0.3333,0.286,0.212
"3838","152080",1997,1904,875,1029,1675,879,796,90.97,0.9097,0.88,0.854
"3839","152248",1997,1071,556,515,101,49,52,9.35,0.0935,0.094,0.095
"3840","152363",1997,267,138,129,112,46,66,47.83,0.4783,0.419,0.357
"3841","152530",1997,486,262,224,321,143,178,67.94,0.6794,0.66,0.638
"3842","152600",1997,702,382,320,416,163,253,66.23,0.6623,0.593,0.509
"3843","153001",1997,385,185,200,169,70,99,53.51,0.5351,0.439,0.35
"3844","153108",1997,306,178,128,183,67,116,65.17,0.6517,0.598,0.523
"3845","153269",1997,636,368,268,389,141,248,67.39,0.6739,0.612,0.526
"3846","153384",1997,413,234,179,330,140,190,81.2,0.812,0.799,0.782
"3847","153603",1997,4007,1790,2217,1081,437,644,35.98,0.3598,0.27,0.197
"3848","153834",1997,629,385,244,431,161,270,70.13,0.7013,0.685,0.66
"3849","154095",1997,1920,1192,728,553,169,384,32.21,0.3221,0.288,0.232
"3850","155089",1997,179,99,80,39,11,28,28.28,0.2828,0.218,0.138
"3851","155317",1997,3808,1989,1819,1093,424,669,33.63,0.3363,0.287,0.233
"3852","155335",1997,89,50,39,22,10,12,24,0.24,0.247,0.256
"3853","155399",1997,2906,1382,1524,640,232,408,29.52,0.2952,0.22,0.152
"3854","155520",1997,256,140,116,107,38,69,49.29,0.4929,0.418,0.328
"3855","155627",1997,149,39,110,39,23,16,41.03,0.4103,0.262,0.209
"3856","155937",1997,140,56,84,45,21,24,42.86,0.4286,0.321,0.25
"3857","156213",1997,365,223,142,179,66,113,50.67,0.5067,0.49,0.465
"3858","156286",1997,318,178,140,155,62,93,52.25,0.5225,0.487,0.443
"3859","156295",1997,404,239,165,118,36,82,34.31,0.3431,0.292,0.218
"3860","156365",1997,342,182,160,93,32,61,33.52,0.3352,0.272,0.2
"3861","156541",1997,418,227,191,87,30,57,25.11,0.2511,0.208,0.157
"3862","156745",1997,394,239,155,208,59,149,62.34,0.6234,0.528,0.381
"3863","157058",1997,302,172,130,33,5,28,16.28,0.1628,0.109,0.038
"3864","157076",1997,203,131,72,84,27,57,43.51,0.4351,0.414,0.375
"3865","157085",1997,2740,1499,1241,743,281,462,30.82,0.3082,0.271,0.226
"3866","157289",1997,1931,1024,907,241,86,155,15.14,0.1514,0.125,0.095
"3867","157386",1997,1227,674,553,160,55,105,15.58,0.1558,0.13,0.099
"3868","157401",1997,1206,691,515,184,51,133,19.25,0.1925,0.153,0.099
"3869","157447",1997,1657,949,708,84,21,63,6.64,0.0664,0.051,0.03
"3870","157535",1997,178,110,68,25,8,17,15.45,0.1545,0.14,0.118
"3871","157951",1997,2205,1244,961,445,148,297,23.87,0.2387,0.202,0.154
"3872","158477",1997,226,116,110,88,28,60,51.72,0.5172,0.389,0.255
"3873","159009",1997,799,408,391,52,25,27,6.62,0.0662,0.065,0.064
"3874","159391",1997,4443,2533,1910,959,319,640,25.27,0.2527,0.216,0.167
"3875","159647",1997,1428,714,714,361,133,228,31.93,0.3193,0.253,0.186
"3876","159717",1997,1447,779,668,116,27,89,11.42,0.1142,0.08,0.04
"3877","159966",1997,1075,646,429,81,14,67,10.37,0.1037,0.075,0.033
"3878","160038",1997,1415,878,537,129,35,94,10.71,0.1071,0.091,0.065
"3879","160612",1997,2487,1371,1116,107,24,83,6.05,0.0605,0.043,0.022
"3880","160621",1997,1853,997,856,106,28,78,7.82,0.0782,0.057,0.033
"3881","160658",1997,2764,1543,1221,169,44,125,8.1,0.081,0.061,0.036
"3882","161004",1997,473,246,227,384,175,209,84.96,0.8496,0.812,0.771
"3883","161226",1997,466,308,158,148,28,120,38.96,0.3896,0.318,0.177
"3884","161235",1997,77,47,30,5,0,5,10.64,0.1064,0.065,0
"3885","161244",1997,121,63,58,9,3,6,9.52,0.0952,0.074,0.052
"3886","161253",1997,1091,513,578,327,144,183,35.67,0.3567,0.3,0.249
"3887","161554",1997,760,450,310,90,31,59,13.11,0.1311,0.118,0.1
"3888","162007",1997,357,190,167,44,8,36,18.95,0.1895,0.123,0.048
"3889","162210",1997,164,99,65,34,11,23,23.23,0.2323,0.207,0.169
"3890","162283",1997,382,268,114,17,3,14,5.22,0.0522,0.045,0.026
"3891","162584",1997,865,444,421,210,71,139,31.31,0.3131,0.243,0.169
"3892","162654",1997,335,255,80,212,49,163,63.92,0.6392,0.633,0.613
"3893","162760",1997,162,158,4,109,3,106,67.09,0.6709,0.673,0.75
"3894","162928",1997,941,411,530,749,411,338,82.24,0.8224,0.796,0.775
"3895","163046",1997,833,478,355,650,258,392,82.01,0.8201,0.78,0.727
"3896","163268",1997,1135,605,530,343,133,210,34.71,0.3471,0.302,0.251
"3897","163286",1997,3950,1873,2077,1699,731,968,51.68,0.5168,0.43,0.352
"3898","163453",1997,1016,588,428,176,30,146,24.83,0.2483,0.173,0.07
"3899","163462",1997,325,179,146,221,95,126,70.39,0.7039,0.68,0.651
"3900","163851",1997,886,515,371,418,133,285,55.34,0.5534,0.472,0.358
"3901","163912",1997,345,194,151,232,92,140,72.16,0.7216,0.672,0.609
"3902","164076",1997,1808,1079,729,557,166,391,36.24,0.3624,0.308,0.228
"3903","164173",1997,367,259,108,122,21,101,39,0.39,0.332,0.194
"3904","164216",1997,290,162,128,182,79,103,63.58,0.6358,0.628,0.617
"3905","164270",1997,427,241,186,274,98,176,73.03,0.7303,0.642,0.527
"3906","164447",1997,253,133,120,79,30,49,36.84,0.3684,0.312,0.25
"3907","164492",1997,135,90,45,54,19,35,38.89,0.3889,0.4,0.422
"3908","164562",1997,582,365,217,386,137,249,68.22,0.6822,0.663,0.631
"3909","165015",1997,794,470,324,633,250,383,81.49,0.8149,0.797,0.772
"3910","165024",1997,1147,672,475,206,46,160,23.81,0.2381,0.18,0.097
"3911","165334",1997,520,313,207,313,110,203,64.86,0.6486,0.602,0.531
"3912","165662",1997,547,333,214,343,130,213,63.96,0.6396,0.627,0.607
"3913","165671",1997,112,112,0,59,0,59,52.68,0.5268,0.527,NA
"3914","165820",1997,488,270,218,104,29,75,27.78,0.2778,0.213,0.133
"3915","165866",1997,590,397,193,120,25,95,23.93,0.2393,0.203,0.13
"3916","165936",1997,406,279,127,206,68,138,49.46,0.4946,0.507,0.535
"3917","166027",1997,1642,782,860,1436,744,692,88.49,0.8849,0.875,0.865
"3918","166124",1997,726,409,317,635,270,365,89.24,0.8924,0.875,0.852
"3919","166513",1997,989,367,622,232,104,128,34.88,0.3488,0.235,0.167
"3920","166629",1997,3831,2012,1819,1635,614,1021,50.75,0.5075,0.427,0.338
"3921","166638",1997,533,284,249,65,25,40,14.08,0.1408,0.122,0.1
"3922","166683",1997,1066,405,661,861,521,340,83.95,0.8395,0.808,0.788
"3923","167288",1997,274,152,122,89,30,59,38.82,0.3882,0.325,0.246
"3924","167987",1997,835,440,395,217,72,145,32.95,0.3295,0.26,0.182
"3925","167996",1997,530,287,243,429,185,244,85.02,0.8502,0.809,0.761
"3926","168005",1997,525,299,226,198,70,128,42.81,0.4281,0.377,0.31
"3927","168148",1997,1270,659,611,1063,498,565,85.74,0.8574,0.837,0.815
"3928","168254",1997,526,220,306,210,98,112,50.91,0.5091,0.399,0.32
"3929","168281",1997,438,277,161,298,97,201,72.56,0.7256,0.68,0.602
"3930","168342",1997,544,266,278,499,253,246,92.48,0.9248,0.917,0.91
"3931","168546",1997,474,260,214,301,114,187,71.92,0.7192,0.635,0.533
"3932","168786",1997,329,204,125,79,30,49,24.02,0.2402,0.24,0.24
"3933","169080",1997,1053,614,439,595,243,352,57.33,0.5733,0.565,0.554
"3934","169798",1997,2314,1372,942,260,80,180,13.12,0.1312,0.112,0.085
"3935","169910",1997,1906,763,1143,46,21,25,3.28,0.0328,0.024,0.018
"3936","170082",1997,2406,1494,912,410,120,290,19.41,0.1941,0.17,0.132
"3937","170301",1997,721,432,289,450,164,286,66.2,0.662,0.624,0.567
"3938","170532",1997,290,170,120,201,78,123,72.35,0.7235,0.693,0.65
"3939","170639",1997,522,239,283,71,34,37,15.48,0.1548,0.136,0.12
"3940","170976",1997,5535,2763,2772,3619,1656,1963,71.05,0.7105,0.654,0.597
"3941","171100",1997,6804,3723,3081,2232,751,1481,39.78,0.3978,0.328,0.244
"3942","171128",1997,1251,295,956,329,224,105,35.59,0.3559,0.263,0.234
"3943","171137",1997,696,378,318,96,29,67,17.72,0.1772,0.138,0.091
"3944","171146",1997,552,337,215,30,10,20,5.93,0.0593,0.054,0.047
"3945","171599",1997,228,73,155,2,0,2,2.74,0.0274,0.009,0
"3946","172051",1997,818,461,357,55,12,43,9.33,0.0933,0.067,0.034
"3947","172699",1997,3213,1835,1378,592,211,381,20.76,0.2076,0.184,0.153
"3948","173160",1997,447,281,166,279,98,181,64.41,0.6441,0.624,0.59
"3949","173258",1997,484,255,229,412,195,217,85.1,0.851,0.851,0.852
"3950","173328",1997,222,132,90,86,32,54,40.91,0.4091,0.387,0.356
"3951","173647",1997,625,353,272,438,174,264,74.79,0.7479,0.701,0.64
"3952","173902",1997,450,251,199,339,140,199,79.28,0.7928,0.753,0.704
"3953","174066",1997,4371,2282,2089,1208,467,741,32.47,0.3247,0.276,0.224
"3954","174233",1997,1679,843,836,363,140,223,26.45,0.2645,0.216,0.167
"3955","174251",1997,461,271,190,161,53,108,39.85,0.3985,0.349,0.279
"3956","174491",1997,372,231,141,162,61,101,43.72,0.4372,0.435,0.433
"3957","174792",1997,450,0,450,335,335,0,NA,NA,0.744,0.744
"3958","174844",1997,722,416,306,539,227,312,75,0.75,0.747,0.742
"3959","174899",1997,244,180,64,141,32,109,60.56,0.6056,0.578,0.5
"3960","174914",1997,955,514,441,595,237,358,69.65,0.6965,0.623,0.537
"3961","175342",1997,532,299,233,138,42,96,32.11,0.3211,0.259,0.18
"3962","175421",1997,86,42,44,28,11,17,40.48,0.4048,0.326,0.25
"3963","175616",1997,521,338,183,136,40,96,28.4,0.284,0.261,0.219
"3964","175856",1997,808,463,345,124,28,96,20.73,0.2073,0.153,0.081
"3965","175980",1997,299,159,140,188,84,104,65.41,0.6541,0.629,0.6
"3966","176017",1997,1770,948,822,578,209,369,38.92,0.3892,0.327,0.254
"3967","176035",1997,231,193,38,71,6,65,33.68,0.3368,0.307,0.158
"3968","176044",1997,343,198,145,73,23,50,25.25,0.2525,0.213,0.159
"3969","176080",1997,2016,965,1051,462,162,300,31.09,0.3109,0.229,0.154
"3970","176406",1997,206,146,60,66,11,55,37.67,0.3767,0.32,0.183
"3971","176628",1997,96,57,39,29,6,23,40.35,0.4035,0.302,0.154
"3972","176947",1997,233,115,118,72,25,47,40.87,0.4087,0.309,0.212
"3973","176965",1997,1323,718,605,298,88,210,29.25,0.2925,0.225,0.145
"3974","177418",1997,171,124,47,50,10,40,32.26,0.3226,0.292,0.213
"3975","178059",1997,223,173,50,114,26,88,50.87,0.5087,0.511,0.52
"3976","178341",1997,675,368,307,61,19,42,11.41,0.1141,0.09,0.062
"3977","178387",1997,985,572,413,135,42,93,16.26,0.1626,0.137,0.102
"3978","178396",1997,3512,1935,1577,1290,461,829,42.84,0.4284,0.367,0.292
"3979","178402",1997,588,321,267,79,27,52,16.2,0.162,0.134,0.101
"3980","178411",1997,692,168,524,99,76,23,13.69,0.1369,0.143,0.145
"3981","178420",1997,458,242,216,60,12,48,19.83,0.1983,0.131,0.056
"3982","178615",1997,1654,1020,634,593,175,418,40.98,0.4098,0.359,0.276
"3983","179043",1997,319,175,144,181,78,103,58.86,0.5886,0.567,0.542
"3984","179159",1997,1084,609,475,601,246,355,58.29,0.5829,0.554,0.518
"3985","179557",1997,1124,713,411,248,65,183,25.67,0.2567,0.221,0.158
"3986","179566",1997,2704,1543,1161,522,180,342,22.16,0.2216,0.193,0.155
"3987","179867",1997,1230,646,584,976,424,552,85.45,0.8545,0.793,0.726
"3988","179894",1997,314,193,121,124,41,83,43.01,0.4301,0.395,0.339
"3989","179946",1997,190,71,119,78,40,38,53.52,0.5352,0.411,0.336
"3990","180179",1997,508,334,174,121,28,93,27.84,0.2784,0.238,0.161
"3991","180461",1997,1819,784,1035,259,116,143,18.24,0.1824,0.142,0.112
"3992","180522",1997,235,89,146,28,16,12,13.48,0.1348,0.119,0.11
"3993","180984",1997,277,152,125,64,22,42,27.63,0.2763,0.231,0.176
"3994","181002",1997,798,457,341,466,184,282,61.71,0.6171,0.584,0.54
"3995","181020",1997,260,134,126,135,55,80,59.7,0.597,0.519,0.437
"3996","181127",1997,282,145,137,145,50,95,65.52,0.6552,0.514,0.365
"3997","181215",1997,1005,570,435,174,60,114,20,0.2,0.173,0.138
"3998","181394",1997,1185,615,570,95,33,62,10.08,0.1008,0.08,0.058
"3999","181446",1997,437,250,187,205,87,118,47.2,0.472,0.469,0.465
"4000","181464",1997,3195,1596,1599,681,259,422,26.44,0.2644,0.213,0.162
"4001","181534",1997,258,107,151,38,16,22,20.56,0.2056,0.147,0.106
"4002","181783",1997,707,407,300,161,42,119,29.24,0.2924,0.228,0.14
"4003","182281",1997,1491,773,718,183,54,129,16.69,0.1669,0.123,0.075
"4004","182290",1997,1165,654,511,171,54,117,17.89,0.1789,0.147,0.106
"4005","182634",1997,240,172,68,111,29,82,47.67,0.4767,0.462,0.426
"4006","182795",1997,489,257,232,178,69,109,42.41,0.4241,0.364,0.297
"4007","183062",1997,845,501,344,193,71,122,24.35,0.2435,0.228,0.206
"4008","183080",1997,844,396,448,163,75,88,22.22,0.2222,0.193,0.167
"4009","183239",1997,508,283,225,350,134,216,76.33,0.7633,0.689,0.596
"4010","183822",1997,312,213,99,26,8,18,8.45,0.0845,0.083,0.081
"4011","183974",1997,104,65,39,24,8,16,24.62,0.2462,0.231,0.205
"4012","184348",1997,418,243,175,294,117,177,72.84,0.7284,0.703,0.669
"4013","184603",1997,519,265,254,83,27,56,21.13,0.2113,0.16,0.106
"4014","184612",1997,112,94,18,9,0,9,9.57,0.0957,0.08,0
"4015","184782",1997,1038,552,486,321,119,202,36.59,0.3659,0.309,0.245
"4016","185129",1997,455,237,218,34,13,21,8.86,0.0886,0.075,0.06
"4017","185572",1997,801,432,369,264,87,177,40.97,0.4097,0.33,0.236
"4018","185590",1997,1148,709,439,230,62,168,23.7,0.237,0.2,0.141
"4019","185828",1997,568,105,463,88,73,15,14.29,0.1429,0.155,0.158
"4020","186131",1997,1129,511,618,1033,562,471,92.17,0.9217,0.915,0.909
"4021","186201",1997,453,228,225,125,53,72,31.58,0.3158,0.276,0.236
"4022","186283",1997,751,435,316,340,135,205,47.13,0.4713,0.453,0.427
"4023","186584",1997,1056,547,509,409,157,252,46.07,0.4607,0.387,0.308
"4024","186876",1997,700,415,285,283,93,190,45.78,0.4578,0.404,0.326
"4025","187134",1997,1396,847,549,870,305,565,66.71,0.6671,0.623,0.556
"4026","187444",1997,1032,563,469,154,51,103,18.29,0.1829,0.149,0.109
"4027","187985",1997,2047,1132,915,244,71,173,15.28,0.1528,0.119,0.078
"4028","188030",1997,1694,901,793,201,70,131,14.54,0.1454,0.119,0.088
"4029","188429",1997,289,174,115,130,49,81,46.55,0.4655,0.45,0.426
"4030","188641",1997,467,205,262,204,99,105,51.22,0.5122,0.437,0.378
"4031","190044",1997,612,136,476,378,297,81,59.56,0.5956,0.618,0.624
"4032","190099",1997,711,364,347,599,276,323,88.74,0.8874,0.842,0.795
"4033","190150",1997,1271,583,688,1036,547,489,83.88,0.8388,0.815,0.795
"4034","190248",1997,113,71,42,41,13,28,39.44,0.3944,0.363,0.31
"4035","190415",1997,2998,1405,1593,2551,1307,1244,88.54,0.8854,0.851,0.82
"4036","190512",1997,1109,608,501,202,75,127,20.89,0.2089,0.182,0.15
"4037","190549",1997,1344,774,570,194,75,119,15.37,0.1537,0.144,0.132
"4038","190558",1997,1418,729,689,32,7,25,3.43,0.0343,0.023,0.01
"4039","190567",1997,947,464,483,44,17,27,5.82,0.0582,0.046,0.035
"4040","190594",1997,1630,1137,493,136,26,110,9.67,0.0967,0.083,0.053
"4041","190637",1997,736,519,217,45,11,34,6.55,0.0655,0.061,0.051
"4042","190664",1997,1153,675,478,227,65,162,24,0.24,0.197,0.136
"4043","190691",1997,500,323,177,38,12,26,8.05,0.0805,0.076,0.068
"4044","190725",1997,416,313,103,87,22,65,20.77,0.2077,0.209,0.214
"4045","191241",1997,1459,849,610,1075,445,630,74.2,0.742,0.737,0.73
"4046","191515",1997,457,239,218,381,172,209,87.45,0.8745,0.834,0.789
"4047","191533",1997,388,197,191,209,94,115,58.38,0.5838,0.539,0.492
"4048","191630",1997,549,284,265,354,174,180,63.38,0.6338,0.645,0.657
"4049","191649",1997,1743,928,815,648,221,427,46.01,0.4601,0.372,0.271
"4050","191676",1997,310,198,112,179,65,114,57.58,0.5758,0.577,0.58
"4051","191931",1997,695,312,383,263,98,165,52.88,0.5288,0.378,0.256
"4052","191968",1997,1417,801,616,909,362,547,68.29,0.6829,0.641,0.588
"4053","192192",1997,141,112,29,69,12,57,50.89,0.5089,0.489,0.414
"4054","192323",1997,453,292,161,299,101,198,67.81,0.6781,0.66,0.627
"4055","192439",1997,915,595,320,33,13,20,3.36,0.0336,0.036,0.041
"4056","192703",1997,527,235,292,269,134,135,57.45,0.5745,0.51,0.459
"4057","192749",1997,294,202,92,148,40,108,53.47,0.5347,0.503,0.435
"4058","192819",1997,973,532,441,570,232,338,63.53,0.6353,0.586,0.526
"4059","192925",1997,164,102,62,19,6,13,12.75,0.1275,0.116,0.097
"4060","193016",1997,1052,692,360,46,16,30,4.34,0.0434,0.044,0.044
"4061","193292",1997,156,112,44,46,6,40,35.71,0.3571,0.295,0.136
"4062","193353",1997,260,177,83,121,43,78,44.07,0.4407,0.465,0.518
"4063","193399",1997,225,168,57,95,18,77,45.83,0.4583,0.422,0.316
"4064","193584",1997,351,257,94,214,59,155,60.31,0.6031,0.61,0.628
"4065","193645",1997,758,643,115,165,18,147,22.86,0.2286,0.218,0.157
"4066","193654",1997,465,308,157,205,56,149,48.38,0.4838,0.441,0.357
"4067","193900",1997,3557,2054,1503,1963,775,1188,57.84,0.5784,0.552,0.516
"4068","193973",1997,705,417,288,299,102,197,47.24,0.4724,0.424,0.354
"4069","194161",1997,208,114,94,46,17,29,25.44,0.2544,0.221,0.181
"4070","194310",1997,1476,859,617,588,203,385,44.82,0.4482,0.398,0.329
"4071","194824",1997,1069,267,802,584,414,170,63.67,0.6367,0.546,0.516
"4072","195003",1997,1836,617,1219,727,446,281,45.54,0.4554,0.396,0.366
"4073","195030",1997,892,404,488,592,301,291,72.03,0.7203,0.664,0.617
"4074","195164",1997,542,274,268,309,144,165,60.22,0.6022,0.57,0.537
"4075","195173",1997,410,253,157,95,26,69,27.27,0.2727,0.232,0.166
"4076","195216",1997,476,232,244,328,148,180,77.59,0.7759,0.689,0.607
"4077","195234",1997,311,223,88,146,29,117,52.47,0.5247,0.469,0.33
"4078","195243",1997,300,179,121,106,34,72,40.22,0.4022,0.353,0.281
"4079","195304",1997,283,222,61,174,33,141,63.51,0.6351,0.615,0.541
"4080","195474",1997,583,301,282,400,181,219,72.76,0.7276,0.686,0.642
"4081","195526",1997,605,372,233,452,175,277,74.46,0.7446,0.747,0.751
"4082","195544",1997,107,74,33,60,18,42,56.76,0.5676,0.561,0.545
"4083","195809",1997,2480,1358,1122,789,311,478,35.2,0.352,0.318,0.277
"4084","196413",1997,2562,1417,1145,1773,713,1060,74.81,0.7481,0.692,0.623
"4085","196592",1997,2028,1457,571,85,27,58,3.98,0.0398,0.042,0.047
"4086","197045",1997,320,216,104,130,44,86,39.81,0.3981,0.406,0.423
"4087","197133",1997,646,409,237,529,186,343,83.86,0.8386,0.819,0.785
"4088","197869",1997,2161,1177,984,711,235,476,40.44,0.4044,0.329,0.239
"4089","197984",1997,159,68,91,61,27,34,50,0.5,0.384,0.297
"4090","198385",1997,470,230,240,417,206,211,91.74,0.9174,0.887,0.858
"4091","198464",1997,2871,1718,1153,705,222,483,28.11,0.2811,0.246,0.193
"4092","198507",1997,424,251,173,133,33,100,39.84,0.3984,0.314,0.191
"4093","198516",1997,964,584,380,599,207,392,67.12,0.6712,0.621,0.545
"4094","198835",1997,306,167,139,119,41,78,46.71,0.4671,0.389,0.295
"4095","198969",1997,350,107,243,69,41,28,26.17,0.2617,0.197,0.169
"4096","199102",1997,1383,727,656,363,118,245,33.7,0.337,0.262,0.18
"4097","199111",1997,470,264,206,138,49,89,33.71,0.3371,0.294,0.238
"4098","199120",1997,3412,2118,1294,2371,816,1555,73.42,0.7342,0.695,0.631
"4099","199139",1997,1904,1077,827,418,155,263,24.42,0.2442,0.22,0.187
"4100","199148",1997,1577,1091,486,431,90,341,31.26,0.3126,0.273,0.185
"4101","199157",1997,712,467,245,202,45,157,33.62,0.3362,0.284,0.184
"4102","199193",1997,3756,1496,2260,961,427,534,35.7,0.357,0.256,0.189
"4103","199218",1997,1350,837,513,478,149,329,39.31,0.3931,0.354,0.29
"4104","199281",1997,480,258,222,98,34,64,24.81,0.2481,0.204,0.153
"4105","199306",1997,162,59,103,40,21,19,32.2,0.322,0.247,0.204
"4106","199412",1997,198,142,56,80,20,60,42.25,0.4225,0.404,0.357
"4107","199582",1997,400,228,172,60,14,46,20.18,0.2018,0.15,0.081
"4108","199643",1997,304,173,131,43,12,31,17.92,0.1792,0.141,0.092
"4109","199847",1997,962,483,479,739,338,401,83.02,0.8302,0.768,0.706
"4110","199962",1997,296,123,173,103,43,60,48.78,0.4878,0.348,0.249
"4111","199999",1997,485,329,156,117,27,90,27.36,0.2736,0.241,0.173
"4112","200004",1997,1224,629,595,310,100,210,33.39,0.3339,0.253,0.168
"4113","200059",1997,408,233,175,39,15,24,10.3,0.103,0.096,0.086
"4114","200156",1997,232,134,98,100,36,64,47.76,0.4776,0.431,0.367
"4115","200217",1997,381,242,139,131,32,99,40.91,0.4091,0.344,0.23
"4116","200226",1997,129,73,56,20,6,14,19.18,0.1918,0.155,0.107
"4117","200253",1997,442,270,172,38,9,29,10.74,0.1074,0.086,0.052
"4118","200280",1997,1516,742,774,222,94,128,17.25,0.1725,0.146,0.121
"4119","200332",1997,1199,497,702,194,83,111,22.33,0.2233,0.162,0.118
"4120","200572",1997,177,100,77,37,8,29,29,0.29,0.209,0.104
"4121","201104",1997,531,302,229,220,76,144,47.68,0.4768,0.414,0.332
"4122","201371",1997,254,149,105,124,37,87,58.39,0.5839,0.488,0.352
"4123","201548",1997,478,290,188,239,82,157,54.14,0.5414,0.5,0.436
"4124","201645",1997,736,269,467,408,235,173,64.31,0.6431,0.554,0.503
"4125","201690",1997,88,47,41,4,0,4,8.51,0.0851,0.045,0
"4126","202134",1997,924,464,460,89,36,53,11.42,0.1142,0.096,0.078
"4127","202480",1997,1622,872,750,896,351,545,62.5,0.625,0.552,0.468
"4128","202523",1997,593,325,268,438,185,253,77.85,0.7785,0.739,0.69
"4129","202763",1997,651,390,261,264,75,189,48.46,0.4846,0.406,0.287
"4130","203085",1997,264,114,150,127,58,69,60.53,0.6053,0.481,0.387
"4131","203128",1997,240,123,117,136,54,82,66.67,0.6667,0.567,0.462
"4132","203368",1997,790,408,382,495,217,278,68.14,0.6814,0.627,0.568
"4133","203517",1997,2573,1524,1049,508,173,335,21.98,0.2198,0.197,0.165
"4134","203535",1997,441,255,186,349,143,206,80.78,0.8078,0.791,0.769
"4135","203580",1997,70,47,23,29,13,16,34.04,0.3404,0.414,0.565
"4136","203775",1997,464,293,171,208,73,135,46.08,0.4608,0.448,0.427
"4137","203845",1997,331,163,168,157,72,85,52.15,0.5215,0.474,0.429
"4138","204024",1997,3379,1914,1465,2180,855,1325,69.23,0.6923,0.645,0.584
"4139","204185",1997,540,297,243,306,113,193,64.98,0.6498,0.567,0.465
"4140","204194",1997,333,195,138,119,45,74,37.95,0.3795,0.357,0.326
"4141","204617",1997,180,101,79,65,18,47,46.53,0.4653,0.361,0.228
"4142","204796",1997,5897,3081,2816,1719,555,1164,37.78,0.3778,0.292,0.197
"4143","204857",1997,3255,1913,1342,1401,427,974,50.91,0.5091,0.43,0.318
"4144","206330",1997,96,40,56,12,4,8,20,0.2,0.125,0.071
"4145","206589",1997,538,289,249,328,130,198,68.51,0.6851,0.61,0.522
"4146","206604",1997,2025,1103,922,336,126,210,19.04,0.1904,0.166,0.137
"4147","206622",1997,757,439,318,512,220,292,66.51,0.6651,0.676,0.692
"4148","206695",1997,1764,924,840,231,85,146,15.8,0.158,0.131,0.101
"4149","206914",1997,615,322,293,50,21,29,9.01,0.0901,0.081,0.072
"4150","207209",1997,566,304,262,34,3,31,10.2,0.102,0.06,0.011
"4151","207306",1997,293,148,145,35,11,24,16.22,0.1622,0.119,0.076
"4152","207324",1997,453,222,231,73,32,41,18.47,0.1847,0.161,0.139
"4153","207388",1997,2321,1214,1107,565,194,371,30.56,0.3056,0.243,0.175
"4154","207500",1997,2895,1523,1372,552,195,357,23.44,0.2344,0.191,0.142
"4155","207722",1997,222,133,89,32,9,23,17.29,0.1729,0.144,0.101
"4156","207847",1997,578,314,264,89,33,56,17.83,0.1783,0.154,0.125
"4157","207865",1997,717,386,331,107,28,79,20.47,0.2047,0.149,0.085
"4158","208822",1997,345,225,120,212,70,142,63.11,0.6311,0.614,0.583
"4159","209056",1997,463,272,191,289,121,168,61.76,0.6176,0.624,0.634
"4160","209065",1997,410,235,175,244,91,153,65.11,0.6511,0.595,0.52
"4161","209542",1997,1869,860,1009,525,212,313,36.4,0.364,0.281,0.21
"4162","209551",1997,2384,1307,1077,856,314,542,41.47,0.4147,0.359,0.292
"4163","209612",1997,261,175,86,129,39,90,51.43,0.5143,0.494,0.453
"4164","209807",1997,743,368,375,96,37,59,16.03,0.1603,0.129,0.099
"4165","209922",1997,315,176,139,146,59,87,49.43,0.4943,0.463,0.424
"4166","210146",1997,759,426,333,142,47,95,22.3,0.223,0.187,0.141
"4167","210401",1997,410,224,186,299,131,168,75,0.75,0.729,0.704
"4168","210429",1997,759,481,278,103,35,68,14.14,0.1414,0.136,0.126
"4169","210571",1997,295,137,158,176,83,93,67.88,0.6788,0.597,0.525
"4170","210669",1997,541,289,252,328,139,189,65.4,0.654,0.606,0.552
"4171","210775",1997,155,95,60,64,26,38,40,0.4,0.413,0.433
"4172","211088",1997,260,191,69,142,34,108,56.54,0.5654,0.546,0.493
"4173","211158",1997,1355,893,462,459,125,334,37.4,0.374,0.339,0.271
"4174","211291",1997,898,426,472,752,380,372,87.32,0.8732,0.837,0.805
"4175","211352",1997,339,231,108,160,39,121,52.38,0.5238,0.472,0.361
"4176","211361",1997,942,446,496,163,64,99,22.2,0.222,0.173,0.129
"4177","211431",1997,142,139,3,50,1,49,35.25,0.3525,0.352,0.333
"4178","211440",1997,1270,464,806,841,522,319,68.75,0.6875,0.662,0.648
"4179","211468",1997,195,194,1,122,1,121,62.37,0.6237,0.626,1
"4180","211556",1997,92,92,0,51,0,51,55.43,0.5543,0.554,NA
"4181","211583",1997,92,92,0,51,0,51,55.43,0.5543,0.554,NA
"4182","211608",1997,236,122,114,18,4,14,11.48,0.1148,0.076,0.035
"4183","211644",1997,1220,751,469,294,84,210,27.96,0.2796,0.241,0.179
"4184","211981",1997,407,185,222,149,58,91,49.19,0.4919,0.366,0.261
"4185","212009",1997,563,354,209,429,148,281,79.38,0.7938,0.762,0.708
"4186","212054",1997,1776,729,1047,231,73,158,21.67,0.2167,0.13,0.07
"4187","212106",1997,1211,716,495,599,225,374,52.23,0.5223,0.495,0.455
"4188","212115",1997,886,532,354,166,34,132,24.81,0.2481,0.187,0.096
"4189","212133",1997,305,211,94,171,40,131,62.09,0.6209,0.561,0.426
"4190","212160",1997,1251,729,522,234,63,171,23.46,0.2346,0.187,0.121
"4191","212197",1997,438,298,140,265,74,191,64.09,0.6409,0.605,0.529
"4192","212577",1997,504,251,253,402,202,200,79.68,0.7968,0.798,0.798
"4193","212601",1997,533,318,215,244,74,170,53.46,0.5346,0.458,0.344
"4194","212832",1997,65,54,11,26,4,22,40.74,0.4074,0.4,0.364
"4195","212911",1997,298,150,148,264,127,137,91.33,0.9133,0.886,0.858
"4196","213020",1997,2620,1479,1141,618,176,442,29.89,0.2989,0.236,0.154
"4197","213251",1997,342,186,156,232,89,143,76.88,0.7688,0.678,0.571
"4198","213321",1997,435,195,240,260,121,139,71.28,0.7128,0.598,0.504
"4199","213349",1997,1497,837,660,252,72,180,21.51,0.2151,0.168,0.109
"4200","213358",1997,184,101,83,91,44,47,46.53,0.4653,0.495,0.53
"4201","213367",1997,834,479,355,476,184,292,60.96,0.6096,0.571,0.518
"4202","213385",1997,568,263,305,456,230,226,85.93,0.8593,0.803,0.754
"4203","213507",1997,303,174,129,185,71,114,65.52,0.6552,0.611,0.55
"4204","213543",1997,1097,442,655,803,444,359,81.22,0.8122,0.732,0.678
"4205","213613",1997,822,430,392,188,67,121,28.14,0.2814,0.229,0.171
"4206","213668",1997,379,227,152,214,65,149,65.64,0.6564,0.565,0.428
"4207","213783",1997,597,329,268,141,53,88,26.75,0.2675,0.236,0.198
"4208","213826",1997,276,209,67,103,18,85,40.67,0.4067,0.373,0.269
"4209","213996",1997,689,445,244,445,165,280,62.92,0.6292,0.646,0.676
"4210","214041",1997,1068,627,441,409,132,277,44.18,0.4418,0.383,0.299
"4211","214069",1997,240,174,66,162,32,130,74.71,0.7471,0.675,0.485
"4212","214157",1997,325,190,135,219,86,133,70,0.7,0.674,0.637
"4213","214175",1997,493,293,200,352,135,217,74.06,0.7406,0.714,0.675
"4214","214272",1997,187,126,61,59,15,44,34.92,0.3492,0.316,0.246
"4215","214777",1997,5185,2686,2499,2497,980,1517,56.48,0.5648,0.482,0.392
"4216","215062",1997,2324,1132,1192,1928,941,987,87.19,0.8719,0.83,0.789
"4217","215743",1997,354,200,154,79,22,57,28.5,0.285,0.223,0.143
"4218","215798",1997,272,129,143,159,77,82,63.57,0.6357,0.585,0.538
"4219","215929",1997,905,538,367,644,247,397,73.79,0.7379,0.712,0.673
"4220","216010",1997,1292,741,551,476,178,298,40.22,0.4022,0.368,0.323
"4221","216038",1997,1193,684,509,248,76,172,25.15,0.2515,0.208,0.149
"4222","216287",1997,373,193,180,309,136,173,89.64,0.8964,0.828,0.756
"4223","216339",1997,2149,1233,916,503,176,327,26.52,0.2652,0.234,0.192
"4224","216524",1997,314,162,152,236,117,119,73.46,0.7346,0.752,0.77
"4225","216694",1997,309,123,186,132,72,60,48.78,0.4878,0.427,0.387
"4226","216764",1997,1581,1025,556,409,93,316,30.83,0.3083,0.259,0.167
"4227","216807",1997,394,239,155,259,93,166,69.46,0.6946,0.657,0.6
"4228","216852",1997,391,174,217,145,65,80,45.98,0.4598,0.371,0.3
"4229","216931",1997,355,168,187,161,72,89,52.98,0.5298,0.454,0.385
"4230","217059",1997,842,496,346,348,128,220,44.35,0.4435,0.413,0.37
"4231","217156",1997,1368,722,646,1136,527,609,84.35,0.8435,0.83,0.816
"4232","217402",1997,974,563,411,801,326,475,84.37,0.8437,0.822,0.793
"4233","217536",1997,479,318,161,219,55,164,51.57,0.5157,0.457,0.342
"4234","217776",1997,101,51,50,27,9,18,35.29,0.3529,0.267,0.18
"4235","217819",1997,1568,1031,537,565,130,435,42.19,0.4219,0.36,0.242
"4236","217882",1997,2579,1265,1314,997,341,656,51.86,0.5186,0.387,0.26
"4237","217998",1997,132,78,54,85,31,54,69.23,0.6923,0.644,0.574
"4238","218061",1997,582,336,246,99,34,65,19.35,0.1935,0.17,0.138
"4239","218229",1997,434,288,146,94,23,71,24.65,0.2465,0.217,0.158
"4240","218238",1997,193,92,101,4,3,1,1.09,0.0109,0.021,0.03
"4241","218399",1997,262,180,82,68,15,53,29.44,0.2944,0.26,0.183
"4242","218414",1997,161,52,109,41,22,19,36.54,0.3654,0.255,0.202
"4243","218663",1997,2919,1596,1323,1065,393,672,42.11,0.4211,0.365,0.297
"4244","218724",1997,826,443,383,121,43,78,17.61,0.1761,0.146,0.112
"4245","218733",1997,601,320,281,169,52,117,36.56,0.3656,0.281,0.185
"4246","218742",1997,539,327,212,81,18,63,19.27,0.1927,0.15,0.085
"4247","218973",1997,296,139,157,210,102,108,77.7,0.777,0.709,0.65
"4248","219000",1997,326,209,117,171,53,118,56.46,0.5646,0.525,0.453
"4249","219046",1997,451,227,224,38,8,30,13.22,0.1322,0.084,0.036
"4250","219082",1997,249,135,114,1,1,0,0,0,0.004,0.009
"4251","219198",1997,129,96,33,47,12,35,36.46,0.3646,0.364,0.364
"4252","219259",1997,539,321,218,83,22,61,19,0.19,0.154,0.101
"4253","219356",1997,1531,741,790,346,130,216,29.15,0.2915,0.226,0.165
"4254","219471",1997,896,503,393,213,80,133,26.44,0.2644,0.238,0.204
"4255","219602",1997,788,503,285,144,40,104,20.68,0.2068,0.183,0.14
"4256","219709",1997,399,248,151,197,67,130,52.42,0.5242,0.494,0.444
"4257","219718",1997,65,26,39,8,2,6,23.08,0.2308,0.123,0.051
"4258","219949",1997,186,91,95,42,10,32,35.16,0.3516,0.226,0.105
"4259","220075",1997,1487,853,634,192,70,122,14.3,0.143,0.129,0.11
"4260","220215",1997,294,181,113,100,40,60,33.15,0.3315,0.34,0.354
"4261","220613",1997,655,379,276,149,50,99,26.12,0.2612,0.227,0.181
"4262","220631",1997,134,88,46,39,15,24,27.27,0.2727,0.291,0.326
"4263","220710",1997,245,117,128,99,44,55,47.01,0.4701,0.404,0.344
"4264","221351",1997,422,239,183,301,128,173,72.38,0.7238,0.713,0.699
"4265","221519",1997,364,195,169,285,130,155,79.49,0.7949,0.783,0.769
"4266","221731",1997,96,61,35,35,12,23,37.7,0.377,0.365,0.343
"4267","221847",1997,1089,466,623,100,33,67,14.38,0.1438,0.092,0.053
"4268","221892",1997,179,100,79,30,9,21,21,0.21,0.168,0.114
"4269","222178",1997,964,530,434,259,97,162,30.57,0.3057,0.269,0.224
"4270","222983",1997,317,150,167,215,103,112,74.67,0.7467,0.678,0.617
"4271","223232",1997,2404,1416,988,967,300,667,47.1,0.471,0.402,0.304
"4272","224004",1997,125,57,68,15,7,8,14.04,0.1404,0.12,0.103
"4273","224323",1997,261,160,101,136,47,89,55.62,0.5562,0.521,0.465
"4274","225432",1997,679,374,305,14,2,12,3.21,0.0321,0.021,0.007
"4275","225548",1997,323,112,211,66,32,34,30.36,0.3036,0.204,0.152
"4276","225627",1997,341,233,108,47,10,37,15.88,0.1588,0.138,0.093
"4277","226231",1997,209,50,159,65,45,20,40,0.4,0.311,0.283
"4278","226833",1997,668,329,339,37,13,24,7.29,0.0729,0.055,0.038
"4279","227216",1997,2292,1310,982,303,83,220,16.79,0.1679,0.132,0.085
"4280","227331",1997,372,293,79,59,10,49,16.72,0.1672,0.159,0.127
"4281","227526",1997,1183,670,513,127,34,93,13.88,0.1388,0.107,0.066
"4282","227757",1997,703,334,369,516,248,268,80.24,0.8024,0.734,0.672
"4283","227845",1997,359,216,143,98,38,60,27.78,0.2778,0.273,0.266
"4284","227863",1997,235,155,80,58,19,39,25.16,0.2516,0.247,0.238
"4285","228042",1997,194,116,78,40,16,24,20.69,0.2069,0.206,0.205
"4286","228149",1997,507,311,196,170,50,120,38.59,0.3859,0.335,0.255
"4287","228246",1997,1247,686,561,702,282,420,61.22,0.6122,0.563,0.503
"4288","228343",1997,332,177,155,201,85,116,65.54,0.6554,0.605,0.548
"4289","228431",1997,2360,1422,938,358,71,287,20.18,0.2018,0.152,0.076
"4290","228459",1997,2331,1399,932,413,107,306,21.87,0.2187,0.177,0.115
"4291","228501",1997,280,113,167,20,12,8,7.08,0.0708,0.071,0.072
"4292","228529",1997,595,306,289,98,38,60,19.61,0.1961,0.165,0.131
"4293","228705",1997,898,402,496,47,15,32,7.96,0.0796,0.052,0.03
"4294","228723",1997,6169,3158,3011,1953,619,1334,42.24,0.4224,0.317,0.206
"4295","228769",1997,1270,644,626,250,105,145,22.52,0.2252,0.197,0.168
"4296","228778",1997,6945,3568,3377,2531,990,1541,43.19,0.4319,0.364,0.293
"4297","228787",1997,444,183,261,143,77,66,36.07,0.3607,0.322,0.295
"4298","228796",1997,1482,750,732,36,15,21,2.8,0.028,0.024,0.02
"4299","228875",1997,1463,885,578,563,167,396,44.75,0.4475,0.385,0.289
"4300","228981",1997,312,186,126,118,38,80,43.01,0.4301,0.378,0.302
"4301","229018",1997,113,60,53,17,2,15,25,0.25,0.15,0.038
"4302","229027",1997,1749,938,811,109,30,79,8.42,0.0842,0.062,0.037
"4303","229115",1997,3221,1625,1596,764,302,462,28.43,0.2843,0.237,0.189
"4304","229780",1997,241,132,109,58,21,37,28.03,0.2803,0.241,0.193
"4305","229814",1997,854,414,440,105,33,72,17.39,0.1739,0.123,0.075
"4306","230603",1997,717,530,187,113,18,95,17.92,0.1792,0.158,0.096
"4307","230728",1997,1465,1029,436,304,60,244,23.71,0.2371,0.208,0.138
"4308","230764",1997,1962,1039,923,407,133,274,26.37,0.2637,0.207,0.144
"4309","230782",1997,1503,978,525,152,37,115,11.76,0.1176,0.101,0.07
"4310","231059",1997,528,279,249,358,158,200,71.68,0.7168,0.678,0.635
"4311","231174",1997,1823,1005,818,959,381,578,57.51,0.5751,0.526,0.466
"4312","231420",1997,160,91,69,43,16,27,29.67,0.2967,0.269,0.232
"4313","231554",1997,130,64,66,44,19,25,39.06,0.3906,0.338,0.288
"4314","231624",1997,1327,802,525,1063,381,682,85.04,0.8504,0.801,0.726
"4315","231712",1997,665,398,267,88,29,59,14.82,0.1482,0.132,0.109
"4316","232025",1997,197,98,99,92,35,57,58.16,0.5816,0.467,0.354
"4317","232043",1997,242,138,104,109,44,65,47.1,0.471,0.45,0.423
"4318","232089",1997,240,102,138,72,35,37,36.27,0.3627,0.3,0.254
"4319","232186",1997,1930,1072,858,437,140,297,27.71,0.2771,0.226,0.163
"4320","232265",1997,1218,765,453,459,119,340,44.44,0.4444,0.377,0.263
"4321","232423",1997,3059,1791,1268,1855,643,1212,67.67,0.6767,0.606,0.507
"4322","232557",1997,995,531,464,279,101,178,33.52,0.3352,0.28,0.218
"4323","232566",1997,728,513,215,303,67,236,46,0.46,0.416,0.312
"4324","232609",1997,477,275,202,220,72,148,53.82,0.5382,0.461,0.356
"4325","232681",1997,808,547,261,479,129,350,63.99,0.6399,0.593,0.494
"4326","232706",1997,261,190,71,111,28,83,43.68,0.4368,0.425,0.394
"4327","232937",1997,1132,700,432,104,30,74,10.57,0.1057,0.092,0.069
"4328","232982",1997,1464,791,673,207,54,153,19.34,0.1934,0.141,0.08
"4329","233277",1997,1619,1048,571,551,145,406,38.74,0.3874,0.34,0.254
"4330","233374",1997,750,367,383,548,258,290,79.02,0.7902,0.731,0.674
"4331","233426",1997,438,248,190,225,70,155,62.5,0.625,0.514,0.368
"4332","233541",1997,257,159,98,61,17,44,27.67,0.2767,0.237,0.173
"4333","233897",1997,303,155,148,80,28,52,33.55,0.3355,0.264,0.189
"4334","233921",1997,4522,1818,2704,1903,869,1034,56.88,0.5688,0.421,0.321
"4335","234030",1997,2175,1301,874,337,106,231,17.76,0.1776,0.155,0.121
"4336","234085",1997,394,20,374,201,188,13,65,0.65,0.51,0.503
"4337","234155",1997,865,493,372,170,48,122,24.75,0.2475,0.197,0.129
"4338","234164",1997,304,155,149,3,1,2,1.29,0.0129,0.01,0.007
"4339","235097",1997,624,367,257,86,21,65,17.71,0.1771,0.138,0.082
"4340","235167",1997,494,271,223,186,71,115,42.44,0.4244,0.377,0.318
"4341","236230",1997,660,394,266,303,87,216,54.82,0.5482,0.459,0.327
"4342","236328",1997,642,390,252,430,155,275,70.51,0.7051,0.67,0.615
"4343","236577",1997,584,392,192,233,63,170,43.37,0.4337,0.399,0.328
"4344","236595",1997,499,288,211,220,78,142,49.31,0.4931,0.441,0.37
"4345","236896",1997,283,142,141,62,29,33,23.24,0.2324,0.219,0.206
"4346","236939",1997,2276,1191,1085,657,235,422,35.43,0.3543,0.289,0.217
"4347","236948",1997,4346,2270,2076,1734,667,1067,47,0.47,0.399,0.321
"4348","237011",1997,2068,1266,802,601,176,425,33.57,0.3357,0.291,0.219
"4349","237057",1997,370,223,147,277,97,180,80.72,0.8072,0.749,0.66
"4350","237066",1997,398,212,186,226,103,123,58.02,0.5802,0.568,0.554
"4351","237215",1997,423,237,186,6,0,6,2.53,0.0253,0.014,0
"4352","237330",1997,726,390,336,121,49,72,18.46,0.1846,0.167,0.146
"4353","237358",1997,95,54,41,6,3,3,5.56,0.0556,0.063,0.073
"4354","237367",1997,540,300,240,115,45,70,23.33,0.2333,0.213,0.188
"4355","237792",1997,643,341,302,111,43,68,19.94,0.1994,0.173,0.142
"4356","237899",1997,581,288,293,33,13,20,6.94,0.0694,0.057,0.044
"4357","237932",1997,491,257,234,77,21,56,21.79,0.2179,0.157,0.09
"4358","237969",1997,480,260,220,201,72,129,49.62,0.4962,0.419,0.327
"4359","238032",1997,3079,1431,1648,794,344,450,31.45,0.3145,0.258,0.209
"4360","238333",1997,339,194,145,204,73,131,67.53,0.6753,0.602,0.503
"4361","238430",1997,226,149,77,55,19,36,24.16,0.2416,0.243,0.247
"4362","238458",1997,459,287,172,232,65,167,58.19,0.5819,0.505,0.378
"4363","238476",1997,395,201,194,174,75,99,49.25,0.4925,0.441,0.387
"4364","238616",1997,253,147,106,128,45,83,56.46,0.5646,0.506,0.425
"4365","238661",1997,222,164,58,53,11,42,25.61,0.2561,0.239,0.19
"4366","239080",1997,208,119,89,62,16,46,38.66,0.3866,0.298,0.18
"4367","239105",1997,1573,830,743,876,351,525,63.25,0.6325,0.557,0.472
"4368","239628",1997,135,62,73,71,35,36,58.06,0.5806,0.526,0.479
"4369","239716",1997,480,288,192,324,121,203,70.49,0.7049,0.675,0.63
"4370","240107",1997,331,240,91,96,18,78,32.5,0.325,0.29,0.198
"4371","240189",1997,1881,944,937,349,138,211,22.35,0.2235,0.186,0.147
"4372","240277",1997,895,568,327,141,39,102,17.96,0.1796,0.158,0.119
"4373","240329",1997,1700,1042,658,386,108,278,26.68,0.2668,0.227,0.164
"4374","240338",1997,109,61,48,50,21,29,47.54,0.4754,0.459,0.438
"4375","240365",1997,1719,994,725,242,69,173,17.4,0.174,0.141,0.095
"4376","240374",1997,726,440,286,87,24,63,14.32,0.1432,0.12,0.084
"4377","240417",1997,1241,604,637,170,47,123,20.36,0.2036,0.137,0.074
"4378","240426",1997,326,182,144,36,13,23,12.64,0.1264,0.11,0.09
"4379","240444",1997,5828,3156,2672,2303,835,1468,46.51,0.4651,0.395,0.312
"4380","240453",1997,2272,1263,1009,327,124,203,16.07,0.1607,0.144,0.123
"4381","240462",1997,978,304,674,138,69,69,22.7,0.227,0.141,0.102
"4382","240471",1997,1144,698,446,269,79,190,27.22,0.2722,0.235,0.177
"4383","240480",1997,1527,837,690,262,78,184,21.98,0.2198,0.172,0.113
"4384","240727",1997,1119,562,557,276,97,179,31.85,0.3185,0.247,0.174
"4385","243443",1997,723,471,252,50,6,44,9.34,0.0934,0.069,0.024
"4386","243780",1997,6369,2806,3563,1994,953,1041,37.1,0.371,0.313,0.267
"4387","100654",1998,995,518,477,182,38,144,27.8,0.278,0.183,0.08
"4388","100663",1998,1076,646,430,164,48,116,17.96,0.1796,0.152,0.112
"4389","100751",1998,2597,1437,1160,857,269,588,40.92,0.4092,0.33,0.232
"4390","100858",1998,3654,1913,1741,1229,415,814,42.55,0.4255,0.336,0.238
"4391","101435",1998,175,96,79,88,31,57,59.38,0.5938,0.503,0.392
"4392","101480",1998,752,392,360,112,34,78,19.9,0.199,0.149,0.094
"4393","101675",1998,340,177,163,133,51,82,46.33,0.4633,0.391,0.313
"4394","101879",1998,828,490,338,118,28,90,18.37,0.1837,0.143,0.083
"4395","102049",1998,625,390,235,316,110,206,52.82,0.5282,0.506,0.468
"4396","102094",1998,1044,618,426,143,36,107,17.31,0.1731,0.137,0.085
"4397","102234",1998,242,119,123,120,61,59,49.58,0.4958,0.496,0.496
"4398","102368",1998,768,437,331,251,75,176,40.27,0.4027,0.327,0.227
"4399","102377",1998,683,412,271,154,37,117,28.4,0.284,0.225,0.137
"4400","104151",1998,4753,2561,2192,1270,480,790,30.85,0.3085,0.267,0.219
"4401","104179",1998,5088,2773,2315,1595,590,1005,36.24,0.3624,0.313,0.255
"4402","105330",1998,2073,1188,885,554,176,378,31.82,0.3182,0.267,0.199
"4403","106245",1998,865,539,326,93,22,71,13.17,0.1317,0.108,0.067
"4404","106342",1998,107,65,42,56,21,35,53.85,0.5385,0.523,0.5
"4405","106397",1998,2456,1245,1211,665,246,419,33.65,0.3365,0.271,0.203
"4406","106412",1998,721,372,349,70,22,48,12.9,0.129,0.097,0.063
"4407","106458",1998,1705,928,777,270,68,202,21.77,0.2177,0.158,0.088
"4408","106467",1998,821,401,420,105,41,64,15.96,0.1596,0.128,0.098
"4409","106485",1998,558,292,266,52,18,34,11.64,0.1164,0.093,0.068
"4410","106704",1998,1575,944,631,249,58,191,20.23,0.2023,0.158,0.092
"4411","107044",1998,908,535,373,285,101,184,34.39,0.3439,0.314,0.271
"4412","107080",1998,320,166,154,196,89,107,64.46,0.6446,0.613,0.578
"4413","107141",1998,250,138,112,112,44,68,49.28,0.4928,0.448,0.393
"4414","107512",1998,362,220,142,120,36,84,38.18,0.3818,0.331,0.254
"4415","107558",1998,137,69,68,43,18,25,36.23,0.3623,0.314,0.265
"4416","110097",1998,469,313,156,227,75,152,48.56,0.4856,0.484,0.481
"4417","110404",1998,254,79,175,195,136,59,74.68,0.7468,0.768,0.777
"4418","110422",1998,2260,945,1315,367,136,231,24.44,0.2444,0.162,0.103
"4419","110486",1998,471,298,173,54,9,45,15.1,0.151,0.115,0.052
"4420","110495",1998,444,297,147,84,16,68,22.9,0.229,0.189,0.109
"4421","110510",1998,1068,680,388,124,39,85,12.5,0.125,0.116,0.101
"4422","110529",1998,2033,855,1178,191,80,111,12.98,0.1298,0.094,0.068
"4423","110538",1998,1850,1069,781,299,65,234,21.89,0.2189,0.162,0.083
"4424","110547",1998,465,330,135,21,3,18,5.45,0.0545,0.045,0.022
"4425","110556",1998,1566,933,633,215,44,171,18.33,0.1833,0.137,0.07
"4426","110565",1998,2146,1240,906,274,65,209,16.85,0.1685,0.128,0.072
"4427","110574",1998,732,470,262,106,24,82,17.45,0.1745,0.145,0.092
"4428","110583",1998,2652,1707,945,285,61,224,13.12,0.1312,0.107,0.065
"4429","110592",1998,1255,789,466,103,22,81,10.27,0.1027,0.082,0.047
"4430","110617",1998,1467,828,639,136,30,106,12.8,0.128,0.093,0.047
"4431","113698",1998,72,58,14,30,6,24,41.38,0.4138,0.417,0.429
"4432","115755",1998,731,405,326,71,24,47,11.6,0.116,0.097,0.074
"4433","119173",1998,295,293,2,62,0,62,21.16,0.2116,0.21,0
"4434","120184",1998,130,80,50,52,14,38,47.5,0.475,0.4,0.28
"4435","121309",1998,598,375,223,261,87,174,46.4,0.464,0.436,0.39
"4436","121345",1998,396,182,214,321,168,153,84.07,0.8407,0.811,0.785
"4437","122409",1998,3128,1815,1313,308,79,229,12.62,0.1262,0.098,0.06
"4438","122436",1998,1028,614,414,610,222,388,63.19,0.6319,0.593,0.536
"4439","122597",1998,1805,1143,662,134,23,111,9.71,0.0971,0.074,0.035
"4440","122612",1998,640,436,204,296,80,216,49.54,0.4954,0.462,0.392
"4441","122931",1998,1032,570,462,783,331,452,79.3,0.793,0.759,0.716
"4442","123554",1998,573,343,230,352,125,227,66.18,0.6618,0.614,0.543
"4443","123572",1998,823,557,266,177,37,140,25.13,0.2513,0.215,0.139
"4444","126562",1998,394,223,171,58,17,41,18.39,0.1839,0.147,0.099
"4445","126580",1998,635,372,263,154,53,101,27.15,0.2715,0.243,0.202
"4446","126614",1998,4263,2037,2226,1545,647,898,44.08,0.4408,0.362,0.291
"4447","126818",1998,3028,1772,1256,1028,301,727,41.03,0.4103,0.339,0.24
"4448","127060",1998,768,393,375,414,185,229,58.27,0.5827,0.539,0.493
"4449","127185",1998,970,405,565,108,46,62,15.31,0.1531,0.111,0.081
"4450","127565",1998,1382,759,623,81,29,52,6.85,0.0685,0.059,0.047
"4451","127741",1998,2165,1314,851,515,123,392,29.83,0.2983,0.238,0.145
"4452","128106",1998,611,345,266,80,30,50,14.49,0.1449,0.131,0.113
"4453","128744",1998,233,94,139,80,48,32,34.04,0.3404,0.343,0.345
"4454","128771",1998,1317,675,642,163,46,117,17.33,0.1733,0.124,0.072
"4455","129020",1998,2536,1358,1178,1135,431,704,51.84,0.5184,0.448,0.366
"4456","129242",1998,875,478,397,679,299,380,79.5,0.795,0.776,0.753
"4457","129941",1998,370,141,229,95,51,44,31.21,0.3121,0.257,0.223
"4458","130253",1998,702,409,293,308,112,196,47.92,0.4792,0.439,0.382
"4459","130314",1998,142,142,0,66,0,66,46.48,0.4648,0.465,NA
"4460","130493",1998,1077,647,430,140,24,116,17.93,0.1793,0.13,0.056
"4461","130590",1998,509,263,246,390,176,214,81.37,0.8137,0.766,0.715
"4462","130697",1998,716,382,334,593,264,329,86.13,0.8613,0.828,0.79
"4463","130776",1998,655,315,340,91,33,58,18.41,0.1841,0.139,0.097
"4464","130794",1998,1295,646,649,1146,573,573,88.7,0.887,0.885,0.883
"4465","130934",1998,578,339,239,118,39,79,23.3,0.233,0.204,0.163
"4466","130943",1998,3545,2149,1396,2078,696,1382,64.31,0.6431,0.586,0.499
"4467","131159",1998,1232,774,458,802,262,540,69.77,0.6977,0.651,0.572
"4468","131283",1998,597,338,259,378,149,229,67.75,0.6775,0.633,0.575
"4469","131450",1998,230,112,118,17,7,10,8.93,0.0893,0.074,0.059
"4470","131469",1998,1773,1057,716,1285,471,814,77.01,0.7701,0.725,0.658
"4471","131496",1998,1470,810,660,1302,581,721,89.01,0.8901,0.886,0.88
"4472","131520",1998,1244,831,413,469,103,366,44.04,0.4404,0.377,0.249
"4473","132471",1998,393,249,144,82,20,62,24.9,0.249,0.209,0.139
"4474","132602",1998,623,316,307,97,24,73,23.1,0.231,0.156,0.078
"4475","132903",1998,3792,1932,1860,1097,387,710,36.75,0.3675,0.289,0.208
"4476","133492",1998,407,227,180,234,99,135,59.47,0.5947,0.575,0.55
"4477","133553",1998,934,128,806,279,230,49,38.28,0.3828,0.299,0.285
"4478","133650",1998,2213,1294,919,385,120,265,20.48,0.2048,0.174,0.131
"4479","133669",1998,1309,773,536,196,56,140,18.11,0.1811,0.15,0.104
"4480","133711",1998,418,285,133,182,58,124,43.51,0.4351,0.435,0.436
"4481","133881",1998,461,145,316,173,108,65,44.83,0.4483,0.375,0.342
"4482","133951",1998,2227,1298,929,430,117,313,24.11,0.2411,0.193,0.126
"4483","134079",1998,440,286,154,199,55,144,50.35,0.5035,0.452,0.357
"4484","134097",1998,5066,2932,2134,2143,705,1438,49.05,0.4905,0.423,0.33
"4485","134130",1998,5629,3171,2458,2886,1037,1849,58.31,0.5831,0.513,0.422
"4486","134945",1998,307,112,195,75,40,35,31.25,0.3125,0.244,0.205
"4487","135726",1998,1831,980,851,975,389,586,59.8,0.598,0.532,0.457
"4488","136172",1998,1371,842,529,353,105,248,29.45,0.2945,0.257,0.198
"4489","136950",1998,458,278,180,232,80,152,54.68,0.5468,0.507,0.444
"4490","137546",1998,539,311,228,279,113,166,53.38,0.5338,0.518,0.496
"4491","138354",1998,647,365,282,136,40,96,26.3,0.263,0.21,0.142
"4492","138716",1998,493,313,180,30,10,20,6.39,0.0639,0.061,0.056
"4493","138789",1998,550,378,172,26,8,18,4.76,0.0476,0.047,0.047
"4494","139144",1998,525,336,189,297,106,191,56.85,0.5685,0.566,0.561
"4495","139366",1998,723,450,273,63,17,46,10.22,0.1022,0.087,0.062
"4496","139393",1998,211,134,77,112,36,76,56.72,0.5672,0.531,0.468
"4497","139658",1998,1692,908,784,1227,548,679,74.78,0.7478,0.725,0.699
"4498","139719",1998,432,240,192,40,11,29,12.08,0.1208,0.093,0.057
"4499","139755",1998,2487,721,1766,644,371,273,37.86,0.3786,0.259,0.21
"4500","139764",1998,335,215,120,41,5,36,16.74,0.1674,0.122,0.042
"4501","139861",1998,750,470,280,127,22,105,22.34,0.2234,0.169,0.079
"4502","139931",1998,2897,1549,1348,335,87,248,16.01,0.1601,0.116,0.065
"4503","139940",1998,1491,924,567,208,63,145,15.69,0.1569,0.14,0.111
"4504","139959",1998,4384,2588,1796,1771,535,1236,47.76,0.4776,0.404,0.298
"4505","140447",1998,706,428,278,221,74,147,34.35,0.3435,0.313,0.266
"4506","140960",1998,321,179,142,23,5,18,10.06,0.1006,0.072,0.035
"4507","140988",1998,247,167,80,86,22,64,38.32,0.3832,0.348,0.275
"4508","141185",1998,229,141,88,76,24,52,36.88,0.3688,0.332,0.273
"4509","141264",1998,1301,755,546,158,44,114,15.1,0.151,0.121,0.081
"4510","141334",1998,1670,1042,628,166,34,132,12.67,0.1267,0.099,0.054
"4511","141486",1998,186,122,64,40,12,28,22.95,0.2295,0.215,0.188
"4512","141565",1998,351,194,157,24,11,13,6.7,0.067,0.068,0.07
"4513","141574",1998,1388,795,593,162,55,107,13.46,0.1346,0.117,0.093
"4514","142276",1998,1442,787,655,52,15,37,4.7,0.047,0.036,0.023
"4515","142285",1998,1481,732,749,297,112,185,25.27,0.2527,0.201,0.15
"4516","142461",1998,310,193,117,101,27,74,38.34,0.3834,0.326,0.231
"4517","143084",1998,567,321,246,389,148,241,75.08,0.7508,0.686,0.602
"4518","143288",1998,144,66,78,37,16,21,31.82,0.3182,0.257,0.205
"4519","144005",1998,601,399,202,10,3,7,1.75,0.0175,0.017,0.015
"4520","144281",1998,1210,588,622,229,108,121,20.58,0.2058,0.189,0.174
"4521","144740",1998,1448,852,596,591,216,375,44.01,0.4401,0.408,0.362
"4522","144892",1998,1604,984,620,547,148,399,40.55,0.4055,0.341,0.239
"4523","144962",1998,266,152,114,154,51,103,67.76,0.6776,0.579,0.447
"4524","144971",1998,114,57,57,65,31,34,59.65,0.5965,0.57,0.544
"4525","145600",1998,2880,1629,1251,465,166,299,18.35,0.1835,0.161,0.133
"4526","145619",1998,299,160,139,93,35,58,36.25,0.3625,0.311,0.252
"4527","145637",1998,6453,3174,3279,3729,1680,2049,64.56,0.6456,0.578,0.512
"4528","145691",1998,238,133,105,107,37,70,52.63,0.5263,0.45,0.352
"4529","145813",1998,2740,1728,1012,915,268,647,37.44,0.3744,0.334,0.265
"4530","146481",1998,302,177,125,167,63,104,58.76,0.5876,0.553,0.504
"4531","146612",1998,391,193,198,151,64,87,45.08,0.4508,0.386,0.323
"4532","146719",1998,1340,868,472,641,208,433,49.88,0.4988,0.478,0.441
"4533","146825",1998,163,79,84,59,22,37,46.84,0.4684,0.362,0.262
"4534","147013",1998,247,139,108,91,24,67,48.2,0.482,0.368,0.222
"4535","147244",1998,594,331,263,291,91,200,60.42,0.6042,0.49,0.346
"4536","147341",1998,320,146,174,170,84,86,58.9,0.589,0.531,0.483
"4537","147703",1998,2818,1513,1305,682,244,438,28.95,0.2895,0.242,0.187
"4538","147767",1998,1912,1023,889,1601,706,895,87.49,0.8749,0.837,0.794
"4539","147776",1998,961,594,367,15,3,12,2.02,0.0202,0.016,0.008
"4540","147828",1998,428,227,201,159,59,100,44.05,0.4405,0.371,0.294
"4541","148131",1998,232,122,110,109,43,66,54.1,0.541,0.47,0.391
"4542","148496",1998,207,137,70,102,36,66,48.18,0.4818,0.493,0.514
"4543","148584",1998,176,88,88,64,21,43,48.86,0.4886,0.364,0.239
"4544","148627",1998,271,180,91,87,21,66,36.67,0.3667,0.321,0.231
"4545","149222",1998,2637,1131,1506,542,248,294,25.99,0.2599,0.206,0.165
"4546","149231",1998,1408,853,555,257,70,187,21.92,0.2192,0.183,0.126
"4547","149772",1998,1749,928,821,504,203,301,32.44,0.3244,0.288,0.247
"4548","149781",1998,573,300,273,409,186,223,74.33,0.7433,0.714,0.681
"4549","150066",1998,534,319,215,202,78,124,38.87,0.3887,0.378,0.363
"4550","150136",1998,3512,1905,1607,896,311,585,30.71,0.3071,0.255,0.194
"4551","150145",1998,273,173,100,104,36,68,39.31,0.3931,0.381,0.36
"4552","150163",1998,912,557,355,452,145,307,55.12,0.5512,0.496,0.408
"4553","150400",1998,593,344,249,423,164,259,75.29,0.7529,0.713,0.659
"4554","150534",1998,665,423,242,293,92,201,47.52,0.4752,0.441,0.38
"4555","150668",1998,207,121,86,99,39,60,49.59,0.4959,0.478,0.453
"4556","150941",1998,227,151,76,115,34,81,53.64,0.5364,0.507,0.447
"4557","151102",1998,1303,673,630,38,16,22,3.27,0.0327,0.029,0.025
"4558","151111",1998,2570,1387,1183,110,41,69,4.97,0.0497,0.043,0.035
"4559","151306",1998,1552,945,607,197,56,141,14.92,0.1492,0.127,0.092
"4560","151324",1998,1994,1062,932,368,123,245,23.07,0.2307,0.185,0.132
"4561","151333",1998,333,230,103,25,2,23,10,0.1,0.075,0.019
"4562","151342",1998,732,427,305,31,14,17,3.98,0.0398,0.042,0.046
"4563","151351",1998,6735,3810,2925,2747,1088,1659,43.54,0.4354,0.408,0.372
"4564","151360",1998,535,347,188,31,8,23,6.63,0.0663,0.058,0.043
"4565","151379",1998,727,407,320,28,6,22,5.41,0.0541,0.039,0.019
"4566","151388",1998,230,146,84,7,2,5,3.42,0.0342,0.03,0.024
"4567","151777",1998,309,173,136,139,47,92,53.18,0.5318,0.45,0.346
"4568","151786",1998,205,158,47,70,14,56,35.44,0.3544,0.341,0.298
"4569","152080",1998,1937,895,1042,1706,891,815,91.06,0.9106,0.881,0.855
"4570","152248",1998,1062,560,502,38,17,21,3.75,0.0375,0.036,0.034
"4571","152363",1998,254,136,118,113,46,67,49.26,0.4926,0.445,0.39
"4572","152530",1998,460,243,217,293,128,165,67.9,0.679,0.637,0.59
"4573","152600",1998,685,350,335,396,162,234,66.86,0.6686,0.578,0.484
"4574","153001",1998,323,165,158,165,68,97,58.79,0.5879,0.511,0.43
"4575","153108",1998,411,222,189,249,101,148,66.67,0.6667,0.606,0.534
"4576","153269",1998,670,379,291,378,134,244,64.38,0.6438,0.564,0.46
"4577","153384",1998,350,194,156,282,127,155,79.9,0.799,0.806,0.814
"4578","153603",1998,3800,1775,2025,1111,438,673,37.92,0.3792,0.292,0.216
"4579","153834",1998,678,396,282,446,179,267,67.42,0.6742,0.658,0.635
"4580","154095",1998,1982,1257,725,585,146,439,34.92,0.3492,0.295,0.201
"4581","155089",1998,195,106,89,35,14,21,19.81,0.1981,0.179,0.157
"4582","155317",1998,3698,2069,1629,974,322,652,31.51,0.3151,0.263,0.198
"4583","155335",1998,110,65,45,28,8,20,30.77,0.3077,0.255,0.178
"4584","155399",1998,2921,1388,1533,755,295,460,33.14,0.3314,0.258,0.192
"4585","155520",1998,254,114,140,64,27,37,32.46,0.3246,0.252,0.193
"4586","155627",1998,117,43,74,24,10,14,32.56,0.3256,0.205,0.135
"4587","155937",1998,161,81,80,52,18,34,41.98,0.4198,0.323,0.225
"4588","156213",1998,333,204,129,211,82,129,63.24,0.6324,0.634,0.636
"4589","156286",1998,362,212,150,165,61,104,49.06,0.4906,0.456,0.407
"4590","156295",1998,414,237,177,161,70,91,38.4,0.384,0.389,0.395
"4591","156365",1998,359,194,165,82,25,57,29.38,0.2938,0.228,0.152
"4592","156541",1998,412,177,235,87,30,57,32.2,0.322,0.211,0.128
"4593","156745",1998,408,224,184,194,61,133,59.38,0.5938,0.475,0.332
"4594","157058",1998,379,215,164,34,9,25,11.63,0.1163,0.09,0.055
"4595","157076",1998,152,95,57,53,18,35,36.84,0.3684,0.349,0.316
"4596","157085",1998,2931,1548,1383,815,331,484,31.27,0.3127,0.278,0.239
"4597","157289",1998,2032,1011,1021,222,81,141,13.95,0.1395,0.109,0.079
"4598","157386",1998,1369,739,630,157,48,109,14.75,0.1475,0.115,0.076
"4599","157401",1998,1275,707,568,341,122,219,30.98,0.3098,0.267,0.215
"4600","157447",1998,1627,956,671,118,32,86,9,0.09,0.073,0.048
"4601","157535",1998,169,110,59,30,12,18,16.36,0.1636,0.178,0.203
"4602","157951",1998,2353,1347,1006,542,190,352,26.13,0.2613,0.23,0.189
"4603","158477",1998,294,180,114,126,34,92,51.11,0.5111,0.429,0.298
"4604","159009",1998,771,359,412,71,23,48,13.37,0.1337,0.092,0.056
"4605","159391",1998,5066,2874,2192,1198,399,799,27.8,0.278,0.236,0.182
"4606","159647",1998,1621,794,827,449,178,271,34.13,0.3413,0.277,0.215
"4607","159717",1998,1433,802,631,141,35,106,13.22,0.1322,0.098,0.055
"4608","159966",1998,1351,781,570,117,22,95,12.16,0.1216,0.087,0.039
"4609","160038",1998,1364,857,507,157,43,114,13.3,0.133,0.115,0.085
"4610","160612",1998,2588,1471,1117,156,50,106,7.21,0.0721,0.06,0.045
"4611","160621",1998,1715,911,804,110,25,85,9.33,0.0933,0.064,0.031
"4612","160658",1998,2931,1621,1310,249,69,180,11.1,0.111,0.085,0.053
"4613","161004",1998,433,213,220,361,181,180,84.51,0.8451,0.834,0.823
"4614","161226",1998,484,333,151,155,41,114,34.23,0.3423,0.32,0.272
"4615","161235",1998,93,40,53,9,1,8,20,0.2,0.097,0.019
"4616","161244",1998,148,95,53,8,2,6,6.32,0.0632,0.054,0.038
"4617","161253",1998,1342,671,671,418,165,253,37.7,0.377,0.311,0.246
"4618","161554",1998,789,463,326,66,18,48,10.37,0.1037,0.084,0.055
"4619","162007",1998,418,225,193,49,7,42,18.67,0.1867,0.117,0.036
"4620","162210",1998,140,67,73,17,7,10,14.93,0.1493,0.121,0.096
"4621","162283",1998,457,337,120,32,10,22,6.53,0.0653,0.07,0.083
"4622","162584",1998,932,486,446,181,66,115,23.66,0.2366,0.194,0.148
"4623","162654",1998,302,213,89,169,36,133,62.44,0.6244,0.56,0.404
"4624","162760",1998,149,144,5,97,2,95,65.97,0.6597,0.651,0.4
"4625","162928",1998,1077,467,610,864,469,395,84.58,0.8458,0.802,0.769
"4626","163046",1998,854,485,369,668,276,392,80.82,0.8082,0.782,0.748
"4627","163268",1998,1246,609,637,347,138,209,34.32,0.3432,0.278,0.217
"4628","163286",1998,4039,2007,2032,1858,801,1057,52.67,0.5267,0.46,0.394
"4629","163453",1998,1136,674,462,166,42,124,18.4,0.184,0.146,0.091
"4630","163462",1998,410,213,197,249,113,136,63.85,0.6385,0.607,0.574
"4631","163851",1998,935,534,401,438,139,299,55.99,0.5599,0.468,0.347
"4632","163912",1998,331,181,150,211,77,134,74.03,0.7403,0.637,0.513
"4633","164076",1998,1923,1175,748,573,183,390,33.19,0.3319,0.298,0.245
"4634","164173",1998,443,305,138,163,46,117,38.36,0.3836,0.368,0.333
"4635","164216",1998,278,174,104,163,53,110,63.22,0.6322,0.586,0.51
"4636","164270",1998,331,173,158,210,86,124,71.68,0.7168,0.634,0.544
"4637","164447",1998,226,96,130,57,22,35,36.46,0.3646,0.252,0.169
"4638","164492",1998,153,116,37,70,19,51,43.97,0.4397,0.458,0.514
"4639","164562",1998,522,334,188,402,138,264,79.04,0.7904,0.77,0.734
"4640","165015",1998,850,477,373,715,293,422,88.47,0.8847,0.841,0.786
"4641","165024",1998,1128,695,433,260,75,185,26.62,0.2662,0.23,0.173
"4642","165334",1998,501,305,196,323,119,204,66.89,0.6689,0.645,0.607
"4643","165662",1998,612,368,244,377,150,227,61.68,0.6168,0.616,0.615
"4644","165671",1998,151,151,0,80,0,80,52.98,0.5298,0.53,NA
"4645","165820",1998,503,281,222,81,24,57,20.28,0.2028,0.161,0.108
"4646","165866",1998,601,381,220,136,27,109,28.61,0.2861,0.226,0.123
"4647","165936",1998,417,289,128,214,65,149,51.56,0.5156,0.513,0.508
"4648","166027",1998,1650,772,878,1423,748,675,87.44,0.8744,0.862,0.852
"4649","166124",1998,723,354,369,623,305,318,89.83,0.8983,0.862,0.827
"4650","166513",1998,997,366,631,235,116,119,32.51,0.3251,0.236,0.184
"4651","166629",1998,3953,2021,1932,1651,625,1026,50.77,0.5077,0.418,0.323
"4652","166638",1998,579,307,272,69,29,40,13.03,0.1303,0.119,0.107
"4653","166683",1998,1042,446,596,840,466,374,83.86,0.8386,0.806,0.782
"4654","167288",1998,209,131,78,66,17,49,37.4,0.374,0.316,0.218
"4655","167987",1998,1086,535,551,284,102,182,34.02,0.3402,0.262,0.185
"4656","167996",1998,531,313,218,421,168,253,80.83,0.8083,0.793,0.771
"4657","168005",1998,620,355,265,208,75,133,37.46,0.3746,0.335,0.283
"4658","168148",1998,1236,668,568,1040,466,574,85.93,0.8593,0.841,0.82
"4659","168254",1998,535,238,297,231,119,112,47.06,0.4706,0.432,0.401
"4660","168281",1998,435,294,141,291,79,212,72.11,0.7211,0.669,0.56
"4661","168342",1998,537,265,272,492,252,240,90.57,0.9057,0.916,0.926
"4662","168546",1998,448,248,200,298,126,172,69.35,0.6935,0.665,0.63
"4663","168786",1998,346,213,133,75,23,52,24.41,0.2441,0.217,0.173
"4664","169080",1998,974,536,438,559,236,323,60.26,0.6026,0.574,0.539
"4665","169798",1998,2349,1426,923,244,79,165,11.57,0.1157,0.104,0.086
"4666","169910",1998,1946,812,1134,53,25,28,3.45,0.0345,0.027,0.022
"4667","170082",1998,2482,1544,938,469,153,316,20.47,0.2047,0.189,0.163
"4668","170301",1998,747,462,285,446,148,298,64.5,0.645,0.597,0.519
"4669","170532",1998,442,256,186,322,126,196,76.56,0.7656,0.729,0.677
"4670","170639",1998,575,250,325,67,27,40,16,0.16,0.117,0.083
"4671","170976",1998,5258,2654,2604,3531,1620,1911,72,0.72,0.672,0.622
"4672","171100",1998,6724,3767,2957,2343,757,1586,42.1,0.421,0.348,0.256
"4673","171128",1998,1194,328,866,323,202,121,36.89,0.3689,0.271,0.233
"4674","171137",1998,741,373,368,99,41,58,15.55,0.1555,0.134,0.111
"4675","171146",1998,613,372,241,60,20,40,10.75,0.1075,0.098,0.083
"4676","171599",1998,198,85,113,42,21,21,24.71,0.2471,0.212,0.186
"4677","172051",1998,895,492,403,59,20,39,7.93,0.0793,0.066,0.05
"4678","172699",1998,3621,1981,1640,699,255,444,22.41,0.2241,0.193,0.155
"4679","173160",1998,513,314,199,314,122,192,61.15,0.6115,0.612,0.613
"4680","173258",1998,520,279,241,450,204,246,88.17,0.8817,0.865,0.846
"4681","173328",1998,213,106,107,57,24,33,31.13,0.3113,0.268,0.224
"4682","173647",1998,695,391,304,477,195,282,72.12,0.7212,0.686,0.641
"4683","173902",1998,465,260,205,339,153,186,71.54,0.7154,0.729,0.746
"4684","174066",1998,4992,2582,2410,1441,573,868,33.62,0.3362,0.289,0.238
"4685","174233",1998,1746,911,835,362,138,224,24.59,0.2459,0.207,0.165
"4686","174251",1998,522,330,192,198,62,136,41.21,0.4121,0.379,0.323
"4687","174491",1998,393,242,151,155,55,100,41.32,0.4132,0.394,0.364
"4688","174792",1998,427,0,427,317,317,0,NA,NA,0.742,0.742
"4689","174844",1998,756,431,325,594,256,338,78.42,0.7842,0.786,0.788
"4690","174899",1998,277,213,64,163,30,133,62.44,0.6244,0.588,0.469
"4691","174914",1998,1038,579,459,561,230,331,57.17,0.5717,0.54,0.501
"4692","175342",1998,556,306,250,140,41,99,32.35,0.3235,0.252,0.164
"4693","175421",1998,112,53,59,35,12,23,43.4,0.434,0.312,0.203
"4694","175616",1998,427,265,162,100,23,77,29.06,0.2906,0.234,0.142
"4695","175856",1998,842,494,348,155,43,112,22.67,0.2267,0.184,0.124
"4696","175980",1998,286,145,141,169,79,90,62.07,0.6207,0.591,0.56
"4697","176017",1998,1794,920,874,602,213,389,42.28,0.4228,0.336,0.244
"4698","176035",1998,210,180,30,47,4,43,23.89,0.2389,0.224,0.133
"4699","176044",1998,321,182,139,68,16,52,28.57,0.2857,0.212,0.115
"4700","176080",1998,1929,944,985,501,178,323,34.22,0.3422,0.26,0.181
"4701","176406",1998,198,142,56,66,12,54,38.03,0.3803,0.333,0.214
"4702","176628",1998,113,64,49,39,9,30,46.88,0.4688,0.345,0.184
"4703","176947",1998,218,111,107,59,19,40,36.04,0.3604,0.271,0.178
"4704","176965",1998,1408,730,678,317,107,210,28.77,0.2877,0.225,0.158
"4705","177418",1998,156,111,45,59,11,48,43.24,0.4324,0.378,0.244
"4706","178059",1998,225,158,67,100,26,74,46.84,0.4684,0.444,0.388
"4707","178341",1998,857,469,388,95,30,65,13.86,0.1386,0.111,0.077
"4708","178387",1998,983,577,406,127,27,100,17.33,0.1733,0.129,0.067
"4709","178396",1998,3785,2077,1708,1425,500,925,44.54,0.4454,0.376,0.293
"4710","178402",1998,618,336,282,114,39,75,22.32,0.2232,0.184,0.138
"4711","178411",1998,717,151,566,106,81,25,16.56,0.1656,0.148,0.143
"4712","178420",1998,528,274,254,114,46,68,24.82,0.2482,0.216,0.181
"4713","178615",1998,1482,914,568,562,181,381,41.68,0.4168,0.379,0.319
"4714","179043",1998,280,153,127,141,50,91,59.48,0.5948,0.504,0.394
"4715","179159",1998,1239,694,545,684,251,433,62.39,0.6239,0.552,0.461
"4716","179557",1998,1239,757,482,300,75,225,29.72,0.2972,0.242,0.156
"4717","179566",1998,2739,1545,1194,607,192,415,26.86,0.2686,0.222,0.161
"4718","179867",1998,1465,770,695,1221,570,651,84.55,0.8455,0.833,0.82
"4719","179894",1998,339,198,141,123,50,73,36.87,0.3687,0.363,0.355
"4720","179946",1998,205,94,111,78,40,38,40.43,0.4043,0.38,0.36
"4721","180179",1998,539,325,214,52,10,42,12.92,0.1292,0.096,0.047
"4722","180461",1998,1886,846,1040,299,140,159,18.79,0.1879,0.159,0.135
"4723","180522",1998,253,107,146,25,15,10,9.35,0.0935,0.099,0.103
"4724","180984",1998,294,172,122,90,25,65,37.79,0.3779,0.306,0.205
"4725","181002",1998,794,462,332,481,195,286,61.9,0.619,0.606,0.587
"4726","181020",1998,266,123,143,156,70,86,69.92,0.6992,0.586,0.49
"4727","181127",1998,309,168,141,160,57,103,61.31,0.6131,0.518,0.404
"4728","181215",1998,1022,598,424,204,55,149,24.92,0.2492,0.2,0.13
"4729","181394",1998,1296,701,595,120,42,78,11.13,0.1113,0.093,0.071
"4730","181446",1998,429,246,183,200,76,124,50.41,0.5041,0.466,0.415
"4731","181464",1998,3353,1619,1734,740,275,465,28.72,0.2872,0.221,0.159
"4732","181534",1998,213,91,122,22,3,19,20.88,0.2088,0.103,0.025
"4733","181783",1998,700,402,298,177,56,121,30.1,0.301,0.253,0.188
"4734","182281",1998,1546,885,661,186,58,128,14.46,0.1446,0.12,0.088
"4735","182290",1998,1260,675,585,181,60,121,17.93,0.1793,0.144,0.103
"4736","182634",1998,235,162,73,111,29,82,50.62,0.5062,0.472,0.397
"4737","182795",1998,429,203,226,145,59,86,42.36,0.4236,0.338,0.261
"4738","183062",1998,773,470,303,178,53,125,26.6,0.266,0.23,0.175
"4739","183080",1998,784,375,409,190,81,109,29.07,0.2907,0.242,0.198
"4740","183239",1998,528,296,232,392,159,233,78.72,0.7872,0.742,0.685
"4741","183822",1998,247,170,77,25,7,18,10.59,0.1059,0.101,0.091
"4742","183974",1998,124,77,47,26,8,18,23.38,0.2338,0.21,0.17
"4743","184348",1998,337,213,124,226,84,142,66.67,0.6667,0.671,0.677
"4744","184603",1998,566,307,259,90,30,60,19.54,0.1954,0.159,0.116
"4745","184612",1998,151,118,33,20,3,17,14.41,0.1441,0.132,0.091
"4746","184782",1998,1118,624,494,414,160,254,40.71,0.4071,0.37,0.324
"4747","185129",1998,549,305,244,40,13,27,8.85,0.0885,0.073,0.053
"4748","185572",1998,834,429,405,253,98,155,36.13,0.3613,0.303,0.242
"4749","185590",1998,1106,660,446,252,60,192,29.09,0.2909,0.228,0.135
"4750","185828",1998,563,120,443,93,64,29,24.17,0.2417,0.165,0.144
"4751","186131",1998,1167,560,607,1000,495,505,90.18,0.9018,0.857,0.815
"4752","186201",1998,472,271,201,169,56,113,41.7,0.417,0.358,0.279
"4753","186283",1998,869,483,386,419,161,258,53.42,0.5342,0.482,0.417
"4754","186584",1998,1221,657,564,486,173,313,47.64,0.4764,0.398,0.307
"4755","186876",1998,744,420,324,321,116,205,48.81,0.4881,0.431,0.358
"4756","187134",1998,1206,714,492,760,278,482,67.51,0.6751,0.63,0.565
"4757","187444",1998,1133,663,470,145,39,106,15.99,0.1599,0.128,0.083
"4758","187985",1998,2617,1475,1142,281,96,185,12.54,0.1254,0.107,0.084
"4759","188030",1998,2077,1070,1007,254,77,177,16.54,0.1654,0.122,0.076
"4760","188429",1998,525,343,182,214,67,147,42.86,0.4286,0.408,0.368
"4761","188641",1998,554,275,279,272,118,154,56,0.56,0.491,0.423
"4762","190044",1998,616,138,478,292,216,76,55.07,0.5507,0.474,0.452
"4763","190099",1998,751,407,344,641,283,358,87.96,0.8796,0.854,0.823
"4764","190150",1998,1283,619,664,1061,545,516,83.36,0.8336,0.827,0.821
"4765","190248",1998,114,68,46,40,17,23,33.82,0.3382,0.351,0.37
"4766","190415",1998,3084,1452,1632,2633,1358,1275,87.81,0.8781,0.854,0.832
"4767","190512",1998,946,493,453,231,83,148,30.02,0.3002,0.244,0.183
"4768","190549",1998,1029,615,414,184,56,128,20.81,0.2081,0.179,0.135
"4769","190558",1998,1510,786,724,36,14,22,2.8,0.028,0.024,0.019
"4770","190567",1998,901,462,439,31,11,20,4.33,0.0433,0.034,0.025
"4771","190594",1998,1468,1026,442,134,29,105,10.23,0.1023,0.091,0.066
"4772","190637",1998,581,398,183,28,8,20,5.03,0.0503,0.048,0.044
"4773","190664",1998,1133,711,422,235,59,176,24.75,0.2475,0.207,0.14
"4774","190691",1998,383,235,148,22,8,14,5.96,0.0596,0.057,0.054
"4775","190725",1998,345,262,83,80,20,60,22.9,0.229,0.232,0.241
"4776","191241",1998,1532,912,620,1111,422,689,75.55,0.7555,0.725,0.681
"4777","191515",1998,464,238,226,372,170,202,84.87,0.8487,0.802,0.752
"4778","191533",1998,440,227,213,204,82,122,53.74,0.5374,0.464,0.385
"4779","191630",1998,488,280,208,347,129,218,77.86,0.7786,0.711,0.62
"4780","191649",1998,1749,907,842,593,217,376,41.46,0.4146,0.339,0.258
"4781","191676",1998,309,204,105,180,50,130,63.73,0.6373,0.583,0.476
"4782","191931",1998,696,302,394,279,117,162,53.64,0.5364,0.401,0.297
"4783","191968",1998,1337,759,578,909,379,530,69.83,0.6983,0.68,0.656
"4784","192192",1998,226,180,46,75,15,60,33.33,0.3333,0.332,0.326
"4785","192323",1998,471,279,192,309,114,195,69.89,0.6989,0.656,0.594
"4786","192439",1998,1061,689,372,44,8,36,5.22,0.0522,0.041,0.022
"4787","192703",1998,547,274,273,328,159,169,61.68,0.6168,0.6,0.582
"4788","192749",1998,338,225,113,126,35,91,40.44,0.4044,0.373,0.31
"4789","192819",1998,834,430,404,547,240,307,71.4,0.714,0.656,0.594
"4790","192925",1998,153,113,40,45,15,30,26.55,0.2655,0.294,0.375
"4791","193016",1998,907,582,325,53,14,39,6.7,0.067,0.058,0.043
"4792","193292",1998,180,117,63,72,21,51,43.59,0.4359,0.4,0.333
"4793","193353",1998,304,230,74,122,27,95,41.3,0.413,0.401,0.365
"4794","193399",1998,266,200,66,124,26,98,49,0.49,0.466,0.394
"4795","193584",1998,321,246,75,199,38,161,65.45,0.6545,0.62,0.507
"4796","193645",1998,852,738,114,161,11,150,20.33,0.2033,0.189,0.096
"4797","193654",1998,581,394,187,240,51,189,47.97,0.4797,0.413,0.273
"4798","193900",1998,3722,2224,1498,2028,805,1223,54.99,0.5499,0.545,0.537
"4799","193973",1998,543,332,211,271,93,178,53.61,0.5361,0.499,0.441
"4800","194161",1998,258,159,99,73,20,53,33.33,0.3333,0.283,0.202
"4801","194310",1998,1536,911,625,602,220,382,41.93,0.4193,0.392,0.352
"4802","194824",1998,1138,258,880,654,483,171,66.28,0.6628,0.575,0.549
"4803","195003",1998,1980,609,1371,816,526,290,47.62,0.4762,0.412,0.384
"4804","195030",1998,1062,481,581,730,372,358,74.43,0.7443,0.687,0.64
"4805","195164",1998,568,284,284,290,126,164,57.75,0.5775,0.511,0.444
"4806","195173",1998,440,259,181,146,40,106,40.93,0.4093,0.332,0.221
"4807","195216",1998,479,255,224,339,155,184,72.16,0.7216,0.708,0.692
"4808","195234",1998,345,262,83,175,29,146,55.73,0.5573,0.507,0.349
"4809","195243",1998,306,179,127,97,34,63,35.2,0.352,0.317,0.268
"4810","195304",1998,306,227,79,202,57,145,63.88,0.6388,0.66,0.722
"4811","195474",1998,619,311,308,436,202,234,75.24,0.7524,0.704,0.656
"4812","195526",1998,596,366,230,482,193,289,78.96,0.7896,0.809,0.839
"4813","195544",1998,100,82,18,69,9,60,73.17,0.7317,0.69,0.5
"4814","195809",1998,2504,1417,1087,886,318,568,40.08,0.4008,0.354,0.293
"4815","196413",1998,2566,1383,1183,1689,702,987,71.37,0.7137,0.658,0.593
"4816","196592",1998,1651,1155,496,221,65,156,13.51,0.1351,0.134,0.131
"4817","197045",1998,306,203,103,107,31,76,37.44,0.3744,0.35,0.301
"4818","197133",1998,626,379,247,504,191,313,82.59,0.8259,0.805,0.773
"4819","197869",1998,2312,1192,1120,687,239,448,37.58,0.3758,0.297,0.213
"4820","197984",1998,198,94,104,87,41,46,48.94,0.4894,0.439,0.394
"4821","198385",1998,472,253,219,423,198,225,88.93,0.8893,0.896,0.904
"4822","198464",1998,2803,1714,1089,720,196,524,30.57,0.3057,0.257,0.18
"4823","198507",1998,378,229,149,109,22,87,37.99,0.3799,0.288,0.148
"4824","198516",1998,1013,632,381,660,234,426,67.41,0.6741,0.652,0.614
"4825","198835",1998,267,138,129,112,38,74,53.62,0.5362,0.419,0.295
"4826","198969",1998,437,117,320,88,55,33,28.21,0.2821,0.201,0.172
"4827","199102",1998,1366,695,671,323,104,219,31.51,0.3151,0.236,0.155
"4828","199111",1998,474,278,196,120,35,85,30.58,0.3058,0.253,0.179
"4829","199120",1998,3425,2116,1309,2289,794,1495,70.65,0.7065,0.668,0.607
"4830","199139",1998,2122,1178,944,456,169,287,24.36,0.2436,0.215,0.179
"4831","199148",1998,1791,1257,534,472,94,378,30.07,0.3007,0.264,0.176
"4832","199157",1998,673,409,264,184,41,143,34.96,0.3496,0.273,0.155
"4833","199193",1998,3751,1513,2238,1075,492,583,38.53,0.3853,0.287,0.22
"4834","199218",1998,1681,1030,651,628,180,448,43.5,0.435,0.374,0.276
"4835","199281",1998,464,244,220,99,36,63,25.82,0.2582,0.213,0.164
"4836","199306",1998,148,67,81,45,17,28,41.79,0.4179,0.304,0.21
"4837","199412",1998,147,111,36,67,15,52,46.85,0.4685,0.456,0.417
"4838","199582",1998,299,164,135,57,13,44,26.83,0.2683,0.191,0.096
"4839","199643",1998,382,220,162,73,20,53,24.09,0.2409,0.191,0.123
"4840","199847",1998,993,505,488,746,334,412,81.58,0.8158,0.751,0.684
"4841","199962",1998,273,127,146,89,34,55,43.31,0.4331,0.326,0.233
"4842","199999",1998,524,364,160,114,23,91,25,0.25,0.218,0.144
"4843","200004",1998,1098,544,554,249,80,169,31.07,0.3107,0.227,0.144
"4844","200059",1998,363,204,159,26,4,22,10.78,0.1078,0.072,0.025
"4845","200156",1998,278,150,128,99,39,60,40,0.4,0.356,0.305
"4846","200217",1998,404,244,160,149,39,110,45.08,0.4508,0.369,0.244
"4847","200226",1998,153,56,97,32,16,16,28.57,0.2857,0.209,0.165
"4848","200253",1998,371,217,154,28,7,21,9.68,0.0968,0.075,0.045
"4849","200280",1998,1465,722,743,326,141,185,25.62,0.2562,0.223,0.19
"4850","200332",1998,1259,524,735,181,83,98,18.7,0.187,0.144,0.113
"4851","200572",1998,193,100,93,47,12,35,35,0.35,0.244,0.129
"4852","201104",1998,570,351,219,235,66,169,48.15,0.4815,0.412,0.301
"4853","201371",1998,190,112,78,102,32,70,62.5,0.625,0.537,0.41
"4854","201548",1998,518,313,205,250,79,171,54.63,0.5463,0.483,0.385
"4855","201645",1998,830,301,529,476,265,211,70.1,0.701,0.573,0.501
"4856","201690",1998,230,130,100,27,5,22,16.92,0.1692,0.117,0.05
"4857","202134",1998,962,455,507,86,37,49,10.77,0.1077,0.089,0.073
"4858","202480",1998,1792,919,873,991,385,606,65.94,0.6594,0.553,0.441
"4859","202523",1998,631,364,267,456,173,283,77.75,0.7775,0.723,0.648
"4860","202763",1998,585,384,201,228,64,164,42.71,0.4271,0.39,0.318
"4861","203085",1998,290,138,152,130,54,76,55.07,0.5507,0.448,0.355
"4862","203128",1998,231,106,125,137,63,74,69.81,0.6981,0.593,0.504
"4863","203368",1998,854,433,421,532,241,291,67.21,0.6721,0.623,0.572
"4864","203517",1998,3019,1867,1152,491,154,337,18.05,0.1805,0.163,0.134
"4865","203535",1998,451,252,199,369,156,213,84.52,0.8452,0.818,0.784
"4866","203580",1998,68,62,6,32,3,29,46.77,0.4677,0.471,0.5
"4867","203775",1998,398,235,163,153,56,97,41.28,0.4128,0.384,0.344
"4868","203845",1998,338,177,161,146,46,100,56.5,0.565,0.432,0.286
"4869","204024",1998,3332,1904,1428,2182,856,1326,69.64,0.6964,0.655,0.599
"4870","204185",1998,568,289,279,318,116,202,69.9,0.699,0.56,0.416
"4871","204194",1998,345,205,140,141,44,97,47.32,0.4732,0.409,0.314
"4872","204617",1998,184,118,66,73,18,55,46.61,0.4661,0.397,0.273
"4873","204796",1998,6151,3177,2974,1886,610,1276,40.16,0.4016,0.307,0.205
"4874","204857",1998,3369,1988,1381,1489,480,1009,50.75,0.5075,0.442,0.348
"4875","206330",1998,143,68,75,37,13,24,35.29,0.3529,0.259,0.173
"4876","206589",1998,504,259,245,335,147,188,72.59,0.7259,0.665,0.6
"4877","206604",1998,2101,1178,923,354,109,245,20.8,0.208,0.168,0.118
"4878","206622",1998,831,483,348,541,227,314,65.01,0.6501,0.651,0.652
"4879","206695",1998,1839,954,885,250,81,169,17.71,0.1771,0.136,0.092
"4880","206914",1998,590,327,263,35,13,22,6.73,0.0673,0.059,0.049
"4881","207209",1998,517,262,255,22,3,19,7.25,0.0725,0.043,0.012
"4882","207306",1998,290,147,143,35,15,20,13.61,0.1361,0.121,0.105
"4883","207324",1998,468,277,191,93,33,60,21.66,0.2166,0.199,0.173
"4884","207388",1998,2584,1301,1283,624,226,398,30.59,0.3059,0.241,0.176
"4885","207500",1998,3148,1618,1530,641,214,427,26.39,0.2639,0.204,0.14
"4886","207722",1998,279,159,120,48,19,29,18.24,0.1824,0.172,0.158
"4887","207847",1998,499,260,239,59,21,38,14.62,0.1462,0.118,0.088
"4888","207865",1998,866,453,413,136,38,98,21.63,0.2163,0.157,0.092
"4889","208822",1998,361,240,121,208,73,135,56.25,0.5625,0.576,0.603
"4890","209056",1998,424,253,171,249,94,155,61.26,0.6126,0.587,0.55
"4891","209065",1998,415,232,183,238,81,157,67.67,0.6767,0.573,0.443
"4892","209542",1998,2229,1105,1124,615,210,405,36.65,0.3665,0.276,0.187
"4893","209551",1998,2304,1289,1015,839,280,559,43.37,0.4337,0.364,0.276
"4894","209612",1998,246,157,89,133,39,94,59.87,0.5987,0.541,0.438
"4895","209807",1998,800,419,381,101,28,73,17.42,0.1742,0.126,0.073
"4896","209922",1998,338,164,174,165,86,79,48.17,0.4817,0.488,0.494
"4897","210146",1998,670,403,267,124,40,84,20.84,0.2084,0.185,0.15
"4898","210401",1998,406,236,170,263,105,158,66.95,0.6695,0.648,0.618
"4899","210429",1998,700,425,275,116,26,90,21.18,0.2118,0.166,0.095
"4900","210571",1998,355,187,168,176,71,105,56.15,0.5615,0.496,0.423
"4901","210669",1998,545,272,273,321,144,177,65.07,0.6507,0.589,0.527
"4902","210775",1998,168,93,75,56,16,40,43.01,0.4301,0.333,0.213
"4903","211088",1998,334,248,86,189,46,143,57.66,0.5766,0.566,0.535
"4904","211158",1998,1377,890,487,465,102,363,40.79,0.4079,0.338,0.209
"4905","211291",1998,954,468,486,840,427,413,88.25,0.8825,0.881,0.879
"4906","211352",1998,304,209,95,152,35,117,55.98,0.5598,0.5,0.368
"4907","211361",1998,931,480,451,180,68,112,23.33,0.2333,0.193,0.151
"4908","211431",1998,163,157,6,43,3,40,25.48,0.2548,0.264,0.5
"4909","211440",1998,1303,445,858,848,539,309,69.44,0.6944,0.651,0.628
"4910","211468",1998,187,185,2,104,1,103,55.68,0.5568,0.556,0.5
"4911","211556",1998,142,142,0,63,0,63,44.37,0.4437,0.444,NA
"4912","211583",1998,95,93,2,42,0,42,45.16,0.4516,0.442,0
"4913","211608",1998,235,147,88,23,3,20,13.61,0.1361,0.098,0.034
"4914","211644",1998,1191,717,474,250,64,186,25.94,0.2594,0.21,0.135
"4915","211981",1998,400,203,197,172,70,102,50.25,0.5025,0.43,0.355
"4916","212009",1998,541,334,207,417,155,262,78.44,0.7844,0.771,0.749
"4917","212054",1998,2087,792,1295,247,73,174,21.97,0.2197,0.118,0.056
"4918","212106",1998,1253,771,482,615,210,405,52.53,0.5253,0.491,0.436
"4919","212115",1998,856,475,381,182,53,129,27.16,0.2716,0.213,0.139
"4920","212133",1998,317,220,97,168,48,120,54.55,0.5455,0.53,0.495
"4921","212160",1998,1205,691,514,210,54,156,22.58,0.2258,0.174,0.105
"4922","212197",1998,422,271,151,265,87,178,65.68,0.6568,0.628,0.576
"4923","212577",1998,502,257,245,394,175,219,85.21,0.8521,0.785,0.714
"4924","212601",1998,608,360,248,282,95,187,51.94,0.5194,0.464,0.383
"4925","212832",1998,143,100,43,44,9,35,35,0.35,0.308,0.209
"4926","212911",1998,322,170,152,277,130,147,86.47,0.8647,0.86,0.855
"4927","213020",1998,2757,1643,1114,661,161,500,30.43,0.3043,0.24,0.145
"4928","213251",1998,337,192,145,227,88,139,72.4,0.724,0.674,0.607
"4929","213321",1998,396,189,207,240,113,127,67.2,0.672,0.606,0.546
"4930","213349",1998,1417,840,577,282,70,212,25.24,0.2524,0.199,0.121
"4931","213358",1998,204,127,77,82,30,52,40.94,0.4094,0.402,0.39
"4932","213367",1998,663,321,342,361,161,200,62.31,0.6231,0.544,0.471
"4933","213385",1998,597,281,316,480,241,239,85.05,0.8505,0.804,0.763
"4934","213507",1998,422,208,214,247,110,137,65.87,0.6587,0.585,0.514
"4935","213543",1998,1112,478,634,789,397,392,82.01,0.8201,0.71,0.626
"4936","213613",1998,813,463,350,159,50,109,23.54,0.2354,0.196,0.143
"4937","213668",1998,380,195,185,222,85,137,70.26,0.7026,0.584,0.459
"4938","213783",1998,619,346,273,143,64,79,22.83,0.2283,0.231,0.234
"4939","213826",1998,241,186,55,102,16,86,46.24,0.4624,0.423,0.291
"4940","213996",1998,763,480,283,536,205,331,68.96,0.6896,0.702,0.724
"4941","214041",1998,1110,651,459,383,132,251,38.56,0.3856,0.345,0.288
"4942","214069",1998,187,142,45,126,31,95,66.9,0.669,0.674,0.689
"4943","214157",1998,292,172,120,183,69,114,66.28,0.6628,0.627,0.575
"4944","214175",1998,577,344,233,438,162,276,80.23,0.8023,0.759,0.695
"4945","214272",1998,314,206,108,131,42,89,43.2,0.432,0.417,0.389
"4946","214777",1998,5117,2590,2527,2448,959,1489,57.49,0.5749,0.478,0.38
"4947","215062",1998,2301,1128,1173,1975,969,1006,89.18,0.8918,0.858,0.826
"4948","215743",1998,335,182,153,90,47,43,23.63,0.2363,0.269,0.307
"4949","215798",1998,262,135,127,153,73,80,59.26,0.5926,0.584,0.575
"4950","215929",1998,873,527,346,607,217,390,74,0.74,0.695,0.627
"4951","216010",1998,1211,654,557,480,181,299,45.72,0.4572,0.396,0.325
"4952","216038",1998,1260,713,547,297,95,202,28.33,0.2833,0.236,0.174
"4953","216287",1998,361,193,168,297,132,165,85.49,0.8549,0.823,0.786
"4954","216339",1998,2150,1279,871,521,171,350,27.37,0.2737,0.242,0.196
"4955","216524",1998,336,189,147,249,93,156,82.54,0.8254,0.741,0.633
"4956","216694",1998,290,113,177,116,60,56,49.56,0.4956,0.4,0.339
"4957","216764",1998,1629,1031,598,474,124,350,33.95,0.3395,0.291,0.207
"4958","216807",1998,372,236,136,252,79,173,73.31,0.7331,0.677,0.581
"4959","216852",1998,490,207,283,204,111,93,44.93,0.4493,0.416,0.392
"4960","216931",1998,376,160,216,148,70,78,48.75,0.4875,0.394,0.324
"4961","217059",1998,853,462,391,370,145,225,48.7,0.487,0.434,0.371
"4962","217156",1998,1417,772,645,1180,520,660,85.49,0.8549,0.833,0.806
"4963","217402",1998,994,599,395,813,323,490,81.8,0.818,0.818,0.818
"4964","217536",1998,443,296,147,241,69,172,58.11,0.5811,0.544,0.469
"4965","217776",1998,91,51,40,25,11,14,27.45,0.2745,0.275,0.275
"4966","217819",1998,1937,1248,689,712,179,533,42.71,0.4271,0.368,0.26
"4967","217882",1998,2699,1273,1426,1091,396,695,54.6,0.546,0.404,0.278
"4968","217998",1998,136,84,52,89,28,61,72.62,0.7262,0.654,0.538
"4969","218061",1998,649,372,277,188,57,131,35.22,0.3522,0.29,0.206
"4970","218229",1998,488,322,166,92,19,73,22.67,0.2267,0.189,0.114
"4971","218238",1998,112,58,54,26,8,18,31.03,0.3103,0.232,0.148
"4972","218399",1998,204,123,81,37,10,27,21.95,0.2195,0.181,0.123
"4973","218414",1998,206,92,114,74,27,47,51.09,0.5109,0.359,0.237
"4974","218663",1998,2756,1553,1203,1098,398,700,45.07,0.4507,0.398,0.331
"4975","218724",1998,855,468,387,150,53,97,20.73,0.2073,0.175,0.137
"4976","218733",1998,739,428,311,186,50,136,31.78,0.3178,0.252,0.161
"4977","218742",1998,547,362,185,106,18,88,24.31,0.2431,0.194,0.097
"4978","218973",1998,298,145,153,224,113,111,76.55,0.7655,0.752,0.739
"4979","219000",1998,403,257,146,213,61,152,59.14,0.5914,0.529,0.418
"4980","219046",1998,632,381,251,48,13,35,9.19,0.0919,0.076,0.052
"4981","219082",1998,231,110,121,45,17,28,25.45,0.2545,0.195,0.14
"4982","219198",1998,126,85,41,44,13,31,36.47,0.3647,0.349,0.317
"4983","219259",1998,480,276,204,66,16,50,18.12,0.1812,0.138,0.078
"4984","219356",1998,1510,766,744,384,147,237,30.94,0.3094,0.254,0.198
"4985","219471",1998,894,500,394,180,58,122,24.4,0.244,0.201,0.147
"4986","219602",1998,846,518,328,76,20,56,10.81,0.1081,0.09,0.061
"4987","219709",1998,413,254,159,201,73,128,50.39,0.5039,0.487,0.459
"4988","219718",1998,82,29,53,16,6,10,34.48,0.3448,0.195,0.113
"4989","219949",1998,236,111,125,44,8,36,32.43,0.3243,0.186,0.064
"4990","220075",1998,1507,880,627,204,64,140,15.91,0.1591,0.135,0.102
"4991","220215",1998,358,199,159,116,53,63,31.66,0.3166,0.324,0.333
"4992","220613",1998,722,417,305,193,62,131,31.41,0.3141,0.267,0.203
"4993","220631",1998,179,122,57,31,10,21,17.21,0.1721,0.173,0.175
"4994","220710",1998,228,132,96,96,35,61,46.21,0.4621,0.421,0.365
"4995","221351",1998,383,206,177,291,128,163,79.13,0.7913,0.76,0.723
"4996","221519",1998,382,198,184,284,124,160,80.81,0.8081,0.743,0.674
"4997","221731",1998,105,61,44,28,8,20,32.79,0.3279,0.267,0.182
"4998","221847",1998,1044,460,584,124,38,86,18.7,0.187,0.119,0.065
"4999","221892",1998,187,111,76,40,16,24,21.62,0.2162,0.214,0.211
"5000","222178",1998,988,541,447,280,110,170,31.42,0.3142,0.283,0.246
"5001","222983",1998,347,190,157,242,97,145,76.32,0.7632,0.697,0.618
"5002","223232",1998,2933,1712,1221,1261,405,856,50,0.5,0.43,0.332
"5003","224004",1998,127,75,52,23,8,15,20,0.2,0.181,0.154
"5004","224323",1998,291,188,103,207,67,140,74.47,0.7447,0.711,0.65
"5005","225432",1998,696,406,290,8,3,5,1.23,0.0123,0.011,0.01
"5006","225548",1998,315,143,172,66,25,41,28.67,0.2867,0.21,0.145
"5007","225627",1998,375,265,110,59,10,49,18.49,0.1849,0.157,0.091
"5008","226231",1998,257,55,202,72,48,24,43.64,0.4364,0.28,0.238
"5009","226833",1998,685,350,335,74,26,48,13.71,0.1371,0.108,0.078
"5010","227216",1998,2449,1400,1049,363,105,258,18.43,0.1843,0.148,0.1
"5011","227331",1998,310,251,59,50,2,48,19.12,0.1912,0.161,0.034
"5012","227526",1998,1197,626,571,132,42,90,14.38,0.1438,0.11,0.074
"5013","227757",1998,642,320,322,489,228,261,81.56,0.8156,0.762,0.708
"5014","227845",1998,367,212,155,95,34,61,28.77,0.2877,0.259,0.219
"5015","227863",1998,231,153,78,65,12,53,34.64,0.3464,0.281,0.154
"5016","228042",1998,198,118,80,39,17,22,18.64,0.1864,0.197,0.212
"5017","228149",1998,499,313,186,147,49,98,31.31,0.3131,0.295,0.263
"5018","228246",1998,1306,720,586,689,249,440,61.11,0.6111,0.528,0.425
"5019","228343",1998,378,218,160,227,74,153,70.18,0.7018,0.601,0.462
"5020","228431",1998,2348,1432,916,388,69,319,22.28,0.2228,0.165,0.075
"5021","228459",1998,2592,1546,1046,458,127,331,21.41,0.2141,0.177,0.121
"5022","228501",1998,316,113,203,26,10,16,14.16,0.1416,0.082,0.049
"5023","228529",1998,605,296,309,102,44,58,19.59,0.1959,0.169,0.142
"5024","228705",1998,872,375,497,73,34,39,10.4,0.104,0.084,0.068
"5025","228723",1998,7322,3701,3621,2350,782,1568,42.37,0.4237,0.321,0.216
"5026","228769",1998,1241,568,673,155,64,91,16.02,0.1602,0.125,0.095
"5027","228778",1998,6598,3388,3210,2590,1036,1554,45.87,0.4587,0.393,0.323
"5028","228787",1998,494,213,281,187,98,89,41.78,0.4178,0.379,0.349
"5029","228796",1998,1639,847,792,58,21,37,4.37,0.0437,0.035,0.027
"5030","228875",1998,1397,839,558,587,177,410,48.87,0.4887,0.42,0.317
"5031","228981",1998,366,180,186,101,34,67,37.22,0.3722,0.276,0.183
"5032","229018",1998,112,69,43,19,7,12,17.39,0.1739,0.17,0.163
"5033","229027",1998,2067,1099,968,152,38,114,10.37,0.1037,0.074,0.039
"5034","229115",1998,3149,1581,1568,804,283,521,32.95,0.3295,0.255,0.18
"5035","229780",1998,244,120,124,37,9,28,23.33,0.2333,0.152,0.073
"5036","229814",1998,884,465,419,140,42,98,21.08,0.2108,0.158,0.1
"5037","230603",1998,667,487,180,113,7,106,21.77,0.2177,0.169,0.039
"5038","230728",1998,1764,1229,535,328,43,285,23.19,0.2319,0.186,0.08
"5039","230764",1998,1702,991,711,363,116,247,24.92,0.2492,0.213,0.163
"5040","230782",1998,1453,935,518,147,36,111,11.87,0.1187,0.101,0.069
"5041","231059",1998,518,278,240,378,166,212,76.26,0.7626,0.73,0.692
"5042","231174",1998,1758,994,764,872,336,536,53.92,0.5392,0.496,0.44
"5043","231420",1998,145,78,67,31,18,13,16.67,0.1667,0.214,0.269
"5044","231554",1998,129,69,60,4,1,3,4.35,0.0435,0.031,0.017
"5045","231624",1998,1290,701,589,1007,412,595,84.88,0.8488,0.781,0.699
"5046","231712",1998,693,414,279,121,35,86,20.77,0.2077,0.175,0.125
"5047","232025",1998,290,144,146,120,43,77,53.47,0.5347,0.414,0.295
"5048","232043",1998,229,130,99,107,43,64,49.23,0.4923,0.467,0.434
"5049","232089",1998,305,128,177,60,29,31,24.22,0.2422,0.197,0.164
"5050","232186",1998,2022,1112,910,540,164,376,33.81,0.3381,0.267,0.18
"5051","232265",1998,1153,715,438,461,105,356,49.79,0.4979,0.4,0.24
"5052","232423",1998,2971,1788,1183,1830,546,1284,71.81,0.7181,0.616,0.462
"5053","232557",1998,1020,479,541,327,126,201,41.96,0.4196,0.321,0.233
"5054","232566",1998,812,539,273,362,91,271,50.28,0.5028,0.446,0.333
"5055","232609",1998,433,267,166,218,65,153,57.3,0.573,0.503,0.392
"5056","232681",1998,812,557,255,530,156,374,67.15,0.6715,0.653,0.612
"5057","232706",1998,262,177,85,100,24,76,42.94,0.4294,0.382,0.282
"5058","232937",1998,1092,680,412,95,26,69,10.15,0.1015,0.087,0.063
"5059","232982",1998,1561,904,657,324,82,242,26.77,0.2677,0.208,0.125
"5060","233277",1998,1518,1011,507,569,154,415,41.05,0.4105,0.375,0.304
"5061","233374",1998,739,358,381,576,281,295,82.4,0.824,0.779,0.738
"5062","233426",1998,426,272,154,222,68,154,56.62,0.5662,0.521,0.442
"5063","233541",1998,288,178,110,80,19,61,34.27,0.3427,0.278,0.173
"5064","233897",1998,297,146,151,57,18,39,26.71,0.2671,0.192,0.119
"5065","233921",1998,4638,1941,2697,1999,855,1144,58.94,0.5894,0.431,0.317
"5066","234030",1998,2141,1257,884,364,117,247,19.65,0.1965,0.17,0.132
"5067","234085",1998,375,23,352,180,174,6,26.09,0.2609,0.48,0.494
"5068","234155",1998,871,526,345,192,48,144,27.38,0.2738,0.22,0.139
"5069","234164",1998,313,191,122,61,15,46,24.08,0.2408,0.195,0.123
"5070","235097",1998,816,486,330,148,34,114,23.46,0.2346,0.181,0.103
"5071","235167",1998,475,280,195,185,65,120,42.86,0.4286,0.389,0.333
"5072","236230",1998,652,414,238,272,77,195,47.1,0.471,0.417,0.324
"5073","236328",1998,680,417,263,446,151,295,70.74,0.7074,0.656,0.574
"5074","236577",1998,582,376,206,232,75,157,41.76,0.4176,0.399,0.364
"5075","236595",1998,626,369,257,287,114,173,46.88,0.4688,0.458,0.444
"5076","236896",1998,305,165,140,60,27,33,20,0.2,0.197,0.193
"5077","236939",1998,2934,1526,1408,888,335,553,36.24,0.3624,0.303,0.238
"5078","236948",1998,4038,2076,1962,1716,718,998,48.07,0.4807,0.425,0.366
"5079","237011",1998,2104,1221,883,623,202,421,34.48,0.3448,0.296,0.229
"5080","237057",1998,386,204,182,286,132,154,75.49,0.7549,0.741,0.725
"5081","237066",1998,373,224,149,197,74,123,54.91,0.5491,0.528,0.497
"5082","237215",1998,426,215,211,7,4,3,1.4,0.014,0.016,0.019
"5083","237330",1998,545,293,252,74,30,44,15.02,0.1502,0.136,0.119
"5084","237358",1998,152,87,65,66,29,37,42.53,0.4253,0.434,0.446
"5085","237367",1998,555,311,244,93,27,66,21.22,0.2122,0.168,0.111
"5086","237792",1998,610,356,254,93,23,70,19.66,0.1966,0.152,0.091
"5087","237899",1998,551,282,269,31,13,18,6.38,0.0638,0.056,0.048
"5088","237932",1998,498,268,230,96,35,61,22.76,0.2276,0.193,0.152
"5089","237969",1998,472,247,225,204,74,130,52.63,0.5263,0.432,0.329
"5090","238032",1998,3335,1571,1764,818,348,470,29.92,0.2992,0.245,0.197
"5091","238333",1998,302,180,122,166,58,108,60,0.6,0.55,0.475
"5092","238430",1998,224,140,84,71,28,43,30.71,0.3071,0.317,0.333
"5093","238458",1998,414,296,118,156,31,125,42.23,0.4223,0.377,0.263
"5094","238476",1998,432,216,216,190,86,104,48.15,0.4815,0.44,0.398
"5095","238616",1998,337,187,150,126,46,80,42.78,0.4278,0.374,0.307
"5096","238661",1998,213,157,56,55,13,42,26.75,0.2675,0.258,0.232
"5097","239080",1998,204,137,67,64,20,44,32.12,0.3212,0.314,0.299
"5098","239105",1998,1730,952,778,960,355,605,63.55,0.6355,0.555,0.456
"5099","239628",1998,162,66,96,99,55,44,66.67,0.6667,0.611,0.573
"5100","239716",1998,460,247,213,282,106,176,71.26,0.7126,0.613,0.498
"5101","240107",1998,318,220,98,88,21,67,30.45,0.3045,0.277,0.214
"5102","240189",1998,1901,965,936,354,122,232,24.04,0.2404,0.186,0.13
"5103","240277",1998,946,612,334,155,53,102,16.67,0.1667,0.164,0.159
"5104","240329",1998,1740,1123,617,450,128,322,28.67,0.2867,0.259,0.207
"5105","240338",1998,124,80,44,60,20,40,50,0.5,0.484,0.455
"5106","240365",1998,1894,1095,799,252,67,185,16.89,0.1689,0.133,0.084
"5107","240374",1998,790,441,349,83,24,59,13.38,0.1338,0.105,0.069
"5108","240417",1998,1333,614,719,209,74,135,21.99,0.2199,0.157,0.103
"5109","240426",1998,376,218,158,55,16,39,17.89,0.1789,0.146,0.101
"5110","240444",1998,5548,3038,2510,2190,844,1346,44.31,0.4431,0.395,0.336
"5111","240453",1998,2513,1367,1146,273,102,171,12.51,0.1251,0.109,0.089
"5112","240462",1998,1118,369,749,134,63,71,19.24,0.1924,0.12,0.084
"5113","240471",1998,1199,773,426,287,87,200,25.87,0.2587,0.239,0.204
"5114","240480",1998,1503,868,635,310,85,225,25.92,0.2592,0.206,0.134
"5115","240727",1998,1225,660,565,306,104,202,30.61,0.3061,0.25,0.184
"5116","243443",1998,885,567,318,76,10,66,11.64,0.1164,0.086,0.031
"5117","243780",1998,6625,2825,3800,2040,998,1042,36.88,0.3688,0.308,0.263
"5118","100654",1999,1111,550,561,97,16,81,14.73,0.1473,0.087,0.029
"5119","100663",1999,1143,678,465,163,59,104,15.34,0.1534,0.143,0.127
"5120","100751",1999,2687,1499,1188,948,309,639,42.63,0.4263,0.353,0.26
"5121","100858",1999,3693,1875,1818,1189,393,796,42.45,0.4245,0.322,0.216
"5122","101435",1999,163,103,60,58,14,44,42.72,0.4272,0.356,0.233
"5123","101480",1999,805,455,350,142,44,98,21.54,0.2154,0.176,0.126
"5124","101675",1999,319,170,149,113,21,92,54.12,0.5412,0.354,0.141
"5125","101879",1999,809,473,336,127,28,99,20.93,0.2093,0.157,0.083
"5126","102049",1999,674,420,254,353,120,233,55.48,0.5548,0.524,0.472
"5127","102094",1999,882,521,361,122,22,100,19.19,0.1919,0.138,0.061
"5128","102234",1999,299,182,117,147,43,104,57.14,0.5714,0.492,0.368
"5129","102368",1999,845,510,335,271,85,186,36.47,0.3647,0.321,0.254
"5130","102377",1999,679,400,279,119,27,92,23,0.23,0.175,0.097
"5131","104151",1999,5625,3096,2529,1505,522,983,31.75,0.3175,0.268,0.206
"5132","104179",1999,5126,2745,2381,1626,623,1003,36.54,0.3654,0.317,0.262
"5133","105330",1999,2162,1278,884,562,166,396,30.99,0.3099,0.26,0.188
"5134","106245",1999,826,518,308,51,12,39,7.53,0.0753,0.062,0.039
"5135","106342",1999,141,79,62,82,33,49,62.03,0.6203,0.582,0.532
"5136","106397",1999,2189,1123,1066,666,235,431,38.38,0.3838,0.304,0.22
"5137","106412",1999,656,341,315,76,20,56,16.42,0.1642,0.116,0.063
"5138","106458",1999,1654,937,717,303,92,211,22.52,0.2252,0.183,0.128
"5139","106467",1999,1055,508,547,146,55,91,17.91,0.1791,0.138,0.101
"5140","106485",1999,685,370,315,53,15,38,10.27,0.1027,0.077,0.048
"5141","106704",1999,1729,1030,699,272,86,186,18.06,0.1806,0.157,0.123
"5142","107044",1999,941,488,453,313,130,183,37.5,0.375,0.333,0.287
"5143","107080",1999,330,181,149,183,74,109,60.22,0.6022,0.555,0.497
"5144","107141",1999,267,149,118,113,39,74,49.66,0.4966,0.423,0.331
"5145","107512",1999,443,256,187,197,72,125,48.83,0.4883,0.445,0.385
"5146","107558",1999,164,93,71,53,17,36,38.71,0.3871,0.323,0.239
"5147","110097",1999,563,373,190,370,123,247,66.22,0.6622,0.657,0.647
"5148","110404",1999,234,83,151,195,126,69,83.13,0.8313,0.833,0.834
"5149","110422",1999,2673,1277,1396,557,167,390,30.54,0.3054,0.208,0.12
"5150","110486",1999,517,319,198,69,14,55,17.24,0.1724,0.133,0.071
"5151","110495",1999,470,310,160,101,16,85,27.42,0.2742,0.215,0.1
"5152","110510",1999,1049,679,370,105,30,75,11.05,0.1105,0.1,0.081
"5153","110529",1999,2489,1008,1481,226,90,136,13.49,0.1349,0.091,0.061
"5154","110538",1999,2007,1139,868,304,67,237,20.81,0.2081,0.151,0.077
"5155","110547",1999,453,319,134,26,5,21,6.58,0.0658,0.057,0.037
"5156","110556",1999,1703,1002,701,225,56,169,16.87,0.1687,0.132,0.08
"5157","110565",1999,2544,1543,1001,349,63,286,18.54,0.1854,0.137,0.063
"5158","110574",1999,714,466,248,119,26,93,19.96,0.1996,0.167,0.105
"5159","110583",1999,3309,2128,1181,361,75,286,13.44,0.1344,0.109,0.064
"5160","110592",1999,1186,750,436,111,32,79,10.53,0.1053,0.094,0.073
"5161","110617",1999,1753,1013,740,159,39,120,11.85,0.1185,0.091,0.053
"5162","113698",1999,111,88,23,50,10,40,45.45,0.4545,0.45,0.435
"5163","115755",1999,751,436,315,89,25,64,14.68,0.1468,0.119,0.079
"5164","119173",1999,294,293,1,57,0,57,19.45,0.1945,0.194,0
"5165","120184",1999,129,85,44,50,17,33,38.82,0.3882,0.388,0.386
"5166","121309",1999,613,392,221,332,117,215,54.85,0.5485,0.542,0.529
"5167","121345",1999,390,194,196,338,167,171,88.14,0.8814,0.867,0.852
"5168","122409",1999,2834,1574,1260,394,119,275,17.47,0.1747,0.139,0.094
"5169","122436",1999,990,621,369,611,204,407,65.54,0.6554,0.617,0.553
"5170","122597",1999,1898,1158,740,178,54,124,10.71,0.1071,0.094,0.073
"5171","122612",1999,757,500,257,379,109,270,54,0.54,0.501,0.424
"5172","122931",1999,1101,619,482,854,358,496,80.13,0.8013,0.776,0.743
"5173","123554",1999,629,363,266,369,142,227,62.53,0.6253,0.587,0.534
"5174","123572",1999,844,555,289,161,24,137,24.68,0.2468,0.191,0.083
"5175","126562",1999,478,259,219,76,30,46,17.76,0.1776,0.159,0.137
"5176","126580",1999,682,395,287,104,35,69,17.47,0.1747,0.152,0.122
"5177","126614",1999,4545,2303,2242,1728,700,1028,44.64,0.4464,0.38,0.312
"5178","126818",1999,3076,1702,1374,1054,371,683,40.13,0.4013,0.343,0.27
"5179","127060",1999,812,410,402,420,181,239,58.29,0.5829,0.517,0.45
"5180","127185",1999,1019,429,590,102,37,65,15.15,0.1515,0.1,0.063
"5181","127565",1999,1440,764,676,86,40,46,6.02,0.0602,0.06,0.059
"5182","127741",1999,2291,1401,890,589,129,460,32.83,0.3283,0.257,0.145
"5183","128106",1999,611,326,285,76,27,49,15.03,0.1503,0.124,0.095
"5184","128744",1999,190,96,94,39,15,24,25,0.25,0.205,0.16
"5185","128771",1999,1280,559,721,143,47,96,17.17,0.1717,0.112,0.065
"5186","129020",1999,2940,1596,1344,1454,523,931,58.33,0.5833,0.495,0.389
"5187","129242",1999,837,446,391,662,287,375,84.08,0.8408,0.791,0.734
"5188","129941",1999,322,117,205,66,32,34,29.06,0.2906,0.205,0.156
"5189","130253",1999,718,416,302,401,141,260,62.5,0.625,0.558,0.467
"5190","130314",1999,144,144,0,61,0,61,42.36,0.4236,0.424,NA
"5191","130493",1999,1238,702,536,148,50,98,13.96,0.1396,0.12,0.093
"5192","130590",1999,565,286,279,442,206,236,82.52,0.8252,0.782,0.738
"5193","130697",1999,732,375,357,609,283,326,86.93,0.8693,0.832,0.793
"5194","130776",1999,697,359,338,70,22,48,13.37,0.1337,0.1,0.065
"5195","130794",1999,1358,682,676,1219,594,625,91.64,0.9164,0.898,0.879
"5196","130934",1999,632,375,257,132,37,95,25.33,0.2533,0.209,0.144
"5197","130943",1999,3513,2146,1367,2193,764,1429,66.59,0.6659,0.624,0.559
"5198","131159",1999,1146,744,402,723,231,492,66.13,0.6613,0.631,0.575
"5199","131283",1999,762,381,381,457,204,253,66.4,0.664,0.6,0.535
"5200","131450",1999,254,135,119,14,6,8,5.93,0.0593,0.055,0.05
"5201","131469",1999,2109,1282,827,1515,556,959,74.8,0.748,0.718,0.672
"5202","131496",1999,1474,802,672,1299,587,712,88.78,0.8878,0.881,0.874
"5203","131520",1999,937,632,305,405,99,306,48.42,0.4842,0.432,0.325
"5204","132471",1999,398,251,147,9,1,8,3.19,0.0319,0.023,0.007
"5205","132602",1999,677,360,317,134,36,98,27.22,0.2722,0.198,0.114
"5206","132903",1999,4267,2256,2011,1298,425,873,38.7,0.387,0.304,0.211
"5207","133492",1999,403,210,193,232,101,131,62.38,0.6238,0.576,0.523
"5208","133553",1999,939,151,788,305,245,60,39.74,0.3974,0.325,0.311
"5209","133650",1999,2205,1277,928,360,86,274,21.46,0.2146,0.163,0.093
"5210","133669",1999,1423,860,563,201,56,145,16.86,0.1686,0.141,0.099
"5211","133711",1999,419,267,152,186,61,125,46.82,0.4682,0.444,0.401
"5212","133881",1999,402,116,286,139,95,44,37.93,0.3793,0.346,0.332
"5213","133951",1999,2482,1460,1022,525,141,384,26.3,0.263,0.212,0.138
"5214","134079",1999,425,267,158,173,55,118,44.19,0.4419,0.407,0.348
"5215","134097",1999,5078,2934,2144,2244,793,1451,49.45,0.4945,0.442,0.37
"5216","134130",1999,6065,3388,2677,3191,1111,2080,61.39,0.6139,0.526,0.415
"5217","134945",1999,309,122,187,98,49,49,40.16,0.4016,0.317,0.262
"5218","135726",1999,1845,998,847,1031,439,592,59.32,0.5932,0.559,0.518
"5219","136172",1999,1501,886,615,375,97,278,31.38,0.3138,0.25,0.158
"5220","136950",1999,448,267,181,220,87,133,49.81,0.4981,0.491,0.481
"5221","137546",1999,548,325,223,312,119,193,59.38,0.5938,0.569,0.534
"5222","138354",1999,637,335,302,132,54,78,23.28,0.2328,0.207,0.179
"5223","138716",1999,648,424,224,92,23,69,16.27,0.1627,0.142,0.103
"5224","138789",1999,602,386,216,35,10,25,6.48,0.0648,0.058,0.046
"5225","139144",1999,401,243,158,197,69,128,52.67,0.5267,0.491,0.437
"5226","139366",1999,672,412,260,54,13,41,9.95,0.0995,0.08,0.05
"5227","139393",1999,228,144,84,124,45,79,54.86,0.5486,0.544,0.536
"5228","139658",1999,1515,870,645,1148,486,662,76.09,0.7609,0.758,0.753
"5229","139719",1999,406,206,200,36,9,27,13.11,0.1311,0.089,0.045
"5230","139755",1999,2293,654,1639,657,431,226,34.56,0.3456,0.287,0.263
"5231","139764",1999,259,161,98,42,14,28,17.39,0.1739,0.162,0.143
"5232","139861",1999,786,486,300,164,36,128,26.34,0.2634,0.209,0.12
"5233","139931",1999,3266,1729,1537,384,98,286,16.54,0.1654,0.118,0.064
"5234","139940",1999,1772,1082,690,242,69,173,15.99,0.1599,0.137,0.1
"5235","139959",1999,4375,2586,1789,1860,592,1268,49.03,0.4903,0.425,0.331
"5236","140447",1999,730,449,281,254,79,175,38.98,0.3898,0.348,0.281
"5237","140960",1999,281,150,131,18,4,14,9.33,0.0933,0.064,0.031
"5238","140988",1999,259,171,88,103,32,71,41.52,0.4152,0.398,0.364
"5239","141185",1999,216,135,81,65,19,46,34.07,0.3407,0.301,0.235
"5240","141264",1999,1177,735,442,211,52,159,21.63,0.2163,0.179,0.118
"5241","141334",1999,1604,1005,599,144,34,110,10.95,0.1095,0.09,0.057
"5242","141486",1999,231,159,72,49,12,37,23.27,0.2327,0.212,0.167
"5243","141565",1999,366,207,159,39,11,28,13.53,0.1353,0.107,0.069
"5244","141574",1999,1421,793,628,164,56,108,13.62,0.1362,0.115,0.089
"5245","142276",1999,1345,740,605,45,10,35,4.73,0.0473,0.033,0.017
"5246","142285",1999,1457,736,721,318,123,195,26.49,0.2649,0.218,0.171
"5247","142461",1999,295,165,130,88,31,57,34.55,0.3455,0.298,0.238
"5248","143084",1999,565,338,227,402,161,241,71.3,0.713,0.712,0.709
"5249","143288",1999,145,76,69,44,21,23,30.26,0.3026,0.303,0.304
"5250","144005",1999,461,329,132,9,3,6,1.82,0.0182,0.02,0.023
"5251","144281",1999,1134,560,574,225,103,122,21.79,0.2179,0.198,0.179
"5252","144740",1999,1700,997,703,771,299,472,47.34,0.4734,0.454,0.425
"5253","144892",1999,1478,929,549,482,131,351,37.78,0.3778,0.326,0.239
"5254","144962",1999,269,156,113,158,58,100,64.1,0.641,0.587,0.513
"5255","144971",1999,130,76,54,60,19,41,53.95,0.5395,0.462,0.352
"5256","145600",1999,2552,1381,1171,506,215,291,21.07,0.2107,0.198,0.184
"5257","145619",1999,259,127,132,74,30,44,34.65,0.3465,0.286,0.227
"5258","145637",1999,6458,3131,3327,3849,1733,2116,67.58,0.6758,0.596,0.521
"5259","145691",1999,241,131,110,97,34,63,48.09,0.4809,0.402,0.309
"5260","145813",1999,3067,1907,1160,1072,301,771,40.43,0.4043,0.35,0.259
"5261","146481",1999,341,208,133,216,80,136,65.38,0.6538,0.633,0.602
"5262","146612",1999,425,194,231,171,82,89,45.88,0.4588,0.402,0.355
"5263","146719",1999,1067,717,350,541,169,372,51.88,0.5188,0.507,0.483
"5264","146825",1999,187,80,107,55,25,30,37.5,0.375,0.294,0.234
"5265","147013",1999,246,164,82,101,27,74,45.12,0.4512,0.411,0.329
"5266","147244",1999,595,324,271,323,130,193,59.57,0.5957,0.543,0.48
"5267","147341",1999,259,155,104,132,44,88,56.77,0.5677,0.51,0.423
"5268","147703",1999,2924,1587,1337,742,285,457,28.8,0.288,0.254,0.213
"5269","147767",1999,1951,1039,912,1657,746,911,87.68,0.8768,0.849,0.818
"5270","147776",1999,943,573,370,22,7,15,2.62,0.0262,0.023,0.019
"5271","147828",1999,410,224,186,169,61,108,48.21,0.4821,0.412,0.328
"5272","148131",1999,273,148,125,98,36,62,41.89,0.4189,0.359,0.288
"5273","148496",1999,195,144,51,112,28,84,58.33,0.5833,0.574,0.549
"5274","148584",1999,170,101,69,54,14,40,39.6,0.396,0.318,0.203
"5275","148627",1999,325,196,129,96,33,63,32.14,0.3214,0.295,0.256
"5276","149222",1999,2547,1094,1453,483,234,249,22.76,0.2276,0.19,0.161
"5277","149231",1999,1357,800,557,253,66,187,23.38,0.2338,0.186,0.118
"5278","149772",1999,1690,856,834,542,215,327,38.2,0.382,0.321,0.258
"5279","149781",1999,583,311,272,450,204,246,79.1,0.791,0.772,0.75
"5280","150066",1999,498,304,194,206,61,145,47.7,0.477,0.414,0.314
"5281","150136",1999,3602,1931,1671,943,348,595,30.81,0.3081,0.262,0.208
"5282","150145",1999,265,156,109,98,30,68,43.59,0.4359,0.37,0.275
"5283","150163",1999,861,529,332,470,168,302,57.09,0.5709,0.546,0.506
"5284","150400",1999,579,327,252,436,194,242,74.01,0.7401,0.753,0.77
"5285","150534",1999,594,367,227,276,97,179,48.77,0.4877,0.465,0.427
"5286","150668",1999,220,135,85,90,30,60,44.44,0.4444,0.409,0.353
"5287","150941",1999,221,140,81,127,43,84,60,0.6,0.575,0.531
"5288","151102",1999,1303,688,615,48,16,32,4.65,0.0465,0.037,0.026
"5289","151111",1999,2552,1409,1143,166,67,99,7.03,0.0703,0.065,0.059
"5290","151306",1999,1674,1003,671,200,49,151,15.05,0.1505,0.119,0.073
"5291","151324",1999,2014,998,1016,352,132,220,22.04,0.2204,0.175,0.13
"5292","151333",1999,295,213,82,27,7,20,9.39,0.0939,0.092,0.085
"5293","151342",1999,637,382,255,37,10,27,7.07,0.0707,0.058,0.039
"5294","151351",1999,6503,3828,2675,3137,1138,1999,52.22,0.5222,0.482,0.425
"5295","151360",1999,540,345,195,45,16,29,8.41,0.0841,0.083,0.082
"5296","151379",1999,719,448,271,54,13,41,9.15,0.0915,0.075,0.048
"5297","151388",1999,255,161,94,10,1,9,5.59,0.0559,0.039,0.011
"5298","151777",1999,328,166,162,132,41,91,54.82,0.5482,0.402,0.253
"5299","151786",1999,251,181,70,88,19,69,38.12,0.3812,0.351,0.271
"5300","152080",1999,1967,932,1035,1739,880,859,92.17,0.9217,0.884,0.85
"5301","152248",1999,1112,593,519,42,13,29,4.89,0.0489,0.038,0.025
"5302","152363",1999,290,122,168,114,56,58,47.54,0.4754,0.393,0.333
"5303","152530",1999,473,256,217,341,142,199,77.73,0.7773,0.721,0.654
"5304","152600",1999,730,376,354,429,192,237,63.03,0.6303,0.588,0.542
"5305","153001",1999,322,144,178,146,69,77,53.47,0.5347,0.453,0.388
"5306","153108",1999,403,219,184,7,0,7,3.2,0.032,0.017,0
"5307","153269",1999,670,364,306,371,151,220,60.44,0.6044,0.554,0.493
"5308","153384",1999,325,168,157,271,126,145,86.31,0.8631,0.834,0.803
"5309","153603",1999,4020,1830,2190,1261,520,741,40.49,0.4049,0.314,0.237
"5310","153834",1999,606,354,252,393,155,238,67.23,0.6723,0.649,0.615
"5311","154095",1999,2122,1303,819,713,211,502,38.53,0.3853,0.336,0.258
"5312","155089",1999,226,125,101,36,13,23,18.4,0.184,0.159,0.129
"5313","155317",1999,3784,2099,1685,1155,374,781,37.21,0.3721,0.305,0.222
"5314","155335",1999,148,87,61,50,18,32,36.78,0.3678,0.338,0.295
"5315","155399",1999,3280,1574,1706,723,288,435,27.64,0.2764,0.22,0.169
"5316","155520",1999,205,111,94,71,28,43,38.74,0.3874,0.346,0.298
"5317","155627",1999,136,50,86,22,10,12,24,0.24,0.162,0.116
"5318","155937",1999,110,63,47,61,20,41,65.08,0.6508,0.555,0.426
"5319","156213",1999,326,198,128,200,76,124,62.63,0.6263,0.613,0.594
"5320","156286",1999,324,223,101,182,54,128,57.4,0.574,0.562,0.535
"5321","156295",1999,423,233,190,150,57,93,39.91,0.3991,0.355,0.3
"5322","156365",1999,290,155,135,77,31,46,29.68,0.2968,0.266,0.23
"5323","156541",1999,403,201,202,114,41,73,36.32,0.3632,0.283,0.203
"5324","156745",1999,340,205,135,158,51,107,52.2,0.522,0.465,0.378
"5325","157058",1999,366,186,180,40,8,32,17.2,0.172,0.109,0.044
"5326","157076",1999,191,102,89,51,18,33,32.35,0.3235,0.267,0.202
"5327","157085",1999,2742,1499,1243,792,293,499,33.29,0.3329,0.289,0.236
"5328","157289",1999,2297,1232,1065,289,90,199,16.15,0.1615,0.126,0.085
"5329","157386",1999,1325,756,569,156,55,101,13.36,0.1336,0.118,0.097
"5330","157401",1999,1177,666,511,345,114,231,34.68,0.3468,0.293,0.223
"5331","157447",1999,1696,969,727,35,13,22,2.27,0.0227,0.021,0.018
"5332","157535",1999,206,140,66,41,10,31,22.14,0.2214,0.199,0.152
"5333","157951",1999,2480,1447,1033,568,204,364,25.16,0.2516,0.229,0.197
"5334","158477",1999,270,162,108,112,34,78,48.15,0.4815,0.415,0.315
"5335","159009",1999,690,367,323,88,24,64,17.44,0.1744,0.128,0.074
"5336","159391",1999,5173,2956,2217,1262,398,864,29.23,0.2923,0.244,0.18
"5337","159647",1999,1753,840,913,478,199,279,33.21,0.3321,0.273,0.218
"5338","159717",1999,1275,636,639,127,34,93,14.62,0.1462,0.1,0.053
"5339","159966",1999,1445,860,585,129,30,99,11.51,0.1151,0.089,0.051
"5340","160038",1999,1656,988,668,184,71,113,11.44,0.1144,0.111,0.106
"5341","160612",1999,2315,1361,954,170,44,126,9.26,0.0926,0.073,0.046
"5342","160621",1999,1287,693,594,86,19,67,9.67,0.0967,0.067,0.032
"5343","160658",1999,2402,1300,1102,298,94,204,15.69,0.1569,0.124,0.085
"5344","161004",1999,464,259,205,418,183,235,90.73,0.9073,0.901,0.893
"5345","161226",1999,470,344,126,197,48,149,43.31,0.4331,0.419,0.381
"5346","161235",1999,109,64,45,17,3,14,21.88,0.2188,0.156,0.067
"5347","161244",1999,121,83,38,15,4,11,13.25,0.1325,0.124,0.105
"5348","161253",1999,1521,718,803,430,176,254,35.38,0.3538,0.283,0.219
"5349","161554",1999,815,477,338,96,24,72,15.09,0.1509,0.118,0.071
"5350","162007",1999,343,189,154,45,12,33,17.46,0.1746,0.131,0.078
"5351","162210",1999,175,115,60,25,6,19,16.52,0.1652,0.143,0.1
"5352","162283",1999,441,306,135,39,12,27,8.82,0.0882,0.088,0.089
"5353","162584",1999,932,508,424,165,52,113,22.24,0.2224,0.177,0.123
"5354","162654",1999,322,224,98,176,54,122,54.46,0.5446,0.547,0.551
"5355","162760",1999,156,152,4,100,1,99,65.13,0.6513,0.641,0.25
"5356","162928",1999,1098,441,657,868,503,365,82.77,0.8277,0.791,0.766
"5357","163046",1999,941,530,411,734,292,442,83.4,0.834,0.78,0.71
"5358","163268",1999,1396,638,758,417,188,229,35.89,0.3589,0.299,0.248
"5359","163286",1999,3871,1796,2075,1943,884,1059,58.96,0.5896,0.502,0.426
"5360","163453",1999,1152,661,491,208,41,167,25.26,0.2526,0.181,0.084
"5361","163462",1999,369,221,148,238,94,144,65.16,0.6516,0.645,0.635
"5362","163851",1999,877,537,340,458,149,309,57.54,0.5754,0.522,0.438
"5363","163912",1999,276,157,119,176,70,106,67.52,0.6752,0.638,0.588
"5364","164076",1999,2103,1277,826,610,170,440,34.46,0.3446,0.29,0.206
"5365","164173",1999,421,288,133,211,60,151,52.43,0.5243,0.501,0.451
"5366","164216",1999,282,175,107,175,54,121,69.14,0.6914,0.621,0.505
"5367","164270",1999,412,204,208,261,107,154,75.49,0.7549,0.633,0.514
"5368","164447",1999,240,92,148,77,33,44,47.83,0.4783,0.321,0.223
"5369","164492",1999,134,90,44,64,23,41,45.56,0.4556,0.478,0.523
"5370","164562",1999,592,361,231,404,150,254,70.36,0.7036,0.682,0.649
"5371","165015",1999,793,446,347,663,275,388,87,0.87,0.836,0.793
"5372","165024",1999,1079,657,422,208,43,165,25.11,0.2511,0.193,0.102
"5373","165334",1999,486,304,182,308,112,196,64.47,0.6447,0.634,0.615
"5374","165662",1999,653,361,292,433,192,241,66.76,0.6676,0.663,0.658
"5375","165671",1999,133,133,0,60,0,60,45.11,0.4511,0.451,NA
"5376","165820",1999,345,202,143,73,23,50,24.75,0.2475,0.212,0.161
"5377","165866",1999,559,402,157,130,27,103,25.62,0.2562,0.233,0.172
"5378","165936",1999,382,243,139,205,61,144,59.26,0.5926,0.537,0.439
"5379","166027",1999,1647,775,872,1429,757,672,86.71,0.8671,0.868,0.868
"5380","166124",1999,722,383,339,645,298,347,90.6,0.906,0.893,0.879
"5381","166513",1999,935,368,567,230,91,139,37.77,0.3777,0.246,0.16
"5382","166629",1999,4144,2199,1945,1824,701,1123,51.07,0.5107,0.44,0.36
"5383","166638",1999,671,368,303,102,33,69,18.75,0.1875,0.152,0.109
"5384","166683",1999,1049,448,601,863,473,390,87.05,0.8705,0.823,0.787
"5385","167288",1999,220,135,85,78,27,51,37.78,0.3778,0.355,0.318
"5386","167987",1999,1131,556,575,316,126,190,34.17,0.3417,0.279,0.219
"5387","167996",1999,572,333,239,458,185,273,81.98,0.8198,0.801,0.774
"5388","168005",1999,672,381,291,240,72,168,44.09,0.4409,0.357,0.247
"5389","168148",1999,1345,741,604,1134,497,637,85.96,0.8596,0.843,0.823
"5390","168254",1999,618,271,347,268,145,123,45.39,0.4539,0.434,0.418
"5391","168281",1999,427,281,146,298,85,213,75.8,0.758,0.698,0.582
"5392","168342",1999,544,264,280,487,244,243,92.05,0.9205,0.895,0.871
"5393","168546",1999,411,219,192,275,110,165,75.34,0.7534,0.669,0.573
"5394","168786",1999,347,227,120,93,32,61,26.87,0.2687,0.268,0.267
"5395","169080",1999,1059,591,468,574,225,349,59.05,0.5905,0.542,0.481
"5396","169798",1999,2767,1627,1140,298,93,205,12.6,0.126,0.108,0.082
"5397","169910",1999,1916,798,1118,78,44,34,4.26,0.0426,0.041,0.039
"5398","170082",1999,2528,1553,975,512,163,349,22.47,0.2247,0.203,0.167
"5399","170301",1999,755,455,300,485,184,301,66.15,0.6615,0.642,0.613
"5400","170532",1999,369,187,182,270,128,142,75.94,0.7594,0.732,0.703
"5401","170639",1999,505,242,263,71,30,41,16.94,0.1694,0.141,0.114
"5402","170976",1999,5563,2853,2710,3879,1779,2100,73.61,0.7361,0.697,0.656
"5403","171100",1999,6499,3674,2825,2580,833,1747,47.55,0.4755,0.397,0.295
"5404","171128",1999,1137,276,861,259,183,76,27.54,0.2754,0.228,0.213
"5405","171137",1999,690,334,356,88,30,58,17.37,0.1737,0.128,0.084
"5406","171146",1999,492,289,203,49,15,34,11.76,0.1176,0.1,0.074
"5407","171599",1999,181,74,107,63,32,31,41.89,0.4189,0.348,0.299
"5408","172051",1999,1015,549,466,81,36,45,8.2,0.082,0.08,0.077
"5409","172699",1999,4302,2288,2014,864,306,558,24.39,0.2439,0.201,0.152
"5410","173160",1999,479,315,164,295,98,197,62.54,0.6254,0.616,0.598
"5411","173258",1999,507,257,250,410,199,211,82.1,0.821,0.809,0.796
"5412","173328",1999,258,142,116,76,32,44,30.99,0.3099,0.295,0.276
"5413","173647",1999,654,365,289,473,207,266,72.88,0.7288,0.723,0.716
"5414","173902",1999,460,271,189,360,147,213,78.6,0.786,0.783,0.778
"5415","174066",1999,5025,2636,2389,1604,655,949,36,0.36,0.319,0.274
"5416","174233",1999,2000,1032,968,416,168,248,24.03,0.2403,0.208,0.174
"5417","174251",1999,453,270,183,174,70,104,38.52,0.3852,0.384,0.383
"5418","174491",1999,392,262,130,160,42,118,45.04,0.4504,0.408,0.323
"5419","174792",1999,475,0,475,335,335,0,NA,NA,0.705,0.705
"5420","174844",1999,761,451,310,594,225,369,81.82,0.8182,0.781,0.726
"5421","174899",1999,305,230,75,156,36,120,52.17,0.5217,0.511,0.48
"5422","174914",1999,1087,603,484,642,255,387,64.18,0.6418,0.591,0.527
"5423","175342",1999,553,309,244,130,41,89,28.8,0.288,0.235,0.168
"5424","175421",1999,144,71,73,46,25,21,29.58,0.2958,0.319,0.342
"5425","175616",1999,458,275,183,107,38,69,25.09,0.2509,0.234,0.208
"5426","175856",1999,845,527,318,128,34,94,17.84,0.1784,0.151,0.107
"5427","175980",1999,284,158,126,177,67,110,69.62,0.6962,0.623,0.532
"5428","176017",1999,1810,944,866,621,218,403,42.69,0.4269,0.343,0.252
"5429","176035",1999,202,177,25,59,3,56,31.64,0.3164,0.292,0.12
"5430","176044",1999,248,138,110,48,18,30,21.74,0.2174,0.194,0.164
"5431","176080",1999,2033,1003,1030,507,177,330,32.9,0.329,0.249,0.172
"5432","176406",1999,252,196,56,73,11,62,31.63,0.3163,0.29,0.196
"5433","176628",1999,113,81,32,45,7,38,46.91,0.4691,0.398,0.219
"5434","176947",1999,228,108,120,62,25,37,34.26,0.3426,0.272,0.208
"5435","176965",1999,1329,725,604,300,94,206,28.41,0.2841,0.226,0.156
"5436","177418",1999,144,94,50,60,14,46,48.94,0.4894,0.417,0.28
"5437","178059",1999,198,133,65,101,26,75,56.39,0.5639,0.51,0.4
"5438","178341",1999,804,434,370,104,40,64,14.75,0.1475,0.129,0.108
"5439","178387",1999,980,575,405,113,35,78,13.57,0.1357,0.115,0.086
"5440","178396",1999,3871,2138,1733,1468,525,943,44.11,0.4411,0.379,0.303
"5441","178402",1999,639,356,283,105,46,59,16.57,0.1657,0.164,0.163
"5442","178411",1999,679,140,539,112,77,35,25,0.25,0.165,0.143
"5443","178420",1999,539,274,265,122,43,79,28.83,0.2883,0.226,0.162
"5444","178615",1999,1446,884,562,594,201,393,44.46,0.4446,0.411,0.358
"5445","179043",1999,303,177,126,152,61,91,51.41,0.5141,0.502,0.484
"5446","179159",1999,1252,695,557,764,314,450,64.75,0.6475,0.61,0.564
"5447","179557",1999,1391,816,575,320,87,233,28.55,0.2855,0.23,0.151
"5448","179566",1999,2581,1439,1142,605,223,382,26.55,0.2655,0.234,0.195
"5449","179867",1999,1369,684,685,1125,548,577,84.36,0.8436,0.822,0.8
"5450","179894",1999,369,214,155,156,52,104,48.6,0.486,0.423,0.335
"5451","179946",1999,201,90,111,94,41,53,58.89,0.5889,0.468,0.369
"5452","180179",1999,629,384,245,56,15,41,10.68,0.1068,0.089,0.061
"5453","180461",1999,1894,891,1003,354,164,190,21.32,0.2132,0.187,0.164
"5454","180522",1999,261,112,149,30,16,14,12.5,0.125,0.115,0.107
"5455","180984",1999,324,149,175,86,41,45,30.2,0.302,0.265,0.234
"5456","181002",1999,822,499,323,516,209,307,61.52,0.6152,0.628,0.647
"5457","181020",1999,278,141,137,174,79,95,67.38,0.6738,0.626,0.577
"5458","181127",1999,286,141,145,146,54,92,65.25,0.6525,0.51,0.372
"5459","181215",1999,1035,579,456,212,71,141,24.35,0.2435,0.205,0.156
"5460","181394",1999,1477,762,715,151,45,106,13.91,0.1391,0.102,0.063
"5461","181446",1999,358,204,154,197,84,113,55.39,0.5539,0.55,0.545
"5462","181464",1999,3592,1778,1814,807,317,490,27.56,0.2756,0.225,0.175
"5463","181534",1999,192,87,105,65,31,34,39.08,0.3908,0.339,0.295
"5464","181783",1999,659,387,272,150,41,109,28.17,0.2817,0.228,0.151
"5465","182281",1999,1486,805,681,204,73,131,16.27,0.1627,0.137,0.107
"5466","182290",1999,1466,792,674,241,78,163,20.58,0.2058,0.164,0.116
"5467","182634",1999,236,151,85,115,47,68,45.03,0.4503,0.487,0.553
"5468","182795",1999,429,184,245,189,103,86,46.74,0.4674,0.441,0.42
"5469","183062",1999,1014,649,365,262,70,192,29.58,0.2958,0.258,0.192
"5470","183080",1999,772,377,395,204,75,129,34.22,0.3422,0.264,0.19
"5471","183239",1999,534,280,254,376,160,216,77.14,0.7714,0.704,0.63
"5472","183822",1999,242,155,87,13,4,9,5.81,0.0581,0.054,0.046
"5473","183974",1999,136,98,38,58,17,41,41.84,0.4184,0.426,0.447
"5474","184348",1999,407,225,182,279,118,161,71.56,0.7156,0.686,0.648
"5475","184603",1999,526,281,245,96,31,65,23.13,0.2313,0.183,0.127
"5476","184612",1999,224,140,84,7,7,0,0,0,0.031,0.083
"5477","184782",1999,1119,587,532,436,183,253,43.1,0.431,0.39,0.344
"5478","185129",1999,603,331,272,54,18,36,10.88,0.1088,0.09,0.066
"5479","185572",1999,833,457,376,295,99,196,42.89,0.4289,0.354,0.263
"5480","185590",1999,1319,823,496,308,81,227,27.58,0.2758,0.234,0.163
"5481","185828",1999,649,114,535,116,88,28,24.56,0.2456,0.179,0.164
"5482","186131",1999,1148,556,592,1030,530,500,89.93,0.8993,0.897,0.895
"5483","186201",1999,527,293,234,201,66,135,46.08,0.4608,0.381,0.282
"5484","186283",1999,735,386,349,310,128,182,47.15,0.4715,0.422,0.367
"5485","186584",1999,1063,533,530,437,190,247,46.34,0.4634,0.411,0.358
"5486","186876",1999,705,409,296,254,86,168,41.08,0.4108,0.36,0.291
"5487","187134",1999,1207,697,510,776,281,495,71.02,0.7102,0.643,0.551
"5488","187444",1999,1105,614,491,177,56,121,19.71,0.1971,0.16,0.114
"5489","187985",1999,2715,1517,1198,276,85,191,12.59,0.1259,0.102,0.071
"5490","188030",1999,2210,1223,987,272,88,184,15.04,0.1504,0.123,0.089
"5491","188429",1999,532,366,166,233,64,169,46.17,0.4617,0.438,0.386
"5492","188641",1999,549,277,272,242,98,144,51.99,0.5199,0.441,0.36
"5493","190044",1999,706,225,481,407,264,143,63.56,0.6356,0.576,0.549
"5494","190099",1999,750,397,353,662,306,356,89.67,0.8967,0.883,0.867
"5495","190150",1999,1298,573,725,1068,586,482,84.12,0.8412,0.823,0.808
"5496","190248",1999,111,72,39,33,6,27,37.5,0.375,0.297,0.154
"5497","190415",1999,3158,1497,1661,2660,1341,1319,88.11,0.8811,0.842,0.807
"5498","190512",1999,1133,593,540,312,124,188,31.7,0.317,0.275,0.23
"5499","190549",1999,982,591,391,166,55,111,18.78,0.1878,0.169,0.141
"5500","190558",1999,1532,782,750,63,21,42,5.37,0.0537,0.041,0.028
"5501","190567",1999,773,341,432,45,16,29,8.5,0.085,0.058,0.037
"5502","190594",1999,1806,1281,525,176,36,140,10.93,0.1093,0.097,0.069
"5503","190637",1999,604,416,188,44,19,25,6.01,0.0601,0.073,0.101
"5504","190664",1999,876,528,348,200,50,150,28.41,0.2841,0.228,0.144
"5505","190691",1999,425,261,164,31,11,20,7.66,0.0766,0.073,0.067
"5506","190725",1999,293,230,63,70,17,53,23.04,0.2304,0.239,0.27
"5507","191241",1999,1538,891,647,1105,443,662,74.3,0.743,0.718,0.685
"5508","191515",1999,500,254,246,408,190,218,85.83,0.8583,0.816,0.772
"5509","191533",1999,407,210,197,192,75,117,55.71,0.5571,0.472,0.381
"5510","191630",1999,502,255,247,307,133,174,68.24,0.6824,0.612,0.538
"5511","191649",1999,1876,1015,861,675,242,433,42.66,0.4266,0.36,0.281
"5512","191676",1999,294,186,108,166,56,110,59.14,0.5914,0.565,0.519
"5513","191931",1999,790,349,441,335,147,188,53.87,0.5387,0.424,0.333
"5514","191968",1999,1586,885,701,1022,418,604,68.25,0.6825,0.644,0.596
"5515","192192",1999,268,192,76,90,23,67,34.9,0.349,0.336,0.303
"5516","192323",1999,471,264,207,304,121,183,69.32,0.6932,0.645,0.585
"5517","192439",1999,1010,719,291,38,12,26,3.62,0.0362,0.038,0.041
"5518","192703",1999,645,289,356,386,195,191,66.09,0.6609,0.598,0.548
"5519","192749",1999,387,266,121,195,57,138,51.88,0.5188,0.504,0.471
"5520","192819",1999,975,548,427,665,260,405,73.91,0.7391,0.682,0.609
"5521","192925",1999,143,104,39,31,6,25,24.04,0.2404,0.217,0.154
"5522","193016",1999,953,630,323,68,18,50,7.94,0.0794,0.071,0.056
"5523","193292",1999,209,156,53,84,11,73,46.79,0.4679,0.402,0.208
"5524","193353",1999,323,247,76,156,25,131,53.04,0.5304,0.483,0.329
"5525","193399",1999,240,167,73,76,18,58,34.73,0.3473,0.317,0.247
"5526","193584",1999,334,244,90,205,51,154,63.11,0.6311,0.614,0.567
"5527","193645",1999,814,670,144,152,16,136,20.3,0.203,0.187,0.111
"5528","193654",1999,573,399,174,234,55,179,44.86,0.4486,0.408,0.316
"5529","193900",1999,3845,2323,1522,2245,868,1377,59.28,0.5928,0.584,0.57
"5530","193973",1999,575,345,230,315,127,188,54.49,0.5449,0.548,0.552
"5531","194161",1999,322,182,140,107,39,68,37.36,0.3736,0.332,0.279
"5532","194310",1999,1500,895,605,604,205,399,44.58,0.4458,0.403,0.339
"5533","194824",1999,1323,295,1028,812,611,201,68.14,0.6814,0.614,0.594
"5534","195003",1999,2107,602,1505,366,187,179,29.73,0.2973,0.174,0.124
"5535","195030",1999,1211,525,686,828,429,399,76,0.76,0.684,0.625
"5536","195164",1999,520,294,226,273,100,173,58.84,0.5884,0.525,0.442
"5537","195173",1999,474,284,190,130,54,76,26.76,0.2676,0.274,0.284
"5538","195216",1999,575,301,274,410,182,228,75.75,0.7575,0.713,0.664
"5539","195234",1999,401,297,104,202,39,163,54.88,0.5488,0.504,0.375
"5540","195243",1999,304,168,136,103,33,70,41.67,0.4167,0.339,0.243
"5541","195304",1999,278,215,63,180,44,136,63.26,0.6326,0.647,0.698
"5542","195474",1999,677,381,296,491,197,294,77.17,0.7717,0.725,0.666
"5543","195526",1999,642,367,275,470,189,281,76.57,0.7657,0.732,0.687
"5544","195544",1999,77,55,22,51,8,43,78.18,0.7818,0.662,0.364
"5545","195809",1999,2650,1500,1150,954,357,597,39.8,0.398,0.36,0.31
"5546","196413",1999,2724,1534,1190,1841,748,1093,71.25,0.7125,0.676,0.629
"5547","196592",1999,1756,1210,546,152,50,102,8.43,0.0843,0.087,0.092
"5548","197045",1999,365,221,144,158,49,109,49.32,0.4932,0.433,0.34
"5549","197133",1999,633,381,252,543,209,334,87.66,0.8766,0.858,0.829
"5550","197869",1999,2199,1186,1013,778,266,512,43.17,0.4317,0.354,0.263
"5551","197984",1999,195,90,105,57,27,30,33.33,0.3333,0.292,0.257
"5552","198385",1999,456,226,230,380,187,193,85.4,0.854,0.833,0.813
"5553","198464",1999,3255,1931,1324,822,266,556,28.79,0.2879,0.253,0.201
"5554","198507",1999,402,247,155,109,22,87,35.22,0.3522,0.271,0.142
"5555","198516",1999,999,637,362,701,232,469,73.63,0.7363,0.702,0.641
"5556","198835",1999,288,168,120,117,37,80,47.62,0.4762,0.406,0.308
"5557","198969",1999,378,123,255,53,23,30,24.39,0.2439,0.14,0.09
"5558","199102",1999,1530,850,680,348,112,236,27.76,0.2776,0.227,0.165
"5559","199111",1999,456,267,189,128,48,80,29.96,0.2996,0.281,0.254
"5560","199120",1999,3388,2099,1289,2389,797,1592,75.85,0.7585,0.705,0.618
"5561","199139",1999,2078,1111,967,489,181,308,27.72,0.2772,0.235,0.187
"5562","199148",1999,1908,1346,562,540,107,433,32.17,0.3217,0.283,0.19
"5563","199157",1999,625,345,280,143,31,112,32.46,0.3246,0.229,0.111
"5564","199193",1999,3636,1499,2137,1253,559,694,46.3,0.463,0.345,0.262
"5565","199218",1999,1649,1011,638,672,213,459,45.4,0.454,0.408,0.334
"5566","199281",1999,475,241,234,89,33,56,23.24,0.2324,0.187,0.141
"5567","199306",1999,159,80,79,52,15,37,46.25,0.4625,0.327,0.19
"5568","199412",1999,123,85,38,67,15,52,61.18,0.6118,0.545,0.395
"5569","199582",1999,331,173,158,57,16,41,23.7,0.237,0.172,0.101
"5570","199643",1999,440,258,182,61,21,40,15.5,0.155,0.139,0.115
"5571","199847",1999,969,498,471,760,327,433,86.95,0.8695,0.784,0.694
"5572","199962",1999,301,144,157,102,32,70,48.61,0.4861,0.339,0.204
"5573","199999",1999,476,316,160,103,19,84,26.58,0.2658,0.216,0.119
"5574","200004",1999,1151,569,582,261,103,158,27.77,0.2777,0.227,0.177
"5575","200059",1999,359,179,180,39,15,24,13.41,0.1341,0.109,0.083
"5576","200156",1999,284,165,119,84,31,53,32.12,0.3212,0.296,0.261
"5577","200217",1999,373,242,131,155,42,113,46.69,0.4669,0.416,0.321
"5578","200226",1999,140,71,69,41,15,26,36.62,0.3662,0.293,0.217
"5579","200253",1999,433,251,182,40,11,29,11.55,0.1155,0.092,0.06
"5580","200280",1999,1742,846,896,394,179,215,25.41,0.2541,0.226,0.2
"5581","200332",1999,1268,514,754,240,111,129,25.1,0.251,0.189,0.147
"5582","200572",1999,158,76,82,35,8,27,35.53,0.3553,0.222,0.098
"5583","201104",1999,541,313,228,246,80,166,53.04,0.5304,0.455,0.351
"5584","201371",1999,248,156,92,114,32,82,52.56,0.5256,0.46,0.348
"5585","201548",1999,532,301,231,255,101,154,51.16,0.5116,0.479,0.437
"5586","201645",1999,762,292,470,432,245,187,64.04,0.6404,0.567,0.521
"5587","201690",1999,294,164,130,46,12,34,20.73,0.2073,0.156,0.092
"5588","202134",1999,1048,494,554,114,50,64,12.96,0.1296,0.109,0.09
"5589","202480",1999,1744,921,823,1041,412,629,68.3,0.683,0.597,0.501
"5590","202523",1999,587,335,252,444,171,273,81.49,0.8149,0.756,0.679
"5591","202763",1999,522,337,185,212,52,160,47.48,0.4748,0.406,0.281
"5592","203085",1999,259,98,161,124,61,63,64.29,0.6429,0.479,0.379
"5593","203128",1999,279,143,136,153,64,89,62.24,0.6224,0.548,0.471
"5594","203368",1999,833,451,382,539,204,335,74.28,0.7428,0.647,0.534
"5595","203517",1999,3476,2160,1316,668,187,481,22.27,0.2227,0.192,0.142
"5596","203535",1999,459,255,204,367,166,201,78.82,0.7882,0.8,0.814
"5597","203580",1999,103,70,33,36,8,28,40,0.4,0.35,0.242
"5598","203775",1999,406,248,158,160,47,113,45.56,0.4556,0.394,0.297
"5599","203845",1999,302,136,166,149,70,79,58.09,0.5809,0.493,0.422
"5600","204024",1999,3588,2030,1558,2351,922,1429,70.39,0.7039,0.655,0.592
"5601","204185",1999,601,323,278,292,86,206,63.78,0.6378,0.486,0.309
"5602","204194",1999,393,231,162,145,49,96,41.56,0.4156,0.369,0.302
"5603","204617",1999,186,120,66,68,16,52,43.33,0.4333,0.366,0.242
"5604","204796",1999,6067,3029,3038,2120,777,1343,44.34,0.4434,0.349,0.256
"5605","204857",1999,3389,1977,1412,1553,490,1063,53.77,0.5377,0.458,0.347
"5606","206330",1999,121,40,81,45,20,25,62.5,0.625,0.372,0.247
"5607","206589",1999,513,265,248,372,164,208,78.49,0.7849,0.725,0.661
"5608","206604",1999,2127,1202,925,352,99,253,21.05,0.2105,0.165,0.107
"5609","206622",1999,771,464,307,540,213,327,70.47,0.7047,0.7,0.694
"5610","206695",1999,1911,954,957,241,89,152,15.93,0.1593,0.126,0.093
"5611","206914",1999,673,355,318,54,16,38,10.7,0.107,0.08,0.05
"5612","207209",1999,446,232,214,17,4,13,5.6,0.056,0.038,0.019
"5613","207306",1999,310,138,172,36,16,20,14.49,0.1449,0.116,0.093
"5614","207324",1999,391,219,172,123,44,79,36.07,0.3607,0.315,0.256
"5615","207388",1999,2795,1491,1304,705,206,499,33.47,0.3347,0.252,0.158
"5616","207500",1999,3206,1603,1603,619,237,382,23.83,0.2383,0.193,0.148
"5617","207722",1999,229,133,96,32,12,20,15.04,0.1504,0.14,0.125
"5618","207847",1999,572,307,265,67,26,41,13.36,0.1336,0.117,0.098
"5619","207865",1999,779,448,331,116,35,81,18.08,0.1808,0.149,0.106
"5620","208822",1999,282,163,119,145,48,97,59.51,0.5951,0.514,0.403
"5621","209056",1999,510,307,203,330,127,203,66.12,0.6612,0.647,0.626
"5622","209065",1999,397,227,170,227,74,153,67.4,0.674,0.572,0.435
"5623","209542",1999,2772,1319,1453,847,333,514,38.97,0.3897,0.306,0.229
"5624","209551",1999,2453,1393,1060,931,314,617,44.29,0.4429,0.38,0.296
"5625","209612",1999,292,175,117,164,70,94,53.71,0.5371,0.562,0.598
"5626","209807",1999,896,496,400,118,39,79,15.93,0.1593,0.132,0.098
"5627","209922",1999,331,182,149,172,78,94,51.65,0.5165,0.52,0.523
"5628","210146",1999,754,431,323,136,46,90,20.88,0.2088,0.18,0.142
"5629","210401",1999,363,190,173,242,100,142,74.74,0.7474,0.667,0.578
"5630","210429",1999,770,460,310,141,45,96,20.87,0.2087,0.183,0.145
"5631","210571",1999,392,242,150,203,61,142,58.68,0.5868,0.518,0.407
"5632","210669",1999,562,284,278,374,167,207,72.89,0.7289,0.665,0.601
"5633","210775",1999,204,101,103,79,34,45,44.55,0.4455,0.387,0.33
"5634","211088",1999,307,238,69,154,28,126,52.94,0.5294,0.502,0.406
"5635","211158",1999,1402,891,511,527,164,363,40.74,0.4074,0.376,0.321
"5636","211291",1999,886,425,461,764,396,368,86.59,0.8659,0.862,0.859
"5637","211352",1999,248,163,85,124,30,94,57.67,0.5767,0.5,0.353
"5638","211361",1999,924,484,440,162,48,114,23.55,0.2355,0.175,0.109
"5639","211431",1999,130,128,2,47,0,47,36.72,0.3672,0.362,0
"5640","211440",1999,1255,487,768,833,491,342,70.23,0.7023,0.664,0.639
"5641","211468",1999,218,218,0,115,0,115,52.75,0.5275,0.528,NA
"5642","211556",1999,126,126,0,62,0,62,49.21,0.4921,0.492,NA
"5643","211583",1999,102,101,1,45,1,44,43.56,0.4356,0.441,1
"5644","211608",1999,254,152,102,37,9,28,18.42,0.1842,0.146,0.088
"5645","211644",1999,1286,806,480,295,80,215,26.67,0.2667,0.229,0.167
"5646","211981",1999,327,172,155,109,41,68,39.53,0.3953,0.333,0.265
"5647","212009",1999,620,399,221,505,178,327,81.95,0.8195,0.815,0.805
"5648","212054",1999,1898,725,1173,269,94,175,24.14,0.2414,0.142,0.08
"5649","212106",1999,1211,686,525,590,216,374,54.52,0.5452,0.487,0.411
"5650","212115",1999,843,522,321,163,42,121,23.18,0.2318,0.193,0.131
"5651","212133",1999,379,274,105,190,41,149,54.38,0.5438,0.501,0.39
"5652","212160",1999,1256,749,507,227,48,179,23.9,0.239,0.181,0.095
"5653","212197",1999,477,298,179,277,102,175,58.72,0.5872,0.581,0.57
"5654","212577",1999,515,253,262,387,181,206,81.42,0.8142,0.751,0.691
"5655","212601",1999,503,314,189,246,67,179,57.01,0.5701,0.489,0.354
"5656","212832",1999,146,114,32,56,13,43,37.72,0.3772,0.384,0.406
"5657","212911",1999,301,160,141,244,113,131,81.88,0.8188,0.811,0.801
"5658","213020",1999,2552,1468,1084,561,165,396,26.98,0.2698,0.22,0.152
"5659","213251",1999,324,184,140,217,81,136,73.91,0.7391,0.67,0.579
"5660","213321",1999,420,218,202,268,112,156,71.56,0.7156,0.638,0.554
"5661","213349",1999,1550,922,628,374,89,285,30.91,0.3091,0.241,0.142
"5662","213358",1999,306,170,136,133,58,75,44.12,0.4412,0.435,0.426
"5663","213367",1999,801,426,375,446,188,258,60.56,0.6056,0.557,0.501
"5664","213385",1999,583,316,267,505,218,287,90.82,0.9082,0.866,0.816
"5665","213507",1999,407,238,169,279,102,177,74.37,0.7437,0.686,0.604
"5666","213543",1999,1077,455,622,799,437,362,79.56,0.7956,0.742,0.703
"5667","213613",1999,887,502,385,212,65,147,29.28,0.2928,0.239,0.169
"5668","213668",1999,392,209,183,242,99,143,68.42,0.6842,0.617,0.541
"5669","213783",1999,611,364,247,178,53,125,34.34,0.3434,0.291,0.215
"5670","213826",1999,282,207,75,118,25,93,44.93,0.4493,0.418,0.333
"5671","213996",1999,678,413,265,468,168,300,72.64,0.7264,0.69,0.634
"5672","214041",1999,1239,746,493,424,134,290,38.87,0.3887,0.342,0.272
"5673","214069",1999,249,173,76,165,42,123,71.1,0.711,0.663,0.553
"5674","214157",1999,318,162,156,213,102,111,68.52,0.6852,0.67,0.654
"5675","214175",1999,551,321,230,446,179,267,83.18,0.8318,0.809,0.778
"5676","214272",1999,324,179,145,108,38,70,39.11,0.3911,0.333,0.262
"5677","214777",1999,5058,2535,2523,2738,1142,1596,62.96,0.6296,0.541,0.453
"5678","215062",1999,2402,1155,1247,2079,1056,1023,88.57,0.8857,0.866,0.847
"5679","215743",1999,333,215,118,147,34,113,52.56,0.5256,0.441,0.288
"5680","215798",1999,272,138,134,162,74,88,63.77,0.6377,0.596,0.552
"5681","215929",1999,958,550,408,675,268,407,74,0.74,0.705,0.657
"5682","216010",1999,1377,734,643,574,231,343,46.73,0.4673,0.417,0.359
"5683","216038",1999,1302,742,560,334,103,231,31.13,0.3113,0.257,0.184
"5684","216287",1999,368,192,176,315,142,173,90.1,0.901,0.856,0.807
"5685","216339",1999,2747,1628,1119,721,228,493,30.28,0.3028,0.262,0.204
"5686","216524",1999,337,173,164,241,106,135,78.03,0.7803,0.715,0.646
"5687","216694",1999,277,126,151,121,64,57,45.24,0.4524,0.437,0.424
"5688","216764",1999,1710,1069,641,444,122,322,30.12,0.3012,0.26,0.19
"5689","216807",1999,351,224,127,228,69,159,70.98,0.7098,0.65,0.543
"5690","216852",1999,548,250,298,213,100,113,45.2,0.452,0.389,0.336
"5691","216931",1999,377,161,216,166,88,78,48.45,0.4845,0.44,0.407
"5692","217059",1999,909,511,398,372,122,250,48.92,0.4892,0.409,0.307
"5693","217156",1999,1376,729,647,1146,539,607,83.26,0.8326,0.833,0.833
"5694","217402",1999,973,556,417,838,351,487,87.59,0.8759,0.861,0.842
"5695","217536",1999,528,352,176,277,69,208,59.09,0.5909,0.525,0.392
"5696","217776",1999,99,47,52,35,12,23,48.94,0.4894,0.354,0.231
"5697","217819",1999,2067,1399,668,850,206,644,46.03,0.4603,0.411,0.308
"5698","217882",1999,2886,1354,1532,1267,490,777,57.39,0.5739,0.439,0.32
"5699","217998",1999,156,91,65,100,33,67,73.63,0.7363,0.641,0.508
"5700","218061",1999,570,332,238,104,27,77,23.19,0.2319,0.182,0.113
"5701","218229",1999,494,313,181,107,22,85,27.16,0.2716,0.217,0.122
"5702","218238",1999,136,58,78,27,13,14,24.14,0.2414,0.199,0.167
"5703","218399",1999,263,173,90,53,10,43,24.86,0.2486,0.202,0.111
"5704","218414",1999,179,70,109,59,18,41,58.57,0.5857,0.33,0.165
"5705","218663",1999,2596,1511,1085,1073,367,706,46.72,0.4672,0.413,0.338
"5706","218724",1999,757,405,352,161,60,101,24.94,0.2494,0.213,0.17
"5707","218733",1999,680,351,329,143,37,106,30.2,0.302,0.21,0.112
"5708","218742",1999,540,334,206,87,24,63,18.86,0.1886,0.161,0.117
"5709","218973",1999,307,154,153,226,112,114,74.03,0.7403,0.736,0.732
"5710","219000",1999,469,314,155,231,65,166,52.87,0.5287,0.493,0.419
"5711","219046",1999,630,360,270,71,17,54,15,0.15,0.113,0.063
"5712","219082",1999,306,124,182,45,21,24,19.35,0.1935,0.147,0.115
"5713","219198",1999,121,84,37,34,8,26,30.95,0.3095,0.281,0.216
"5714","219259",1999,523,303,220,69,15,54,17.82,0.1782,0.132,0.068
"5715","219356",1999,1457,714,743,342,127,215,30.11,0.3011,0.235,0.171
"5716","219471",1999,868,493,375,176,53,123,24.95,0.2495,0.203,0.141
"5717","219602",1999,715,432,283,66,22,44,10.19,0.1019,0.092,0.078
"5718","219709",1999,487,300,187,266,91,175,58.33,0.5833,0.546,0.487
"5719","219718",1999,142,42,100,17,10,7,16.67,0.1667,0.12,0.1
"5720","219949",1999,174,67,107,36,19,17,25.37,0.2537,0.207,0.178
"5721","220075",1999,1466,821,645,217,62,155,18.88,0.1888,0.148,0.096
"5722","220215",1999,322,187,135,125,59,66,35.29,0.3529,0.388,0.437
"5723","220613",1999,690,400,290,213,80,133,33.25,0.3325,0.309,0.276
"5724","220631",1999,113,80,33,35,9,26,32.5,0.325,0.31,0.273
"5725","220710",1999,313,174,139,141,50,91,52.3,0.523,0.45,0.36
"5726","221351",1999,438,251,187,338,143,195,77.69,0.7769,0.772,0.765
"5727","221519",1999,391,227,164,308,123,185,81.5,0.815,0.788,0.75
"5728","221731",1999,140,93,47,22,3,19,20.43,0.2043,0.157,0.064
"5729","221847",1999,1175,524,651,67,63,4,0.76,0.0076,0.057,0.097
"5730","221892",1999,192,119,73,43,14,29,24.37,0.2437,0.224,0.192
"5731","222178",1999,924,533,391,335,120,215,40.34,0.4034,0.363,0.307
"5732","222983",1999,324,188,136,222,74,148,78.72,0.7872,0.685,0.544
"5733","223232",1999,2766,1668,1098,1272,379,893,53.54,0.5354,0.46,0.345
"5734","224004",1999,134,66,68,15,10,5,7.58,0.0758,0.112,0.147
"5735","224323",1999,309,191,118,188,67,121,63.35,0.6335,0.608,0.568
"5736","225432",1999,729,418,311,10,3,7,1.67,0.0167,0.014,0.01
"5737","225548",1999,286,137,149,10,3,7,5.11,0.0511,0.035,0.02
"5738","225627",1999,380,253,127,51,9,42,16.6,0.166,0.134,0.071
"5739","226231",1999,259,58,201,75,52,23,39.66,0.3966,0.29,0.259
"5740","226833",1999,732,409,323,67,21,46,11.25,0.1125,0.092,0.065
"5741","227216",1999,2687,1550,1137,410,111,299,19.29,0.1929,0.153,0.098
"5742","227331",1999,308,241,67,44,10,34,14.11,0.1411,0.143,0.149
"5743","227526",1999,967,504,463,113,33,80,15.87,0.1587,0.117,0.071
"5744","227757",1999,670,325,345,512,251,261,80.31,0.8031,0.764,0.728
"5745","227845",1999,357,184,173,101,35,66,35.87,0.3587,0.283,0.202
"5746","227863",1999,215,128,87,50,16,34,26.56,0.2656,0.233,0.184
"5747","228042",1999,225,148,77,44,7,37,25,0.25,0.196,0.091
"5748","228149",1999,485,277,208,165,54,111,40.07,0.4007,0.34,0.26
"5749","228246",1999,1331,688,643,656,262,394,57.27,0.5727,0.493,0.407
"5750","228343",1999,354,210,144,236,83,153,72.86,0.7286,0.667,0.576
"5751","228431",1999,2255,1353,902,339,92,247,18.26,0.1826,0.15,0.102
"5752","228459",1999,2447,1479,968,504,130,374,25.29,0.2529,0.206,0.134
"5753","228501",1999,227,95,132,25,11,14,14.74,0.1474,0.11,0.083
"5754","228529",1999,585,303,282,109,45,64,21.12,0.2112,0.186,0.16
"5755","228705",1999,736,293,443,53,24,29,9.9,0.099,0.072,0.054
"5756","228723",1999,6659,3419,3240,2359,722,1637,47.88,0.4788,0.354,0.223
"5757","228769",1999,1402,714,688,214,95,119,16.67,0.1667,0.153,0.138
"5758","228778",1999,6925,3508,3417,2888,1186,1702,48.52,0.4852,0.417,0.347
"5759","228787",1999,603,242,361,180,88,92,38.02,0.3802,0.299,0.244
"5760","228796",1999,1662,874,788,79,22,57,6.52,0.0652,0.048,0.028
"5761","228875",1999,1427,869,558,678,208,470,54.09,0.5409,0.475,0.373
"5762","228981",1999,383,170,213,112,45,67,39.41,0.3941,0.292,0.211
"5763","229018",1999,97,65,32,15,5,10,15.38,0.1538,0.155,0.156
"5764","229027",1999,1665,882,783,105,32,73,8.28,0.0828,0.063,0.041
"5765","229115",1999,3403,1725,1678,785,248,537,31.13,0.3113,0.231,0.148
"5766","229780",1999,210,108,102,39,15,24,22.22,0.2222,0.186,0.147
"5767","229814",1999,986,506,480,126,34,92,18.18,0.1818,0.128,0.071
"5768","230603",1999,629,456,173,103,9,94,20.61,0.2061,0.164,0.052
"5769","230728",1999,1521,1047,474,320,67,253,24.16,0.2416,0.21,0.141
"5770","230764",1999,1921,921,1000,295,109,186,20.2,0.202,0.154,0.109
"5771","230782",1999,1619,1001,618,158,47,111,11.09,0.1109,0.098,0.076
"5772","231059",1999,501,269,232,342,145,197,73.23,0.7323,0.683,0.625
"5773","231174",1999,1808,984,824,875,351,524,53.25,0.5325,0.484,0.426
"5774","231420",1999,204,123,81,72,22,50,40.65,0.4065,0.353,0.272
"5775","231554",1999,144,79,65,43,18,25,31.65,0.3165,0.299,0.277
"5776","231624",1999,1298,736,562,1052,418,634,86.14,0.8614,0.81,0.744
"5777","231712",1999,808,485,323,148,44,104,21.44,0.2144,0.183,0.136
"5778","232025",1999,271,129,142,117,50,67,51.94,0.5194,0.432,0.352
"5779","232043",1999,218,131,87,111,36,75,57.25,0.5725,0.509,0.414
"5780","232089",1999,309,104,205,56,26,30,28.85,0.2885,0.181,0.127
"5781","232186",1999,2030,1129,901,534,161,373,33.04,0.3304,0.263,0.179
"5782","232265",1999,1190,728,462,422,102,320,43.96,0.4396,0.355,0.221
"5783","232423",1999,3040,1855,1185,1887,610,1277,68.84,0.6884,0.621,0.515
"5784","232557",1999,1074,557,517,268,103,165,29.62,0.2962,0.25,0.199
"5785","232566",1999,815,534,281,391,101,290,54.31,0.5431,0.48,0.359
"5786","232609",1999,473,277,196,222,73,149,53.79,0.5379,0.469,0.372
"5787","232681",1999,834,619,215,583,142,441,71.24,0.7124,0.699,0.66
"5788","232706",1999,302,220,82,116,26,90,40.91,0.4091,0.384,0.317
"5789","232937",1999,1111,687,424,118,27,91,13.25,0.1325,0.106,0.064
"5790","232982",1999,1500,833,667,327,103,224,26.89,0.2689,0.218,0.154
"5791","233277",1999,1655,1075,580,610,164,446,41.49,0.4149,0.369,0.283
"5792","233374",1999,854,465,389,647,273,374,80.43,0.8043,0.758,0.702
"5793","233426",1999,450,274,176,257,88,169,61.68,0.6168,0.571,0.5
"5794","233541",1999,292,163,129,87,36,51,31.29,0.3129,0.298,0.279
"5795","233897",1999,299,151,148,76,36,40,26.49,0.2649,0.254,0.243
"5796","233921",1999,4653,1957,2696,2177,996,1181,60.35,0.6035,0.468,0.369
"5797","234030",1999,2408,1427,981,499,164,335,23.48,0.2348,0.207,0.167
"5798","234085",1999,369,24,345,194,180,14,58.33,0.5833,0.526,0.522
"5799","234155",1999,937,543,394,185,48,137,25.23,0.2523,0.197,0.122
"5800","234164",1999,268,167,101,50,8,42,25.15,0.2515,0.187,0.079
"5801","235097",1999,1072,652,420,164,45,119,18.25,0.1825,0.153,0.107
"5802","235167",1999,456,256,200,190,69,121,47.27,0.4727,0.417,0.345
"5803","236230",1999,562,370,192,241,77,164,44.32,0.4432,0.429,0.401
"5804","236328",1999,682,413,269,443,170,273,66.1,0.661,0.65,0.632
"5805","236577",1999,567,392,175,272,79,193,49.23,0.4923,0.48,0.451
"5806","236595",1999,578,351,227,256,92,164,46.72,0.4672,0.443,0.405
"5807","236896",1999,323,158,165,64,28,36,22.78,0.2278,0.198,0.17
"5808","236939",1999,2456,1276,1180,791,306,485,38.01,0.3801,0.322,0.259
"5809","236948",1999,4319,2279,2040,1977,790,1187,52.08,0.5208,0.458,0.387
"5810","237011",1999,2074,1264,810,623,172,451,35.68,0.3568,0.3,0.212
"5811","237057",1999,361,209,152,294,120,174,83.25,0.8325,0.814,0.789
"5812","237066",1999,406,266,140,233,74,159,59.77,0.5977,0.574,0.529
"5813","237215",1999,370,225,145,8,3,5,2.22,0.0222,0.022,0.021
"5814","237330",1999,612,317,295,92,37,55,17.35,0.1735,0.15,0.125
"5815","237358",1999,129,72,57,34,15,19,26.39,0.2639,0.264,0.263
"5816","237367",1999,534,286,248,77,28,49,17.13,0.1713,0.144,0.113
"5817","237792",1999,674,367,307,91,25,66,17.98,0.1798,0.135,0.081
"5818","237899",1999,555,260,295,31,13,18,6.92,0.0692,0.056,0.044
"5819","237932",1999,494,245,249,96,31,65,26.53,0.2653,0.194,0.124
"5820","237969",1999,472,261,211,211,89,122,46.74,0.4674,0.447,0.422
"5821","238032",1999,3523,1641,1882,885,363,522,31.81,0.3181,0.251,0.193
"5822","238333",1999,303,173,130,196,75,121,69.94,0.6994,0.647,0.577
"5823","238430",1999,203,132,71,28,10,18,13.64,0.1364,0.138,0.141
"5824","238458",1999,482,327,155,219,63,156,47.71,0.4771,0.454,0.406
"5825","238476",1999,427,216,211,190,78,112,51.85,0.5185,0.445,0.37
"5826","238616",1999,321,197,124,104,38,66,33.5,0.335,0.324,0.306
"5827","238661",1999,196,132,64,49,9,40,30.3,0.303,0.25,0.141
"5828","239080",1999,224,156,68,71,17,54,34.62,0.3462,0.317,0.25
"5829","239105",1999,1715,963,752,1064,414,650,67.5,0.675,0.62,0.551
"5830","239628",1999,283,156,127,174,73,101,64.74,0.6474,0.615,0.575
"5831","239716",1999,519,296,223,332,136,196,66.22,0.6622,0.64,0.61
"5832","240107",1999,311,235,76,111,22,89,37.87,0.3787,0.357,0.289
"5833","240189",1999,1877,1017,860,357,119,238,23.4,0.234,0.19,0.138
"5834","240277",1999,879,578,301,164,45,119,20.59,0.2059,0.187,0.15
"5835","240329",1999,1631,1035,596,395,128,267,25.8,0.258,0.242,0.215
"5836","240338",1999,161,92,69,79,23,56,60.87,0.6087,0.491,0.333
"5837","240365",1999,1834,1084,750,284,85,199,18.36,0.1836,0.155,0.113
"5838","240374",1999,811,419,392,78,30,48,11.46,0.1146,0.096,0.077
"5839","240417",1999,1317,661,656,185,57,128,19.36,0.1936,0.14,0.087
"5840","240426",1999,406,241,165,38,6,32,13.28,0.1328,0.094,0.036
"5841","240444",1999,5520,2985,2535,2263,847,1416,47.44,0.4744,0.41,0.334
"5842","240453",1999,2694,1523,1171,356,127,229,15.04,0.1504,0.132,0.108
"5843","240462",1999,1093,377,716,148,61,87,23.08,0.2308,0.135,0.085
"5844","240471",1999,1104,684,420,277,95,182,26.61,0.2661,0.251,0.226
"5845","240480",1999,1490,849,641,285,99,186,21.91,0.2191,0.191,0.154
"5846","240727",1999,1194,654,540,352,124,228,34.86,0.3486,0.295,0.23
"5847","243443",1999,799,506,293,63,13,50,9.88,0.0988,0.079,0.044
"5848","243780",1999,6895,2945,3950,2083,974,1109,37.66,0.3766,0.302,0.247
"5849","100654",2000,1020,504,516,118,24,94,18.65,0.1865,0.116,0.047
"5850","100663",2000,1234,748,486,173,51,122,16.31,0.1631,0.14,0.105
"5851","100751",2000,2886,1653,1233,1038,303,735,44.46,0.4446,0.36,0.246
"5852","100858",2000,3861,1990,1871,1277,451,826,41.51,0.4151,0.331,0.241
"5853","101435",2000,151,95,56,67,21,46,48.42,0.4842,0.444,0.375
"5854","101480",2000,850,443,407,127,39,88,19.86,0.1986,0.149,0.096
"5855","101675",2000,425,220,205,85,19,66,30,0.3,0.2,0.093
"5856","101879",2000,824,481,343,143,35,108,22.45,0.2245,0.174,0.102
"5857","102049",2000,657,427,230,359,122,237,55.5,0.555,0.546,0.53
"5858","102094",2000,1064,679,385,167,46,121,17.82,0.1782,0.157,0.119
"5859","102234",2000,284,186,98,158,47,111,59.68,0.5968,0.556,0.48
"5860","102368",2000,941,513,428,271,105,166,32.36,0.3236,0.288,0.245
"5861","102377",2000,591,354,237,149,37,112,31.64,0.3164,0.252,0.156
"5862","104151",2000,5763,3058,2705,1615,596,1019,33.32,0.3332,0.28,0.22
"5863","104179",2000,5443,2924,2519,1613,618,995,34.03,0.3403,0.296,0.245
"5864","105330",2000,2273,1384,889,613,174,439,31.72,0.3172,0.27,0.196
"5865","106245",2000,836,484,352,73,28,45,9.3,0.093,0.087,0.08
"5866","106342",2000,127,71,56,74,30,44,61.97,0.6197,0.583,0.536
"5867","106397",2000,2179,1092,1087,645,246,399,36.54,0.3654,0.296,0.226
"5868","106412",2000,629,330,299,43,13,30,9.09,0.0909,0.068,0.043
"5869","106458",2000,1591,893,698,307,97,210,23.52,0.2352,0.193,0.139
"5870","106467",2000,1124,593,531,205,70,135,22.77,0.2277,0.182,0.132
"5871","106485",2000,628,346,282,51,17,34,9.83,0.0983,0.081,0.06
"5872","106704",2000,1627,982,645,325,80,245,24.95,0.2495,0.2,0.124
"5873","107044",2000,975,557,418,365,137,228,40.93,0.4093,0.374,0.328
"5874","107080",2000,326,173,153,194,85,109,63.01,0.6301,0.595,0.556
"5875","107141",2000,276,164,112,140,51,89,54.27,0.5427,0.507,0.455
"5876","107512",2000,440,247,193,187,69,118,47.77,0.4777,0.425,0.358
"5877","107558",2000,166,100,66,52,17,35,35,0.35,0.313,0.258
"5878","110097",2000,608,409,199,326,88,238,58.19,0.5819,0.536,0.442
"5879","110404",2000,205,74,131,166,107,59,79.73,0.7973,0.81,0.817
"5880","110422",2000,3053,1332,1721,607,212,395,29.65,0.2965,0.199,0.123
"5881","110486",2000,545,349,196,77,22,55,15.76,0.1576,0.141,0.112
"5882","110495",2000,565,362,203,113,27,86,23.76,0.2376,0.2,0.133
"5883","110510",2000,1146,750,396,142,33,109,14.53,0.1453,0.124,0.083
"5884","110529",2000,2600,1121,1479,265,113,152,13.56,0.1356,0.102,0.076
"5885","110538",2000,1931,1079,852,336,79,257,23.82,0.2382,0.174,0.093
"5886","110547",2000,495,355,140,31,7,24,6.76,0.0676,0.063,0.05
"5887","110556",2000,1885,1138,747,227,67,160,14.06,0.1406,0.12,0.09
"5888","110565",2000,2655,1609,1046,381,83,298,18.52,0.1852,0.144,0.079
"5889","110574",2000,669,452,217,109,26,83,18.36,0.1836,0.163,0.12
"5890","110583",2000,3214,2038,1176,375,87,288,14.13,0.1413,0.117,0.074
"5891","110592",2000,1184,755,429,126,24,102,13.51,0.1351,0.106,0.056
"5892","110617",2000,2055,1198,857,178,36,142,11.85,0.1185,0.087,0.042
"5893","113698",2000,113,86,27,48,13,35,40.7,0.407,0.425,0.481
"5894","115755",2000,769,460,309,94,32,62,13.48,0.1348,0.122,0.104
"5895","119173",2000,297,296,1,67,1,66,22.3,0.223,0.226,1
"5896","120184",2000,137,99,38,54,15,39,39.39,0.3939,0.394,0.395
"5897","121309",2000,539,312,227,274,101,173,55.45,0.5545,0.508,0.445
"5898","121345",2000,398,208,190,346,163,183,87.98,0.8798,0.869,0.858
"5899","122409",2000,2719,1598,1121,472,130,342,21.4,0.214,0.174,0.116
"5900","122436",2000,1024,642,382,656,225,431,67.13,0.6713,0.641,0.589
"5901","122597",2000,1870,1212,658,205,54,151,12.46,0.1246,0.11,0.082
"5902","122612",2000,757,518,239,363,100,263,50.77,0.5077,0.48,0.418
"5903","122931",2000,1025,544,481,814,366,448,82.35,0.8235,0.794,0.761
"5904","123554",2000,620,366,254,368,149,219,59.84,0.5984,0.594,0.587
"5905","123572",2000,1064,714,350,236,46,190,26.61,0.2661,0.222,0.131
"5906","126562",2000,515,296,219,71,23,48,16.22,0.1622,0.138,0.105
"5907","126580",2000,718,457,261,162,38,124,27.13,0.2713,0.226,0.146
"5908","126614",2000,5047,2445,2602,1937,829,1108,45.32,0.4532,0.384,0.319
"5909","126818",2000,3240,1862,1378,1119,370,749,40.23,0.4023,0.345,0.269
"5910","127060",2000,926,505,421,526,214,312,61.78,0.6178,0.568,0.508
"5911","127185",2000,938,428,510,120,45,75,17.52,0.1752,0.128,0.088
"5912","127565",2000,1435,778,657,79,27,52,6.68,0.0668,0.055,0.041
"5913","127741",2000,2113,1240,873,605,162,443,35.73,0.3573,0.286,0.186
"5914","128106",2000,641,331,310,101,41,60,18.13,0.1813,0.158,0.132
"5915","128744",2000,161,80,81,53,21,32,40,0.4,0.329,0.259
"5916","128771",2000,1304,635,669,141,42,99,15.59,0.1559,0.108,0.063
"5917","129020",2000,2802,1549,1253,1484,554,930,60.04,0.6004,0.53,0.442
"5918","129242",2000,1008,610,398,797,291,506,82.95,0.8295,0.791,0.731
"5919","129941",2000,457,195,262,101,48,53,27.18,0.2718,0.221,0.183
"5920","130253",2000,834,498,336,477,168,309,62.05,0.6205,0.572,0.5
"5921","130314",2000,187,187,0,86,0,86,45.99,0.4599,0.46,NA
"5922","130493",2000,1350,775,575,142,38,104,13.42,0.1342,0.105,0.066
"5923","130590",2000,489,253,236,389,181,208,82.21,0.8221,0.796,0.767
"5924","130697",2000,720,371,349,607,281,326,87.87,0.8787,0.843,0.805
"5925","130776",2000,822,404,418,104,42,62,15.35,0.1535,0.127,0.1
"5926","130794",2000,1349,678,671,1189,582,607,89.53,0.8953,0.881,0.867
"5927","130934",2000,684,405,279,155,36,119,29.38,0.2938,0.227,0.129
"5928","130943",2000,3128,1926,1202,1884,620,1264,65.63,0.6563,0.602,0.516
"5929","131159",2000,1272,821,451,818,260,558,67.97,0.6797,0.643,0.576
"5930","131283",2000,530,298,232,315,126,189,63.42,0.6342,0.594,0.543
"5931","131450",2000,241,123,118,16,3,13,10.57,0.1057,0.066,0.025
"5932","131469",2000,2093,1241,852,1504,574,930,74.94,0.7494,0.719,0.674
"5933","131496",2000,1469,789,680,1327,603,724,91.76,0.9176,0.903,0.887
"5934","131520",2000,1355,909,446,624,145,479,52.7,0.527,0.461,0.325
"5935","132471",2000,401,258,143,70,18,52,20.16,0.2016,0.175,0.126
"5936","132602",2000,833,478,355,105,26,79,16.53,0.1653,0.126,0.073
"5937","132903",2000,4558,2436,2122,1384,436,948,38.92,0.3892,0.304,0.205
"5938","133492",2000,408,223,185,215,95,120,53.81,0.5381,0.527,0.514
"5939","133553",2000,797,124,673,280,225,55,44.35,0.4435,0.351,0.334
"5940","133650",2000,2145,1263,882,415,99,316,25.02,0.2502,0.193,0.112
"5941","133669",2000,1818,988,830,254,89,165,16.7,0.167,0.14,0.107
"5942","133711",2000,496,315,181,206,72,134,42.54,0.4254,0.415,0.398
"5943","133881",2000,531,156,375,214,145,69,44.23,0.4423,0.403,0.387
"5944","133951",2000,2582,1511,1071,507,148,359,23.76,0.2376,0.196,0.138
"5945","134079",2000,506,306,200,209,62,147,48.04,0.4804,0.413,0.31
"5946","134097",2000,5557,3294,2263,2481,811,1670,50.7,0.507,0.446,0.358
"5947","134130",2000,6864,3874,2990,3692,1285,2407,62.13,0.6213,0.538,0.43
"5948","134945",2000,406,163,243,155,80,75,46.01,0.4601,0.382,0.329
"5949","135726",2000,1964,1081,883,1140,469,671,62.07,0.6207,0.58,0.531
"5950","136172",2000,1664,963,701,335,100,235,24.4,0.244,0.201,0.143
"5951","136950",2000,425,256,169,252,87,165,64.45,0.6445,0.593,0.515
"5952","137546",2000,502,262,240,265,108,157,59.92,0.5992,0.528,0.45
"5953","138354",2000,629,355,274,117,30,87,24.51,0.2451,0.186,0.109
"5954","138716",2000,643,431,212,79,14,65,15.08,0.1508,0.123,0.066
"5955","138789",2000,568,327,241,27,9,18,5.5,0.055,0.048,0.037
"5956","139144",2000,486,321,165,258,84,174,54.21,0.5421,0.531,0.509
"5957","139366",2000,759,468,291,87,24,63,13.46,0.1346,0.115,0.082
"5958","139393",2000,206,117,89,107,47,60,51.28,0.5128,0.519,0.528
"5959","139658",2000,1532,831,701,936,420,516,62.09,0.6209,0.611,0.599
"5960","139719",2000,360,195,165,48,14,34,17.44,0.1744,0.133,0.085
"5961","139755",2000,2242,640,1602,760,470,290,45.31,0.4531,0.339,0.293
"5962","139764",2000,308,202,106,44,15,29,14.36,0.1436,0.143,0.142
"5963","139861",2000,820,506,314,189,41,148,29.25,0.2925,0.23,0.131
"5964","139931",2000,2859,1481,1378,379,105,274,18.5,0.185,0.133,0.076
"5965","139940",2000,2061,1233,828,303,85,218,17.68,0.1768,0.147,0.103
"5966","139959",2000,4207,2556,1651,1911,584,1327,51.92,0.5192,0.454,0.354
"5967","140447",2000,733,438,295,223,71,152,34.7,0.347,0.304,0.241
"5968","140960",2000,370,195,175,35,7,28,14.36,0.1436,0.095,0.04
"5969","140988",2000,299,205,94,105,23,82,40,0.4,0.351,0.245
"5970","141185",2000,192,105,87,51,13,38,36.19,0.3619,0.266,0.149
"5971","141264",2000,788,512,276,141,49,92,17.97,0.1797,0.179,0.178
"5972","141334",2000,1661,987,674,187,34,153,15.5,0.155,0.113,0.05
"5973","141486",2000,237,163,74,45,13,32,19.63,0.1963,0.19,0.176
"5974","141565",2000,362,223,139,39,13,26,11.66,0.1166,0.108,0.094
"5975","141574",2000,1499,846,653,168,48,120,14.18,0.1418,0.112,0.074
"5976","142276",2000,1345,781,564,51,9,42,5.38,0.0538,0.038,0.016
"5977","142285",2000,1560,722,838,311,127,184,25.48,0.2548,0.199,0.152
"5978","142461",2000,240,137,103,74,24,50,36.5,0.365,0.308,0.233
"5979","143084",2000,610,359,251,443,172,271,75.49,0.7549,0.726,0.685
"5980","143288",2000,191,107,84,56,18,38,35.51,0.3551,0.293,0.214
"5981","144005",2000,345,232,113,10,5,5,2.16,0.0216,0.029,0.044
"5982","144281",2000,1265,640,625,330,139,191,29.84,0.2984,0.261,0.222
"5983","144740",2000,1897,1140,757,852,308,544,47.72,0.4772,0.449,0.407
"5984","144892",2000,1495,870,625,471,151,320,36.78,0.3678,0.315,0.242
"5985","144962",2000,301,185,116,183,50,133,71.89,0.7189,0.608,0.431
"5986","144971",2000,121,72,49,49,17,32,44.44,0.4444,0.405,0.347
"5987","145600",2000,2762,1557,1205,588,203,385,24.73,0.2473,0.213,0.168
"5988","145619",2000,278,156,122,114,45,69,44.23,0.4423,0.41,0.369
"5989","145637",2000,6167,2990,3177,3737,1692,2045,68.39,0.6839,0.606,0.533
"5990","145691",2000,239,128,111,102,32,70,54.69,0.5469,0.427,0.288
"5991","145813",2000,3254,1996,1258,1204,347,857,42.94,0.4294,0.37,0.276
"5992","146481",2000,335,187,148,194,78,116,62.03,0.6203,0.579,0.527
"5993","146612",2000,427,183,244,127,69,58,31.69,0.3169,0.297,0.283
"5994","146719",2000,889,585,304,542,164,378,64.62,0.6462,0.61,0.539
"5995","146825",2000,199,97,102,55,20,35,36.08,0.3608,0.276,0.196
"5996","147013",2000,265,154,111,97,35,62,40.26,0.4026,0.366,0.315
"5997","147244",2000,574,316,258,320,120,200,63.29,0.6329,0.557,0.465
"5998","147341",2000,235,136,99,143,51,92,67.65,0.6765,0.609,0.515
"5999","147703",2000,2765,1341,1424,634,273,361,26.92,0.2692,0.229,0.192
"6000","147767",2000,1876,983,893,1612,731,881,89.62,0.8962,0.859,0.819
"6001","147776",2000,948,570,378,27,7,20,3.51,0.0351,0.028,0.019
"6002","147828",2000,468,278,190,187,61,126,45.32,0.4532,0.4,0.321
"6003","148131",2000,235,137,98,81,25,56,40.88,0.4088,0.345,0.255
"6004","148496",2000,165,108,57,94,30,64,59.26,0.5926,0.57,0.526
"6005","148584",2000,190,109,81,73,25,48,44.04,0.4404,0.384,0.309
"6006","148627",2000,352,222,130,112,36,76,34.23,0.3423,0.318,0.277
"6007","149222",2000,2325,1036,1289,473,201,272,26.25,0.2625,0.203,0.156
"6008","149231",2000,1495,848,647,324,103,221,26.06,0.2606,0.217,0.159
"6009","149772",2000,1762,904,858,557,245,312,34.51,0.3451,0.316,0.286
"6010","149781",2000,568,291,277,441,212,229,78.69,0.7869,0.776,0.765
"6011","150066",2000,538,275,263,212,77,135,49.09,0.4909,0.394,0.293
"6012","150136",2000,3694,2023,1671,1062,372,690,34.11,0.3411,0.287,0.223
"6013","150145",2000,294,182,112,114,41,73,40.11,0.4011,0.388,0.366
"6014","150163",2000,868,559,309,516,182,334,59.75,0.5975,0.594,0.589
"6015","150400",2000,610,336,274,479,202,277,82.44,0.8244,0.785,0.737
"6016","150534",2000,555,320,235,237,84,153,47.81,0.4781,0.427,0.357
"6017","150668",2000,194,113,81,87,30,57,50.44,0.5044,0.448,0.37
"6018","150941",2000,206,109,97,100,46,54,49.54,0.4954,0.485,0.474
"6019","151102",2000,1337,723,614,48,22,26,3.6,0.036,0.036,0.036
"6020","151111",2000,2473,1414,1059,168,48,120,8.49,0.0849,0.068,0.045
"6021","151306",2000,1729,1033,696,247,57,190,18.39,0.1839,0.143,0.082
"6022","151324",2000,2124,1122,1002,404,126,278,24.78,0.2478,0.19,0.126
"6023","151333",2000,347,223,124,28,9,19,8.52,0.0852,0.081,0.073
"6024","151342",2000,637,349,288,22,6,16,4.58,0.0458,0.035,0.021
"6025","151351",2000,6862,3839,3023,3421,1362,2059,53.63,0.5363,0.499,0.451
"6026","151360",2000,517,318,199,33,16,17,5.35,0.0535,0.064,0.08
"6027","151379",2000,700,413,287,57,18,39,9.44,0.0944,0.081,0.063
"6028","151388",2000,249,161,88,10,1,9,5.59,0.0559,0.04,0.011
"6029","151777",2000,333,178,155,142,46,96,53.93,0.5393,0.426,0.297
"6030","151786",2000,208,126,82,58,12,46,36.51,0.3651,0.279,0.146
"6031","152080",2000,1955,919,1036,1757,921,836,90.97,0.9097,0.899,0.889
"6032","152248",2000,1043,577,466,37,14,23,3.99,0.0399,0.035,0.03
"6033","152363",2000,246,132,114,109,50,59,44.7,0.447,0.443,0.439
"6034","152530",2000,482,242,240,332,149,183,75.62,0.7562,0.689,0.621
"6035","152600",2000,707,388,319,450,188,262,67.53,0.6753,0.636,0.589
"6036","153001",2000,326,182,144,153,62,91,50,0.5,0.469,0.431
"6037","153108",2000,369,214,155,226,84,142,66.36,0.6636,0.612,0.542
"6038","153269",2000,760,475,285,353,127,226,47.58,0.4758,0.464,0.446
"6039","153384",2000,363,209,154,312,127,185,88.52,0.8852,0.86,0.825
"6040","153603",2000,4282,1928,2354,1340,515,825,42.79,0.4279,0.313,0.219
"6041","153834",2000,662,396,266,420,161,259,65.4,0.654,0.634,0.605
"6042","154095",2000,2218,1337,881,751,243,508,38,0.38,0.339,0.276
"6043","155089",2000,231,127,104,49,18,31,24.41,0.2441,0.212,0.173
"6044","155317",2000,4119,2268,1851,1282,455,827,36.46,0.3646,0.311,0.246
"6045","155335",2000,171,112,59,49,14,35,31.25,0.3125,0.287,0.237
"6046","155399",2000,3399,1711,1688,829,289,540,31.56,0.3156,0.244,0.171
"6047","155520",2000,260,133,127,113,39,74,55.64,0.5564,0.435,0.307
"6048","155627",2000,111,40,71,30,12,18,45,0.45,0.27,0.169
"6049","155937",2000,126,60,66,47,18,29,48.33,0.4833,0.373,0.273
"6050","156213",2000,304,180,124,166,60,106,58.89,0.5889,0.546,0.484
"6051","156286",2000,355,224,131,172,63,109,48.66,0.4866,0.485,0.481
"6052","156295",2000,421,245,176,169,60,109,44.49,0.4449,0.401,0.341
"6053","156365",2000,317,167,150,88,25,63,37.72,0.3772,0.278,0.167
"6054","156541",2000,403,195,208,82,37,45,23.08,0.2308,0.203,0.178
"6055","156745",2000,331,189,142,158,49,109,57.67,0.5767,0.477,0.345
"6056","157058",2000,340,171,169,49,17,32,18.71,0.1871,0.144,0.101
"6057","157076",2000,159,75,84,37,12,25,33.33,0.3333,0.233,0.143
"6058","157085",2000,2971,1590,1381,884,333,551,34.65,0.3465,0.298,0.241
"6059","157289",2000,2249,1162,1087,321,113,208,17.9,0.179,0.143,0.104
"6060","157386",2000,1473,849,624,181,59,122,14.37,0.1437,0.123,0.095
"6061","157401",2000,1210,730,480,348,108,240,32.88,0.3288,0.288,0.225
"6062","157447",2000,1682,974,708,114,37,77,7.91,0.0791,0.068,0.052
"6063","157535",2000,282,137,145,45,7,38,27.74,0.2774,0.16,0.048
"6064","157951",2000,2477,1444,1033,634,202,432,29.92,0.2992,0.256,0.196
"6065","158477",2000,229,152,77,99,33,66,43.42,0.4342,0.432,0.429
"6066","159009",2000,908,513,395,182,46,136,26.51,0.2651,0.2,0.116
"6067","159391",2000,5072,2803,2269,1229,431,798,28.47,0.2847,0.242,0.19
"6068","159647",2000,1795,819,976,480,222,258,31.5,0.315,0.267,0.227
"6069","159717",2000,1320,767,553,110,31,79,10.3,0.103,0.083,0.056
"6070","159966",2000,1460,882,578,118,26,92,10.43,0.1043,0.081,0.045
"6071","160038",2000,1555,959,596,194,56,138,14.39,0.1439,0.125,0.094
"6072","160612",2000,2220,1351,869,176,59,117,8.66,0.0866,0.079,0.068
"6073","160621",2000,1766,996,770,2,2,0,0,0,0.001,0.003
"6074","160658",2000,2291,1302,989,314,103,211,16.21,0.1621,0.137,0.104
"6075","161004",2000,452,221,231,379,188,191,86.43,0.8643,0.838,0.814
"6076","161226",2000,475,329,146,176,40,136,41.34,0.4134,0.371,0.274
"6077","161235",2000,82,38,44,4,1,3,7.89,0.0789,0.049,0.023
"6078","161244",2000,127,85,42,13,4,9,10.59,0.1059,0.102,0.095
"6079","161253",2000,1589,781,808,536,222,314,40.2,0.402,0.337,0.275
"6080","161554",2000,855,489,366,81,21,60,12.27,0.1227,0.095,0.057
"6081","162007",2000,361,195,166,47,13,34,17.44,0.1744,0.13,0.078
"6082","162210",2000,158,89,69,22,4,18,20.22,0.2022,0.139,0.058
"6083","162283",2000,417,289,128,20,4,16,5.54,0.0554,0.048,0.031
"6084","162584",2000,1028,499,529,199,64,135,27.05,0.2705,0.194,0.121
"6085","162654",2000,365,258,107,227,57,170,65.89,0.6589,0.622,0.533
"6086","162760",2000,131,128,3,90,3,87,67.97,0.6797,0.687,1
"6087","162928",2000,1067,456,611,876,483,393,86.18,0.8618,0.821,0.791
"6088","163046",2000,909,520,389,699,277,422,81.15,0.8115,0.769,0.712
"6089","163268",2000,1307,601,706,362,150,212,35.27,0.3527,0.277,0.212
"6090","163286",2000,3929,1896,2033,2141,933,1208,63.71,0.6371,0.545,0.459
"6091","163453",2000,1107,689,418,204,60,144,20.9,0.209,0.184,0.144
"6092","163462",2000,383,223,160,255,109,146,65.47,0.6547,0.666,0.681
"6093","163851",2000,939,546,393,488,163,325,59.52,0.5952,0.52,0.415
"6094","163912",2000,375,220,155,262,94,168,76.36,0.7636,0.699,0.606
"6095","164076",2000,1981,1198,783,630,190,440,36.73,0.3673,0.318,0.243
"6096","164173",2000,425,313,112,220,51,169,53.99,0.5399,0.518,0.455
"6097","164216",2000,374,236,138,255,80,175,74.15,0.7415,0.682,0.58
"6098","164270",2000,442,247,195,293,109,184,74.49,0.7449,0.663,0.559
"6099","164447",2000,239,123,116,112,63,49,39.84,0.3984,0.469,0.543
"6100","164492",2000,149,110,39,81,18,63,57.27,0.5727,0.544,0.462
"6101","164562",2000,593,367,226,409,114,295,80.38,0.8038,0.69,0.504
"6102","165015",2000,858,475,383,714,301,413,86.95,0.8695,0.832,0.786
"6103","165024",2000,1244,760,484,290,87,203,26.71,0.2671,0.233,0.18
"6104","165334",2000,497,292,205,315,120,195,66.78,0.6678,0.634,0.585
"6105","165662",2000,641,396,245,461,179,282,71.21,0.7121,0.719,0.731
"6106","165671",2000,165,165,0,82,0,82,49.7,0.497,0.497,NA
"6107","165820",2000,448,275,173,119,30,89,32.36,0.3236,0.266,0.173
"6108","165866",2000,612,434,178,153,30,123,28.34,0.2834,0.25,0.169
"6109","165936",2000,411,274,137,233,71,162,59.12,0.5912,0.567,0.518
"6110","166027",2000,1638,755,883,1431,757,674,89.27,0.8927,0.874,0.857
"6111","166124",2000,706,376,330,626,284,342,90.96,0.9096,0.887,0.861
"6112","166513",2000,996,373,623,299,140,159,42.63,0.4263,0.3,0.225
"6113","166629",2000,3803,2086,1717,1768,667,1101,52.78,0.5278,0.465,0.388
"6114","166638",2000,593,326,267,91,14,77,23.62,0.2362,0.153,0.052
"6115","166683",2000,1010,425,585,825,468,357,84,0.84,0.817,0.8
"6116","167288",2000,224,126,98,80,32,48,38.1,0.381,0.357,0.327
"6117","167987",2000,1300,642,658,363,142,221,34.42,0.3442,0.279,0.216
"6118","167996",2000,629,363,266,517,210,307,84.57,0.8457,0.822,0.789
"6119","168005",2000,645,371,274,243,87,156,42.05,0.4205,0.377,0.318
"6120","168148",2000,1181,637,544,1022,464,558,87.6,0.876,0.865,0.853
"6121","168254",2000,560,262,298,268,140,128,48.85,0.4885,0.479,0.47
"6122","168281",2000,450,286,164,318,104,214,74.83,0.7483,0.707,0.634
"6123","168342",2000,528,260,268,483,240,243,93.46,0.9346,0.915,0.896
"6124","168546",2000,405,253,152,270,86,184,72.73,0.7273,0.667,0.566
"6125","168786",2000,362,244,118,89,24,65,26.64,0.2664,0.246,0.203
"6126","169080",2000,1050,594,456,585,241,344,57.91,0.5791,0.557,0.529
"6127","169798",2000,2664,1619,1045,327,109,218,13.47,0.1347,0.123,0.104
"6128","169910",2000,2147,883,1264,94,47,47,5.32,0.0532,0.044,0.037
"6129","170082",2000,2831,1732,1099,548,166,382,22.06,0.2206,0.194,0.151
"6130","170301",2000,754,468,286,480,170,310,66.24,0.6624,0.637,0.594
"6131","170532",2000,324,180,144,246,103,143,79.44,0.7944,0.759,0.715
"6132","170639",2000,555,262,293,76,35,41,15.65,0.1565,0.137,0.119
"6133","170976",2000,5403,2860,2543,3803,1697,2106,73.64,0.7364,0.704,0.667
"6134","171100",2000,6790,3756,3034,2908,1026,1882,50.11,0.5011,0.428,0.338
"6135","171128",2000,1267,292,975,316,223,93,31.85,0.3185,0.249,0.229
"6136","171137",2000,738,371,367,118,52,66,17.79,0.1779,0.16,0.142
"6137","171146",2000,576,349,227,64,18,46,13.18,0.1318,0.111,0.079
"6138","171599",2000,183,66,117,36,18,18,27.27,0.2727,0.197,0.154
"6139","172051",2000,1049,559,490,68,24,44,7.87,0.0787,0.065,0.049
"6140","172699",2000,4429,2349,2080,865,323,542,23.07,0.2307,0.195,0.155
"6141","173160",2000,591,357,234,364,127,237,66.39,0.6639,0.616,0.543
"6142","173258",2000,471,247,224,415,194,221,89.47,0.8947,0.881,0.866
"6143","173328",2000,212,124,88,57,15,42,33.87,0.3387,0.269,0.17
"6144","173647",2000,652,383,269,392,169,223,58.22,0.5822,0.601,0.628
"6145","173902",2000,454,299,155,366,126,240,80.27,0.8027,0.806,0.813
"6146","174066",2000,4865,2577,2288,1581,668,913,35.43,0.3543,0.325,0.292
"6147","174233",2000,2088,1107,981,508,182,326,29.45,0.2945,0.243,0.186
"6148","174251",2000,467,267,200,186,66,120,44.94,0.4494,0.398,0.33
"6149","174491",2000,430,279,151,178,52,126,45.16,0.4516,0.414,0.344
"6150","174792",2000,522,0,522,406,406,0,NA,NA,0.778,0.778
"6151","174844",2000,753,441,312,600,232,368,83.45,0.8345,0.797,0.744
"6152","174899",2000,315,226,89,173,45,128,56.64,0.5664,0.549,0.506
"6153","174914",2000,1082,578,504,597,244,353,61.07,0.6107,0.552,0.484
"6154","175342",2000,489,248,241,107,28,79,31.85,0.3185,0.219,0.116
"6155","175421",2000,182,95,87,50,19,31,32.63,0.3263,0.275,0.218
"6156","175616",2000,461,273,188,111,24,87,31.87,0.3187,0.241,0.128
"6157","175856",2000,936,547,389,134,40,94,17.18,0.1718,0.143,0.103
"6158","175980",2000,292,152,140,176,82,94,61.84,0.6184,0.603,0.586
"6159","176017",2000,1981,1019,962,655,248,407,39.94,0.3994,0.331,0.258
"6160","176035",2000,205,190,15,57,0,57,30,0.3,0.278,0
"6161","176044",2000,297,173,124,41,13,28,16.18,0.1618,0.138,0.105
"6162","176080",2000,2055,1057,998,556,204,352,33.3,0.333,0.271,0.204
"6163","176406",2000,224,168,56,66,15,51,30.36,0.3036,0.295,0.268
"6164","176628",2000,162,91,71,36,5,31,34.07,0.3407,0.222,0.07
"6165","176947",2000,216,102,114,68,17,51,50,0.5,0.315,0.149
"6166","176965",2000,1455,794,661,380,146,234,29.47,0.2947,0.261,0.221
"6167","177418",2000,164,124,40,57,4,53,42.74,0.4274,0.348,0.1
"6168","178059",2000,231,186,45,122,18,104,55.91,0.5591,0.528,0.4
"6169","178341",2000,771,427,344,129,50,79,18.5,0.185,0.167,0.145
"6170","178387",2000,908,532,376,91,20,71,13.35,0.1335,0.1,0.053
"6171","178396",2000,4170,2247,1923,1657,609,1048,46.64,0.4664,0.397,0.317
"6172","178402",2000,688,391,297,120,44,76,19.44,0.1944,0.174,0.148
"6173","178411",2000,672,146,526,143,98,45,30.82,0.3082,0.213,0.186
"6174","178420",2000,497,279,218,100,35,65,23.3,0.233,0.201,0.161
"6175","178615",2000,1396,840,556,537,181,356,42.38,0.4238,0.385,0.326
"6176","179043",2000,267,141,126,135,61,74,52.48,0.5248,0.506,0.484
"6177","179159",2000,1405,748,657,886,397,489,65.37,0.6537,0.631,0.604
"6178","179557",2000,1433,817,616,372,103,269,32.93,0.3293,0.26,0.167
"6179","179566",2000,2496,1477,1019,613,204,409,27.69,0.2769,0.246,0.2
"6180","179867",2000,1392,761,631,1158,498,660,86.73,0.8673,0.832,0.789
"6181","179894",2000,412,242,170,168,60,108,44.63,0.4463,0.408,0.353
"6182","179946",2000,173,75,98,82,37,45,60,0.6,0.474,0.378
"6183","180179",2000,538,352,186,48,10,38,10.8,0.108,0.089,0.054
"6184","180461",2000,1852,841,1011,357,160,197,23.42,0.2342,0.193,0.158
"6185","180522",2000,187,85,102,28,17,11,12.94,0.1294,0.15,0.167
"6186","180984",2000,329,173,156,84,42,42,24.28,0.2428,0.255,0.269
"6187","181002",2000,881,535,346,537,197,340,63.55,0.6355,0.61,0.569
"6188","181020",2000,300,160,140,174,75,99,61.88,0.6188,0.58,0.536
"6189","181127",2000,271,119,152,129,61,68,57.14,0.5714,0.476,0.401
"6190","181215",2000,996,550,446,159,48,111,20.18,0.2018,0.16,0.108
"6191","181394",2000,1517,825,692,157,55,102,12.36,0.1236,0.103,0.079
"6192","181446",2000,423,254,169,235,87,148,58.27,0.5827,0.556,0.515
"6193","181464",2000,3598,1783,1815,823,326,497,27.87,0.2787,0.229,0.18
"6194","181534",2000,201,93,108,26,7,19,20.43,0.2043,0.129,0.065
"6195","181783",2000,623,366,257,168,49,119,32.51,0.3251,0.27,0.191
"6196","182281",2000,2126,1182,944,240,70,170,14.38,0.1438,0.113,0.074
"6197","182290",2000,1930,1090,840,293,95,198,18.17,0.1817,0.152,0.113
"6198","182634",2000,274,180,94,148,47,101,56.11,0.5611,0.54,0.5
"6199","182795",2000,530,262,268,227,101,126,48.09,0.4809,0.428,0.377
"6200","183062",2000,935,576,359,243,69,174,30.21,0.3021,0.26,0.192
"6201","183080",2000,902,454,448,241,97,144,31.72,0.3172,0.267,0.217
"6202","183239",2000,518,280,238,349,142,207,73.93,0.7393,0.674,0.597
"6203","183822",2000,236,135,101,13,8,5,3.7,0.037,0.055,0.079
"6204","183974",2000,145,114,31,56,7,49,42.98,0.4298,0.386,0.226
"6205","184348",2000,419,265,154,291,98,193,72.83,0.7283,0.695,0.636
"6206","184603",2000,535,300,235,79,32,47,15.67,0.1567,0.148,0.136
"6207","184612",2000,219,173,46,46,7,39,22.54,0.2254,0.21,0.152
"6208","184782",2000,1053,561,492,444,173,271,48.31,0.4831,0.422,0.352
"6209","185129",2000,661,357,304,46,20,26,7.28,0.0728,0.07,0.066
"6210","185572",2000,1033,529,504,377,142,235,44.42,0.4442,0.365,0.282
"6211","185590",2000,1324,827,497,351,96,255,30.83,0.3083,0.265,0.193
"6212","185828",2000,685,117,568,130,98,32,27.35,0.2735,0.19,0.173
"6213","186131",2000,1159,569,590,1031,503,528,92.79,0.9279,0.89,0.853
"6214","186201",2000,636,392,244,282,87,195,49.74,0.4974,0.443,0.357
"6215","186283",2000,884,504,380,399,152,247,49.01,0.4901,0.451,0.4
"6216","186584",2000,1121,581,540,464,186,278,47.85,0.4785,0.414,0.344
"6217","186876",2000,728,431,297,296,96,200,46.4,0.464,0.407,0.323
"6218","187134",2000,1205,714,491,799,287,512,71.71,0.7171,0.663,0.585
"6219","187444",2000,1160,610,550,188,73,115,18.85,0.1885,0.162,0.133
"6220","187985",2000,2587,1474,1113,311,106,205,13.91,0.1391,0.12,0.095
"6221","188030",2000,1959,1082,877,238,83,155,14.33,0.1433,0.121,0.095
"6222","188429",2000,616,416,200,314,82,232,55.77,0.5577,0.51,0.41
"6223","188641",2000,504,280,224,246,81,165,58.93,0.5893,0.488,0.362
"6224","190044",2000,638,149,489,325,242,83,55.7,0.557,0.509,0.495
"6225","190099",2000,711,339,372,600,308,292,86.14,0.8614,0.844,0.828
"6226","190150",2000,1339,610,729,1136,602,534,87.54,0.8754,0.848,0.826
"6227","190248",2000,122,68,54,55,23,32,47.06,0.4706,0.451,0.426
"6228","190415",2000,3047,1438,1609,2569,1308,1261,87.69,0.8769,0.843,0.813
"6229","190512",2000,1295,701,594,351,137,214,30.53,0.3053,0.271,0.231
"6230","190549",2000,1238,717,521,218,79,139,19.39,0.1939,0.176,0.152
"6231","190558",2000,1488,796,692,44,10,34,4.27,0.0427,0.03,0.014
"6232","190567",2000,852,399,453,27,8,19,4.76,0.0476,0.032,0.018
"6233","190594",2000,1741,1227,514,188,43,145,11.82,0.1182,0.108,0.084
"6234","190637",2000,542,367,175,45,11,34,9.26,0.0926,0.083,0.063
"6235","190664",2000,1085,639,446,254,65,189,29.58,0.2958,0.234,0.146
"6236","190691",2000,458,314,144,29,6,23,7.32,0.0732,0.063,0.042
"6237","190725",2000,317,254,63,77,13,64,25.2,0.252,0.243,0.206
"6238","191241",2000,1632,975,657,1183,468,715,73.33,0.7333,0.725,0.712
"6239","191515",2000,467,251,216,386,172,214,85.26,0.8526,0.827,0.796
"6240","191533",2000,425,245,180,188,61,127,51.84,0.5184,0.442,0.339
"6241","191630",2000,521,282,239,353,144,209,74.11,0.7411,0.678,0.603
"6242","191649",2000,1937,1036,901,703,266,437,42.18,0.4218,0.363,0.295
"6243","191676",2000,358,226,132,217,75,142,62.83,0.6283,0.606,0.568
"6244","191931",2000,723,351,372,337,132,205,58.4,0.584,0.466,0.355
"6245","191968",2000,1675,940,735,1149,474,675,71.81,0.7181,0.686,0.645
"6246","192192",2000,281,183,98,83,28,55,30.05,0.3005,0.295,0.286
"6247","192323",2000,510,291,219,298,119,179,61.51,0.6151,0.584,0.543
"6248","192439",2000,863,578,285,36,9,27,4.67,0.0467,0.042,0.032
"6249","192703",2000,623,315,308,361,153,208,66.03,0.6603,0.579,0.497
"6250","192749",2000,403,277,126,213,58,155,55.96,0.5596,0.529,0.46
"6251","192819",2000,993,589,404,690,272,418,70.97,0.7097,0.695,0.673
"6252","192925",2000,208,153,55,36,10,26,16.99,0.1699,0.173,0.182
"6253","193016",2000,637,421,216,69,10,59,14.01,0.1401,0.108,0.046
"6254","193292",2000,195,133,62,56,13,43,32.33,0.3233,0.287,0.21
"6255","193353",2000,328,251,77,124,15,109,43.43,0.4343,0.378,0.195
"6256","193399",2000,236,174,62,83,16,67,38.51,0.3851,0.352,0.258
"6257","193584",2000,402,304,98,244,56,188,61.84,0.6184,0.607,0.571
"6258","193645",2000,755,662,93,159,13,146,22.05,0.2205,0.211,0.14
"6259","193654",2000,595,402,193,245,69,176,43.78,0.4378,0.412,0.358
"6260","193900",2000,3966,2424,1542,2416,966,1450,59.82,0.5982,0.609,0.626
"6261","193973",2000,628,371,257,350,122,228,61.46,0.6146,0.557,0.475
"6262","194161",2000,373,233,140,105,35,70,30.04,0.3004,0.282,0.25
"6263","194310",2000,1602,976,626,612,204,408,41.8,0.418,0.382,0.326
"6264","194824",2000,1303,334,969,833,603,230,68.86,0.6886,0.639,0.622
"6265","195003",2000,2278,636,1642,453,244,209,32.86,0.3286,0.199,0.149
"6266","195030",2000,1044,460,584,741,395,346,75.22,0.7522,0.71,0.676
"6267","195164",2000,584,316,268,309,116,193,61.08,0.6108,0.529,0.433
"6268","195173",2000,434,242,192,191,72,119,49.17,0.4917,0.44,0.375
"6269","195216",2000,612,325,287,436,186,250,76.92,0.7692,0.712,0.648
"6270","195234",2000,485,349,136,216,47,169,48.42,0.4842,0.445,0.346
"6271","195243",2000,298,173,125,117,38,79,45.66,0.4566,0.393,0.304
"6272","195304",2000,292,212,80,204,56,148,69.81,0.6981,0.699,0.7
"6273","195474",2000,765,404,361,547,234,313,77.48,0.7748,0.715,0.648
"6274","195526",2000,599,345,254,461,186,275,79.71,0.7971,0.77,0.732
"6275","195544",2000,98,80,18,67,6,61,76.25,0.7625,0.684,0.333
"6276","195809",2000,2853,1619,1234,997,387,610,37.68,0.3768,0.349,0.314
"6277","196413",2000,2791,1569,1222,1981,805,1176,74.95,0.7495,0.71,0.659
"6278","196592",2000,1272,919,353,121,46,75,8.16,0.0816,0.095,0.13
"6279","197045",2000,445,260,185,139,41,98,37.69,0.3769,0.312,0.222
"6280","197133",2000,639,389,250,544,211,333,85.6,0.856,0.851,0.844
"6281","197869",2000,2544,1370,1174,872,285,587,42.85,0.4285,0.343,0.243
"6282","197984",2000,188,113,75,63,22,41,36.28,0.3628,0.335,0.293
"6283","198385",2000,465,229,236,413,193,220,96.07,0.9607,0.888,0.818
"6284","198464",2000,3105,1837,1268,856,248,608,33.1,0.331,0.276,0.196
"6285","198507",2000,441,248,193,133,32,101,40.73,0.4073,0.302,0.166
"6286","198516",2000,1144,718,426,744,244,500,69.64,0.6964,0.65,0.573
"6287","198835",2000,268,142,126,122,42,80,56.34,0.5634,0.455,0.333
"6288","198969",2000,308,115,193,46,18,28,24.35,0.2435,0.149,0.093
"6289","199102",2000,1661,884,777,321,97,224,25.34,0.2534,0.193,0.125
"6290","199111",2000,496,284,212,154,54,100,35.21,0.3521,0.31,0.255
"6291","199120",2000,3406,2121,1285,2426,829,1597,75.29,0.7529,0.712,0.645
"6292","199139",2000,2142,1208,934,553,194,359,29.72,0.2972,0.258,0.208
"6293","199148",2000,1867,1355,512,556,112,444,32.77,0.3277,0.298,0.219
"6294","199157",2000,720,443,277,162,26,136,30.7,0.307,0.225,0.094
"6295","199193",2000,3816,1622,2194,1379,634,745,45.93,0.4593,0.361,0.289
"6296","199218",2000,1661,1081,580,711,185,526,48.66,0.4866,0.428,0.319
"6297","199281",2000,567,303,264,114,34,80,26.4,0.264,0.201,0.129
"6298","199306",2000,185,90,95,58,17,41,45.56,0.4556,0.314,0.179
"6299","199412",2000,188,136,52,93,23,70,51.47,0.5147,0.495,0.442
"6300","199582",2000,398,232,166,67,17,50,21.55,0.2155,0.168,0.102
"6301","199643",2000,401,247,154,43,13,30,12.15,0.1215,0.107,0.084
"6302","199847",2000,1020,530,490,804,355,449,84.72,0.8472,0.788,0.724
"6303","199962",2000,380,181,199,142,54,88,48.62,0.4862,0.374,0.271
"6304","199999",2000,499,359,140,97,19,78,21.73,0.2173,0.194,0.136
"6305","200004",2000,1211,594,617,298,120,178,29.97,0.2997,0.246,0.194
"6306","200059",2000,350,208,142,34,14,20,9.62,0.0962,0.097,0.099
"6307","200156",2000,331,192,139,107,35,72,37.5,0.375,0.323,0.252
"6308","200217",2000,351,201,150,142,37,105,52.24,0.5224,0.405,0.247
"6309","200226",2000,153,73,80,22,6,16,21.92,0.2192,0.144,0.075
"6310","200253",2000,452,260,192,61,25,36,13.85,0.1385,0.135,0.13
"6311","200280",2000,1832,858,974,394,192,202,23.54,0.2354,0.215,0.197
"6312","200332",2000,1280,512,768,217,102,115,22.46,0.2246,0.17,0.133
"6313","200572",2000,179,92,87,35,11,24,26.09,0.2609,0.196,0.126
"6314","201104",2000,448,265,183,187,51,136,51.32,0.5132,0.417,0.279
"6315","201371",2000,227,124,103,114,48,66,53.23,0.5323,0.502,0.466
"6316","201548",2000,558,333,225,305,111,194,58.26,0.5826,0.547,0.493
"6317","201645",2000,833,305,528,489,279,210,68.85,0.6885,0.587,0.528
"6318","201690",2000,307,173,134,39,5,34,19.65,0.1965,0.127,0.037
"6319","202134",2000,934,471,463,103,42,61,12.95,0.1295,0.11,0.091
"6320","202480",2000,1764,932,832,1055,431,624,66.95,0.6695,0.598,0.518
"6321","202523",2000,648,370,278,484,198,286,77.3,0.773,0.747,0.712
"6322","202763",2000,684,399,285,257,87,170,42.61,0.4261,0.376,0.305
"6323","203085",2000,277,137,140,121,39,82,59.85,0.5985,0.437,0.279
"6324","203128",2000,244,139,105,128,54,74,53.24,0.5324,0.525,0.514
"6325","203368",2000,830,467,363,543,214,329,70.45,0.7045,0.654,0.59
"6326","203517",2000,3556,2184,1372,748,226,522,23.9,0.239,0.21,0.165
"6327","203535",2000,436,227,209,371,168,203,89.43,0.8943,0.851,0.804
"6328","203580",2000,86,63,23,26,6,20,31.75,0.3175,0.302,0.261
"6329","203775",2000,388,240,148,157,49,108,45,0.45,0.405,0.331
"6330","203845",2000,303,141,162,154,75,79,56.03,0.5603,0.508,0.463
"6331","204024",2000,3359,1947,1412,2271,870,1401,71.96,0.7196,0.676,0.616
"6332","204185",2000,555,315,240,277,93,184,58.41,0.5841,0.499,0.388
"6333","204194",2000,365,228,137,139,39,100,43.86,0.4386,0.381,0.285
"6334","204617",2000,179,118,61,48,15,33,27.97,0.2797,0.268,0.246
"6335","204796",2000,5831,3008,2823,2282,851,1431,47.57,0.4757,0.391,0.301
"6336","204857",2000,3586,2041,1545,1693,588,1105,54.14,0.5414,0.472,0.381
"6337","206330",2000,215,84,131,38,19,19,22.62,0.2262,0.177,0.145
"6338","206589",2000,501,258,243,331,137,194,75.19,0.7519,0.661,0.564
"6339","206604",2000,2124,1217,907,403,117,286,23.5,0.235,0.19,0.129
"6340","206622",2000,776,436,340,515,223,292,66.97,0.6697,0.664,0.656
"6341","206695",2000,1853,943,910,220,95,125,13.26,0.1326,0.119,0.104
"6342","206914",2000,620,339,281,68,24,44,12.98,0.1298,0.11,0.085
"6343","207209",2000,690,328,362,40,14,26,7.93,0.0793,0.058,0.039
"6344","207306",2000,329,159,170,46,15,31,19.5,0.195,0.14,0.088
"6345","207324",2000,449,226,223,100,45,55,24.34,0.2434,0.223,0.202
"6346","207388",2000,2953,1615,1338,802,272,530,32.82,0.3282,0.272,0.203
"6347","207500",2000,3326,1760,1566,791,268,523,29.72,0.2972,0.238,0.171
"6348","207722",2000,206,135,71,29,6,23,17.04,0.1704,0.141,0.085
"6349","207847",2000,509,261,248,54,21,33,12.64,0.1264,0.106,0.085
"6350","207865",2000,815,464,351,135,27,108,23.28,0.2328,0.166,0.077
"6351","208822",2000,352,205,147,209,81,128,62.44,0.6244,0.594,0.551
"6352","209056",2000,426,263,163,251,91,160,60.84,0.6084,0.589,0.558
"6353","209065",2000,434,228,206,281,113,168,73.68,0.7368,0.647,0.549
"6354","209542",2000,2652,1250,1402,770,311,459,36.72,0.3672,0.29,0.222
"6355","209551",2000,2809,1527,1282,1089,384,705,46.17,0.4617,0.388,0.3
"6356","209612",2000,303,198,105,158,58,100,50.51,0.5051,0.521,0.552
"6357","209807",2000,915,480,435,133,50,83,17.29,0.1729,0.145,0.115
"6358","209922",2000,358,202,156,204,79,125,61.88,0.6188,0.57,0.506
"6359","210146",2000,681,390,291,130,45,85,21.79,0.2179,0.191,0.155
"6360","210401",2000,506,292,214,336,124,212,72.6,0.726,0.664,0.579
"6361","210429",2000,825,524,301,176,55,121,23.09,0.2309,0.213,0.183
"6362","210571",2000,407,231,176,207,84,123,53.25,0.5325,0.509,0.477
"6363","210669",2000,561,291,270,393,175,218,74.91,0.7491,0.701,0.648
"6364","210775",2000,236,149,87,70,22,48,32.21,0.3221,0.297,0.253
"6365","211088",2000,294,228,66,147,27,120,52.63,0.5263,0.5,0.409
"6366","211158",2000,1414,912,502,587,153,434,47.59,0.4759,0.415,0.305
"6367","211291",2000,914,454,460,773,376,397,87.44,0.8744,0.846,0.817
"6368","211352",2000,359,221,138,161,50,111,50.23,0.5023,0.448,0.362
"6369","211361",2000,840,398,442,187,83,104,26.13,0.2613,0.223,0.188
"6370","211431",2000,180,178,2,85,0,85,47.75,0.4775,0.472,0
"6371","211440",2000,1325,516,809,920,537,383,74.22,0.7422,0.694,0.664
"6372","211468",2000,200,198,2,109,0,109,55.05,0.5505,0.545,0
"6373","211556",2000,138,138,0,54,0,54,39.13,0.3913,0.391,NA
"6374","211583",2000,104,98,6,51,1,50,51.02,0.5102,0.49,0.167
"6375","211608",2000,291,151,140,34,9,25,16.56,0.1656,0.117,0.064
"6376","211644",2000,1305,813,492,330,99,231,28.41,0.2841,0.253,0.201
"6377","211981",2000,380,188,192,160,63,97,51.6,0.516,0.421,0.328
"6378","212009",2000,594,340,254,464,188,276,81.18,0.8118,0.781,0.74
"6379","212054",2000,2125,810,1315,275,97,178,21.98,0.2198,0.129,0.074
"6380","212106",2000,1257,733,524,650,243,407,55.53,0.5553,0.517,0.464
"6381","212115",2000,878,522,356,193,57,136,26.05,0.2605,0.22,0.16
"6382","212133",2000,400,279,121,229,60,169,60.57,0.6057,0.573,0.496
"6383","212160",2000,1304,731,573,297,88,209,28.59,0.2859,0.228,0.154
"6384","212197",2000,474,318,156,310,98,212,66.67,0.6667,0.654,0.628
"6385","212577",2000,510,251,259,382,179,203,80.88,0.8088,0.749,0.691
"6386","212601",2000,563,327,236,257,87,170,51.99,0.5199,0.456,0.369
"6387","212832",2000,179,141,38,70,10,60,42.55,0.4255,0.391,0.263
"6388","212911",2000,334,181,153,305,140,165,91.16,0.9116,0.913,0.915
"6389","213020",2000,2776,1607,1169,605,167,438,27.26,0.2726,0.218,0.143
"6390","213251",2000,359,207,152,265,105,160,77.29,0.7729,0.738,0.691
"6391","213321",2000,457,199,258,285,133,152,76.38,0.7638,0.624,0.516
"6392","213349",2000,1528,925,603,422,100,322,34.81,0.3481,0.276,0.166
"6393","213358",2000,351,199,152,200,98,102,51.26,0.5126,0.57,0.645
"6394","213367",2000,774,404,370,455,203,252,62.38,0.6238,0.588,0.549
"6395","213385",2000,558,280,278,490,238,252,90,0.9,0.878,0.856
"6396","213507",2000,388,225,163,242,85,157,69.78,0.6978,0.624,0.521
"6397","213543",2000,1127,464,663,845,473,372,80.17,0.8017,0.75,0.713
"6398","213613",2000,890,522,368,250,68,182,34.87,0.3487,0.281,0.185
"6399","213668",2000,337,177,160,199,90,109,61.58,0.6158,0.591,0.562
"6400","213783",2000,639,363,276,183,79,104,28.65,0.2865,0.286,0.286
"6401","213826",2000,257,188,69,100,29,71,37.77,0.3777,0.389,0.42
"6402","213996",2000,741,451,290,500,184,316,70.07,0.7007,0.675,0.634
"6403","214041",2000,1265,768,497,463,163,300,39.06,0.3906,0.366,0.328
"6404","214069",2000,261,185,76,160,39,121,65.41,0.6541,0.613,0.513
"6405","214157",2000,378,236,142,246,80,166,70.34,0.7034,0.651,0.563
"6406","214175",2000,579,340,239,480,196,284,83.53,0.8353,0.829,0.82
"6407","214272",2000,299,164,135,87,34,53,32.32,0.3232,0.291,0.252
"6408","214777",2000,5621,2866,2755,3127,1277,1850,64.55,0.6455,0.556,0.464
"6409","215062",2000,2270,1125,1145,1986,967,1019,90.58,0.9058,0.875,0.845
"6410","215743",2000,355,210,145,159,58,101,48.1,0.481,0.448,0.4
"6411","215798",2000,302,141,161,192,99,93,65.96,0.6596,0.636,0.615
"6412","215929",2000,833,472,361,625,259,366,77.54,0.7754,0.75,0.717
"6413","216010",2000,1520,831,689,679,233,446,53.67,0.5367,0.447,0.338
"6414","216038",2000,1346,794,552,372,105,267,33.63,0.3363,0.276,0.19
"6415","216287",2000,366,195,171,316,141,175,89.74,0.8974,0.863,0.825
"6416","216339",2000,3031,1767,1264,857,318,539,30.5,0.305,0.283,0.252
"6417","216524",2000,376,214,162,287,112,175,81.78,0.8178,0.763,0.691
"6418","216694",2000,328,160,168,146,57,89,55.62,0.5562,0.445,0.339
"6419","216764",2000,1715,1085,630,536,127,409,37.7,0.377,0.313,0.202
"6420","216807",2000,340,199,141,230,87,143,71.86,0.7186,0.676,0.617
"6421","216852",2000,534,231,303,218,96,122,52.81,0.5281,0.408,0.317
"6422","216931",2000,460,196,264,194,93,101,51.53,0.5153,0.422,0.352
"6423","217059",2000,900,510,390,366,129,237,46.47,0.4647,0.407,0.331
"6424","217156",2000,1415,767,648,1177,530,647,84.35,0.8435,0.832,0.818
"6425","217402",2000,930,527,403,775,328,447,84.82,0.8482,0.833,0.814
"6426","217536",2000,510,383,127,273,63,210,54.83,0.5483,0.535,0.496
"6427","217776",2000,92,51,41,33,12,21,41.18,0.4118,0.359,0.293
"6428","217819",2000,1985,1337,648,835,215,620,46.37,0.4637,0.421,0.332
"6429","217882",2000,3028,1451,1577,1333,496,837,57.68,0.5768,0.44,0.315
"6430","217998",2000,138,79,59,89,31,58,73.42,0.7342,0.645,0.525
"6431","218061",2000,602,356,246,95,33,62,17.42,0.1742,0.158,0.134
"6432","218229",2000,509,321,188,88,23,65,20.25,0.2025,0.173,0.122
"6433","218238",2000,103,49,54,23,6,17,34.69,0.3469,0.223,0.111
"6434","218399",2000,265,167,98,48,14,34,20.36,0.2036,0.181,0.143
"6435","218414",2000,181,80,101,58,25,33,41.25,0.4125,0.32,0.248
"6436","218663",2000,2475,1394,1081,988,351,637,45.7,0.457,0.399,0.325
"6437","218724",2000,784,434,350,157,57,100,23.04,0.2304,0.2,0.163
"6438","218733",2000,571,307,264,170,48,122,39.74,0.3974,0.298,0.182
"6439","218742",2000,546,358,188,94,24,70,19.55,0.1955,0.172,0.128
"6440","218973",2000,308,150,158,222,104,118,78.67,0.7867,0.721,0.658
"6441","219000",2000,460,286,174,222,76,146,51.05,0.5105,0.483,0.437
"6442","219046",2000,586,361,225,48,11,37,10.25,0.1025,0.082,0.049
"6443","219082",2000,351,149,202,51,25,26,17.45,0.1745,0.145,0.124
"6444","219198",2000,154,97,57,46,21,25,25.77,0.2577,0.299,0.368
"6445","219259",2000,446,257,189,61,10,51,19.84,0.1984,0.137,0.053
"6446","219356",2000,1446,740,706,327,129,198,26.76,0.2676,0.226,0.183
"6447","219471",2000,918,504,414,199,62,137,27.18,0.2718,0.217,0.15
"6448","219602",2000,870,554,316,101,29,72,13,0.13,0.116,0.092
"6449","219709",2000,516,309,207,278,108,170,55.02,0.5502,0.539,0.522
"6450","219718",2000,137,44,93,17,7,10,22.73,0.2273,0.124,0.075
"6451","219949",2000,189,78,111,28,9,19,24.36,0.2436,0.148,0.081
"6452","220075",2000,1483,824,659,244,73,171,20.75,0.2075,0.165,0.111
"6453","220215",2000,357,198,159,132,60,72,36.36,0.3636,0.37,0.377
"6454","220613",2000,711,435,276,204,72,132,30.34,0.3034,0.287,0.261
"6455","220631",2000,168,104,64,50,21,29,27.88,0.2788,0.298,0.328
"6456","220710",2000,269,132,137,135,54,81,61.36,0.6136,0.502,0.394
"6457","221351",2000,396,227,169,296,125,171,75.33,0.7533,0.747,0.74
"6458","221519",2000,385,203,182,276,126,150,73.89,0.7389,0.717,0.692
"6459","221731",2000,134,72,62,35,9,26,36.11,0.3611,0.261,0.145
"6460","221847",2000,1305,609,696,241,85,156,25.62,0.2562,0.185,0.122
"6461","221892",2000,220,130,90,80,24,56,43.08,0.4308,0.364,0.267
"6462","222178",2000,1023,565,458,355,139,216,38.23,0.3823,0.347,0.303
"6463","222983",2000,347,186,161,249,106,143,76.88,0.7688,0.718,0.658
"6464","223232",2000,2822,1666,1156,1388,442,946,56.78,0.5678,0.492,0.382
"6465","224004",2000,130,73,57,24,8,16,21.92,0.2192,0.185,0.14
"6466","224323",2000,279,168,111,167,59,108,64.29,0.6429,0.599,0.532
"6467","225432",2000,794,437,357,16,6,10,2.29,0.0229,0.02,0.017
"6468","225548",2000,355,175,180,82,28,54,30.86,0.3086,0.231,0.156
"6469","225627",2000,388,253,135,77,20,57,22.53,0.2253,0.198,0.148
"6470","226231",2000,286,79,207,96,58,38,48.1,0.481,0.336,0.28
"6471","226833",2000,696,355,341,64,33,31,8.73,0.0873,0.092,0.097
"6472","227216",2000,2841,1664,1177,515,142,373,22.42,0.2242,0.181,0.121
"6473","227331",2000,267,205,62,42,7,35,17.07,0.1707,0.157,0.113
"6474","227526",2000,1230,657,573,163,46,117,17.81,0.1781,0.133,0.08
"6475","227757",2000,628,290,338,498,249,249,85.86,0.8586,0.793,0.737
"6476","227845",2000,397,207,190,118,42,76,36.71,0.3671,0.297,0.221
"6477","227863",2000,303,207,96,72,19,53,25.6,0.256,0.238,0.198
"6478","228042",2000,207,124,83,40,16,24,19.35,0.1935,0.193,0.193
"6479","228149",2000,656,399,257,201,60,141,35.34,0.3534,0.306,0.233
"6480","228246",2000,1276,713,563,736,280,456,63.96,0.6396,0.577,0.497
"6481","228343",2000,355,195,160,230,91,139,71.28,0.7128,0.648,0.569
"6482","228431",2000,2210,1371,839,370,88,282,20.57,0.2057,0.167,0.105
"6483","228459",2000,2531,1553,978,522,122,400,25.76,0.2576,0.206,0.125
"6484","228501",2000,263,105,158,13,7,6,5.71,0.0571,0.049,0.044
"6485","228529",2000,475,238,237,100,40,60,25.21,0.2521,0.211,0.169
"6486","228705",2000,819,332,487,79,33,46,13.86,0.1386,0.096,0.068
"6487","228723",2000,6591,3453,3138,2409,774,1635,47.35,0.4735,0.365,0.247
"6488","228769",2000,1589,801,788,225,102,123,15.36,0.1536,0.142,0.129
"6489","228778",2000,7551,3857,3694,3447,1403,2044,52.99,0.5299,0.456,0.38
"6490","228787",2000,801,303,498,248,127,121,39.93,0.3993,0.31,0.255
"6491","228796",2000,2018,1046,972,85,30,55,5.26,0.0526,0.042,0.031
"6492","228875",2000,1493,902,591,671,210,461,51.11,0.5111,0.449,0.355
"6493","228981",2000,330,175,155,125,48,77,44,0.44,0.379,0.31
"6494","229018",2000,144,86,58,23,8,15,17.44,0.1744,0.16,0.138
"6495","229027",2000,1727,894,833,121,47,74,8.28,0.0828,0.07,0.056
"6496","229115",2000,3998,1982,2016,1005,359,646,32.59,0.3259,0.251,0.178
"6497","229780",2000,216,120,96,30,6,24,20,0.2,0.139,0.062
"6498","229814",2000,867,471,396,121,40,81,17.2,0.172,0.14,0.101
"6499","230603",2000,513,414,99,98,12,86,20.77,0.2077,0.191,0.121
"6500","230728",2000,1632,1116,516,357,76,281,25.18,0.2518,0.219,0.147
"6501","230764",2000,2067,1029,1038,441,155,286,27.79,0.2779,0.213,0.149
"6502","230782",2000,1663,1000,663,135,39,96,9.6,0.096,0.081,0.059
"6503","231059",2000,521,283,238,366,149,217,76.68,0.7668,0.702,0.626
"6504","231174",2000,1765,988,777,917,344,573,58,0.58,0.52,0.443
"6505","231420",2000,192,64,128,44,17,27,42.19,0.4219,0.229,0.133
"6506","231554",2000,107,54,53,26,13,13,24.07,0.2407,0.243,0.245
"6507","231624",2000,1347,782,565,1118,425,693,88.62,0.8862,0.83,0.752
"6508","231712",2000,999,587,412,262,73,189,32.2,0.322,0.262,0.177
"6509","232025",2000,251,127,124,126,53,73,57.48,0.5748,0.502,0.427
"6510","232043",2000,220,137,83,106,35,71,51.82,0.5182,0.482,0.422
"6511","232089",2000,281,102,179,47,23,24,23.53,0.2353,0.167,0.128
"6512","232186",2000,2097,1132,965,650,194,456,40.28,0.4028,0.31,0.201
"6513","232265",2000,828,527,301,327,79,248,47.06,0.4706,0.395,0.262
"6514","232423",2000,3223,1981,1242,2089,684,1405,70.92,0.7092,0.648,0.551
"6515","232557",2000,1216,657,559,431,167,264,40.18,0.4018,0.354,0.299
"6516","232566",2000,895,611,284,412,105,307,50.25,0.5025,0.46,0.37
"6517","232609",2000,438,252,186,188,70,118,46.83,0.4683,0.429,0.376
"6518","232681",2000,873,609,264,622,175,447,73.4,0.734,0.712,0.663
"6519","232706",2000,309,230,79,120,21,99,43.04,0.4304,0.388,0.266
"6520","232937",2000,1262,808,454,141,52,89,11.01,0.1101,0.112,0.115
"6521","232982",2000,1407,798,609,321,93,228,28.57,0.2857,0.228,0.153
"6522","233277",2000,1753,1081,672,610,191,419,38.76,0.3876,0.348,0.284
"6523","233374",2000,723,366,357,574,278,296,80.87,0.8087,0.794,0.779
"6524","233426",2000,444,274,170,259,80,179,65.33,0.6533,0.583,0.471
"6525","233541",2000,377,187,190,105,35,70,37.43,0.3743,0.279,0.184
"6526","233897",2000,277,137,140,74,22,52,37.96,0.3796,0.267,0.157
"6527","233921",2000,4586,2024,2562,2339,1047,1292,63.83,0.6383,0.51,0.409
"6528","234030",2000,2670,1608,1062,522,161,361,22.45,0.2245,0.196,0.152
"6529","234085",2000,349,22,327,204,189,15,68.18,0.6818,0.585,0.578
"6530","234155",2000,885,498,387,187,45,142,28.51,0.2851,0.211,0.116
"6531","234164",2000,456,265,191,69,16,53,20,0.2,0.151,0.084
"6532","235097",2000,1085,642,443,227,64,163,25.39,0.2539,0.209,0.144
"6533","235167",2000,468,254,214,208,81,127,50,0.5,0.444,0.379
"6534","236230",2000,580,355,225,293,94,199,56.06,0.5606,0.505,0.418
"6535","236328",2000,647,408,239,442,155,287,70.34,0.7034,0.683,0.649
"6536","236577",2000,612,413,199,293,90,203,49.15,0.4915,0.479,0.452
"6537","236595",2000,664,428,236,338,104,234,54.67,0.5467,0.509,0.441
"6538","236896",2000,338,160,178,62,25,37,23.12,0.2312,0.183,0.14
"6539","236939",2000,2440,1257,1183,794,277,517,41.13,0.4113,0.325,0.234
"6540","236948",2000,4765,2495,2270,2271,926,1345,53.91,0.5391,0.477,0.408
"6541","237011",2000,2351,1427,924,692,212,480,33.64,0.3364,0.294,0.229
"6542","237057",2000,349,220,129,278,99,179,81.36,0.8136,0.797,0.767
"6543","237066",2000,402,234,168,242,86,156,66.67,0.6667,0.602,0.512
"6544","237215",2000,443,254,189,30,14,16,6.3,0.063,0.068,0.074
"6545","237330",2000,694,381,313,87,26,61,16.01,0.1601,0.125,0.083
"6546","237358",2000,133,76,57,39,18,21,27.63,0.2763,0.293,0.316
"6547","237367",2000,589,333,256,87,25,62,18.62,0.1862,0.148,0.098
"6548","237792",2000,669,378,291,101,32,69,18.25,0.1825,0.151,0.11
"6549","237899",2000,542,277,265,19,6,13,4.69,0.0469,0.035,0.023
"6550","237932",2000,513,275,238,91,29,62,22.55,0.2255,0.177,0.122
"6551","237969",2000,415,232,183,169,56,113,48.71,0.4871,0.407,0.306
"6552","238032",2000,3480,1679,1801,889,346,543,32.34,0.3234,0.255,0.192
"6553","238333",2000,306,177,129,168,79,89,50.28,0.5028,0.549,0.612
"6554","238430",2000,207,122,85,129,53,76,62.3,0.623,0.623,0.624
"6555","238458",2000,500,334,166,220,58,162,48.5,0.485,0.44,0.349
"6556","238476",2000,532,295,237,232,91,141,47.8,0.478,0.436,0.384
"6557","238616",2000,285,169,116,106,43,63,37.28,0.3728,0.372,0.371
"6558","238661",2000,274,203,71,81,13,68,33.5,0.335,0.296,0.183
"6559","239080",2000,245,180,65,85,18,67,37.22,0.3722,0.347,0.277
"6560","239105",2000,1675,926,749,963,404,559,60.37,0.6037,0.575,0.539
"6561","239628",2000,280,166,114,171,64,107,64.46,0.6446,0.611,0.561
"6562","239716",2000,548,321,227,364,128,236,73.52,0.7352,0.664,0.564
"6563","240107",2000,327,252,75,98,16,82,32.54,0.3254,0.3,0.213
"6564","240189",2000,2052,1051,1001,423,155,268,25.5,0.255,0.206,0.155
"6565","240277",2000,929,631,298,216,55,161,25.52,0.2552,0.233,0.185
"6566","240329",2000,1609,1009,600,420,131,289,28.64,0.2864,0.261,0.218
"6567","240338",2000,194,125,69,91,33,58,46.4,0.464,0.469,0.478
"6568","240365",2000,1624,969,655,236,65,171,17.65,0.1765,0.145,0.099
"6569","240374",2000,747,413,334,82,31,51,12.35,0.1235,0.11,0.093
"6570","240417",2000,1307,668,639,195,58,137,20.51,0.2051,0.149,0.091
"6571","240426",2000,395,234,161,57,21,36,15.38,0.1538,0.144,0.13
"6572","240444",2000,5636,3120,2516,2500,963,1537,49.26,0.4926,0.444,0.383
"6573","240453",2000,2663,1449,1214,395,142,253,17.46,0.1746,0.148,0.117
"6574","240462",2000,958,340,618,129,53,76,22.35,0.2235,0.135,0.086
"6575","240471",2000,1096,669,427,259,81,178,26.61,0.2661,0.236,0.19
"6576","240480",2000,1518,925,593,333,107,226,24.43,0.2443,0.219,0.18
"6577","240727",2000,1313,658,655,337,126,211,32.07,0.3207,0.257,0.192
"6578","243443",2000,540,350,190,59,10,49,14,0.14,0.109,0.053
"6579","243780",2000,6403,2646,3757,2209,1046,1163,43.95,0.4395,0.345,0.278
"6580","100654",2001,1038,541,497,138,34,104,19.22,0.1922,0.133,0.068
"6581","100663",2001,1224,765,459,175,57,118,15.42,0.1542,0.143,0.124
"6582","100751",2001,2384,1342,1042,920,313,607,45.23,0.4523,0.386,0.3
"6583","100858",2001,3739,1949,1790,1284,468,816,41.87,0.4187,0.343,0.261
"6584","101435",2001,146,96,50,58,13,45,46.88,0.4688,0.397,0.26
"6585","101480",2001,877,480,397,146,40,106,22.08,0.2208,0.166,0.101
"6586","101675",2001,423,213,210,29,9,20,9.39,0.0939,0.069,0.043
"6587","101879",2001,816,465,351,147,36,111,23.87,0.2387,0.18,0.103
"6588","102049",2001,658,434,224,354,109,245,56.45,0.5645,0.538,0.487
"6589","102094",2001,1116,634,482,160,40,120,18.93,0.1893,0.143,0.083
"6590","102234",2001,251,137,114,112,39,73,53.28,0.5328,0.446,0.342
"6591","102368",2001,1054,572,482,211,71,140,24.48,0.2448,0.2,0.147
"6592","102377",2001,645,375,270,108,41,67,17.87,0.1787,0.167,0.152
"6593","104151",2001,5950,3157,2793,1649,599,1050,33.26,0.3326,0.277,0.214
"6594","104179",2001,5727,3005,2722,1871,717,1154,38.4,0.384,0.327,0.263
"6595","105330",2001,2146,1299,847,609,169,440,33.87,0.3387,0.284,0.2
"6596","106245",2001,703,410,293,57,19,38,9.27,0.0927,0.081,0.065
"6597","106342",2001,129,80,49,68,20,48,60,0.6,0.527,0.408
"6598","106397",2001,2190,1126,1064,718,290,428,38.01,0.3801,0.328,0.273
"6599","106412",2001,700,371,329,97,21,76,20.49,0.2049,0.139,0.064
"6600","106458",2001,1594,921,673,309,86,223,24.21,0.2421,0.194,0.128
"6601","106467",2001,1202,564,638,235,108,127,22.52,0.2252,0.196,0.169
"6602","106485",2001,654,382,272,51,15,36,9.42,0.0942,0.078,0.055
"6603","106704",2001,1668,1028,640,367,102,265,25.78,0.2578,0.22,0.159
"6604","107044",2001,979,547,432,365,145,220,40.22,0.4022,0.373,0.336
"6605","107080",2001,279,164,115,157,49,108,65.85,0.6585,0.563,0.426
"6606","107141",2001,241,149,92,132,50,82,55.03,0.5503,0.548,0.543
"6607","107512",2001,400,214,186,183,73,110,51.4,0.514,0.458,0.392
"6608","107558",2001,190,116,74,61,22,39,33.62,0.3362,0.321,0.297
"6609","110097",2001,649,426,223,360,113,247,57.98,0.5798,0.555,0.507
"6610","110404",2001,214,78,136,175,110,65,83.33,0.8333,0.818,0.809
"6611","110422",2001,2957,1374,1583,629,220,409,29.77,0.2977,0.213,0.139
"6612","110486",2001,610,393,217,86,20,66,16.79,0.1679,0.141,0.092
"6613","110495",2001,516,352,164,96,24,72,20.45,0.2045,0.186,0.146
"6614","110510",2001,1273,774,499,127,36,91,11.76,0.1176,0.1,0.072
"6615","110529",2001,2412,961,1451,229,91,138,14.36,0.1436,0.095,0.063
"6616","110538",2001,2092,1175,917,314,64,250,21.28,0.2128,0.15,0.07
"6617","110547",2001,561,391,170,26,6,20,5.12,0.0512,0.046,0.035
"6618","110556",2001,1946,1179,767,275,74,201,17.05,0.1705,0.141,0.096
"6619","110565",2001,2772,1673,1099,416,86,330,19.73,0.1973,0.15,0.078
"6620","110574",2001,692,435,257,75,17,58,13.33,0.1333,0.108,0.066
"6621","110583",2001,4324,2751,1573,420,117,303,11.01,0.1101,0.097,0.074
"6622","110592",2001,1223,767,456,117,26,91,11.86,0.1186,0.096,0.057
"6623","110617",2001,2278,1387,891,221,49,172,12.4,0.124,0.097,0.055
"6624","113698",2001,127,90,37,51,13,38,42.22,0.4222,0.402,0.351
"6625","115755",2001,725,416,309,81,18,63,15.14,0.1514,0.112,0.058
"6626","119173",2001,328,325,3,47,1,46,14.15,0.1415,0.143,0.333
"6627","120184",2001,111,85,26,55,10,45,52.94,0.5294,0.495,0.385
"6628","121309",2001,545,346,199,327,106,221,63.87,0.6387,0.6,0.533
"6629","121345",2001,393,192,201,339,173,166,86.46,0.8646,0.863,0.861
"6630","122409",2001,3338,1986,1352,664,178,486,24.47,0.2447,0.199,0.132
"6631","122436",2001,1003,646,357,635,217,418,64.71,0.6471,0.633,0.608
"6632","122597",2001,1820,1157,663,209,58,151,13.05,0.1305,0.115,0.087
"6633","122612",2001,840,572,268,411,114,297,51.92,0.5192,0.489,0.425
"6634","122931",2001,1017,556,461,799,339,460,82.73,0.8273,0.786,0.735
"6635","123554",2001,580,352,228,350,129,221,62.78,0.6278,0.603,0.566
"6636","123572",2001,1018,673,345,258,53,205,30.46,0.3046,0.253,0.154
"6637","126562",2001,492,288,204,63,27,36,12.5,0.125,0.128,0.132
"6638","126580",2001,785,453,332,171,54,117,25.83,0.2583,0.218,0.163
"6639","126614",2001,4962,2396,2566,2013,887,1126,46.99,0.4699,0.406,0.346
"6640","126818",2001,3683,2061,1622,1285,420,865,41.97,0.4197,0.349,0.259
"6641","127060",2001,933,486,447,561,249,312,64.2,0.642,0.601,0.557
"6642","127185",2001,1047,469,578,139,50,89,18.98,0.1898,0.133,0.087
"6643","127565",2001,1596,816,780,97,42,55,6.74,0.0674,0.061,0.054
"6644","127741",2001,2108,1309,799,623,140,483,36.9,0.369,0.296,0.175
"6645","128106",2001,634,343,291,115,47,68,19.83,0.1983,0.181,0.162
"6646","128744",2001,175,97,78,49,17,32,32.99,0.3299,0.28,0.218
"6647","128771",2001,1261,623,638,169,74,95,15.25,0.1525,0.134,0.116
"6648","129020",2001,3122,1648,1474,1671,682,989,60.01,0.6001,0.535,0.463
"6649","129242",2001,831,463,368,646,265,381,82.29,0.8229,0.777,0.72
"6650","129941",2001,503,202,301,123,54,69,34.16,0.3416,0.245,0.179
"6651","130253",2001,766,465,301,457,172,285,61.29,0.6129,0.597,0.571
"6652","130314",2001,165,165,0,75,0,75,45.45,0.4545,0.455,NA
"6653","130493",2001,1429,858,571,134,37,97,11.31,0.1131,0.094,0.065
"6654","130590",2001,491,239,252,388,184,204,85.36,0.8536,0.79,0.73
"6655","130697",2001,722,372,350,606,280,326,87.63,0.8763,0.839,0.8
"6656","130776",2001,841,439,402,111,36,75,17.08,0.1708,0.132,0.09
"6657","130794",2001,1293,648,645,1125,538,587,90.59,0.9059,0.87,0.834
"6658","130934",2001,686,385,301,107,30,77,20,0.2,0.156,0.1
"6659","130943",2001,3362,1944,1418,2147,767,1380,70.99,0.7099,0.639,0.541
"6660","131159",2001,1387,875,512,924,330,594,67.89,0.6789,0.666,0.645
"6661","131283",2001,613,342,271,407,170,237,69.3,0.693,0.664,0.627
"6662","131450",2001,213,113,100,10,3,7,6.19,0.0619,0.047,0.03
"6663","131469",2001,2566,1433,1133,1864,761,1103,76.97,0.7697,0.726,0.672
"6664","131496",2001,1482,757,725,1339,648,691,91.28,0.9128,0.904,0.894
"6665","131520",2001,1344,900,444,680,185,495,55,0.55,0.506,0.417
"6666","132471",2001,431,264,167,101,32,69,26.14,0.2614,0.234,0.192
"6667","132602",2001,720,386,334,91,31,60,15.54,0.1554,0.126,0.093
"6668","132903",2001,4913,2621,2292,1529,529,1000,38.15,0.3815,0.311,0.231
"6669","133492",2001,424,241,183,225,83,142,58.92,0.5892,0.531,0.454
"6670","133553",2001,1013,159,854,338,277,61,38.36,0.3836,0.334,0.324
"6671","133650",2001,2243,1300,943,368,88,280,21.54,0.2154,0.164,0.093
"6672","133669",2001,1937,1120,817,292,85,207,18.48,0.1848,0.151,0.104
"6673","133711",2001,407,253,154,185,59,126,49.8,0.498,0.455,0.383
"6674","133881",2001,544,153,391,203,128,75,49.02,0.4902,0.373,0.327
"6675","133951",2001,2457,1364,1093,527,145,382,28.01,0.2801,0.214,0.133
"6676","134079",2001,515,323,192,205,66,139,43.03,0.4303,0.398,0.344
"6677","134097",2001,5681,3318,2363,2702,928,1774,53.47,0.5347,0.476,0.393
"6678","134130",2001,6178,3348,2830,3304,1208,2096,62.6,0.626,0.535,0.427
"6679","134945",2001,428,186,242,219,140,79,42.47,0.4247,0.512,0.579
"6680","135726",2001,2152,1277,875,1349,503,846,66.25,0.6625,0.627,0.575
"6681","136172",2001,1672,979,693,392,126,266,27.17,0.2717,0.234,0.182
"6682","136950",2001,473,300,173,278,90,188,62.67,0.6267,0.588,0.52
"6683","137546",2001,527,298,229,289,117,172,57.72,0.5772,0.548,0.511
"6684","138354",2001,695,406,289,167,59,108,26.6,0.266,0.24,0.204
"6685","138716",2001,420,266,154,79,17,62,23.31,0.2331,0.188,0.11
"6686","138789",2001,551,328,223,39,7,32,9.76,0.0976,0.071,0.031
"6687","139144",2001,536,357,179,262,74,188,52.66,0.5266,0.489,0.413
"6688","139366",2001,761,468,293,84,20,64,13.68,0.1368,0.11,0.068
"6689","139393",2001,238,151,87,120,41,79,52.32,0.5232,0.504,0.471
"6690","139658",2001,1547,817,730,1013,486,527,64.5,0.645,0.655,0.666
"6691","139719",2001,425,225,200,60,16,44,19.56,0.1956,0.141,0.08
"6692","139755",2001,2223,634,1589,736,441,295,46.53,0.4653,0.331,0.278
"6693","139764",2001,266,173,93,31,8,23,13.29,0.1329,0.117,0.086
"6694","139861",2001,879,556,323,203,52,151,27.16,0.2716,0.231,0.161
"6695","139931",2001,2632,1278,1354,435,110,325,25.43,0.2543,0.165,0.081
"6696","139940",2001,2136,1305,831,357,99,258,19.77,0.1977,0.167,0.119
"6697","139959",2001,4459,2646,1813,2137,677,1460,55.18,0.5518,0.479,0.373
"6698","140447",2001,767,472,295,257,73,184,38.98,0.3898,0.335,0.247
"6699","140960",2001,440,238,202,58,13,45,18.91,0.1891,0.132,0.064
"6700","140988",2001,258,186,72,92,20,72,38.71,0.3871,0.357,0.278
"6701","141185",2001,198,124,74,71,25,46,37.1,0.371,0.359,0.338
"6702","141264",2001,1534,937,597,266,67,199,21.24,0.2124,0.173,0.112
"6703","141334",2001,1551,931,620,194,34,160,17.19,0.1719,0.125,0.055
"6704","141486",2001,223,160,63,39,11,28,17.5,0.175,0.175,0.175
"6705","141565",2001,400,231,169,53,17,36,15.58,0.1558,0.132,0.101
"6706","141574",2001,1521,883,638,224,61,163,18.46,0.1846,0.147,0.096
"6707","142276",2001,1485,783,702,53,9,44,5.62,0.0562,0.036,0.013
"6708","142285",2001,1642,791,851,340,122,218,27.56,0.2756,0.207,0.143
"6709","142461",2001,265,150,115,83,31,52,34.67,0.3467,0.313,0.27
"6710","143084",2001,550,310,240,392,167,225,72.58,0.7258,0.713,0.696
"6711","143288",2001,162,95,67,60,18,42,44.21,0.4421,0.37,0.269
"6712","144005",2001,395,280,115,16,3,13,4.64,0.0464,0.041,0.026
"6713","144281",2001,1448,767,681,353,157,196,25.55,0.2555,0.244,0.231
"6714","144740",2001,2042,1180,862,866,325,541,45.85,0.4585,0.424,0.377
"6715","144892",2001,1431,836,595,445,135,310,37.08,0.3708,0.311,0.227
"6716","144962",2001,302,169,133,153,47,106,62.72,0.6272,0.507,0.353
"6717","144971",2001,146,75,71,60,26,34,45.33,0.4533,0.411,0.366
"6718","145600",2001,2637,1470,1167,590,210,380,25.85,0.2585,0.224,0.18
"6719","145619",2001,262,159,103,120,41,79,49.69,0.4969,0.458,0.398
"6720","145637",2001,6234,3008,3226,3886,1789,2097,69.71,0.6971,0.623,0.555
"6721","145691",2001,205,113,92,94,37,57,50.44,0.5044,0.459,0.402
"6722","145813",2001,3331,2080,1251,1316,364,952,45.77,0.4577,0.395,0.291
"6723","146481",2001,336,188,148,214,83,131,69.68,0.6968,0.637,0.561
"6724","146612",2001,384,191,193,126,52,74,38.74,0.3874,0.328,0.269
"6725","146719",2001,1424,960,464,674,202,472,49.17,0.4917,0.473,0.435
"6726","146825",2001,144,65,79,37,14,23,35.38,0.3538,0.257,0.177
"6727","147013",2001,284,168,116,128,35,93,55.36,0.5536,0.451,0.302
"6728","147244",2001,646,356,290,349,139,210,58.99,0.5899,0.54,0.479
"6729","147341",2001,258,122,136,128,67,61,50,0.5,0.496,0.493
"6730","147703",2001,2792,1459,1333,725,281,444,30.43,0.3043,0.26,0.211
"6731","147767",2001,1947,1026,921,1682,769,913,88.99,0.8899,0.864,0.835
"6732","147776",2001,964,622,342,21,7,14,2.25,0.0225,0.022,0.02
"6733","147828",2001,541,297,244,240,90,150,50.51,0.5051,0.444,0.369
"6734","148131",2001,231,119,112,83,32,51,42.86,0.4286,0.359,0.286
"6735","148496",2001,222,139,83,111,34,77,55.4,0.554,0.5,0.41
"6736","148584",2001,177,112,65,72,21,51,45.54,0.4554,0.407,0.323
"6737","148627",2001,353,208,145,88,31,57,27.4,0.274,0.249,0.214
"6738","149222",2001,2153,967,1186,501,220,281,29.06,0.2906,0.233,0.185
"6739","149231",2001,1573,895,678,332,108,224,25.03,0.2503,0.211,0.159
"6740","149772",2001,1677,836,841,557,245,312,37.32,0.3732,0.332,0.291
"6741","149781",2001,572,276,296,416,200,216,78.26,0.7826,0.727,0.676
"6742","150066",2001,462,272,190,170,45,125,45.96,0.4596,0.368,0.237
"6743","150136",2001,3743,2039,1704,1066,344,722,35.41,0.3541,0.285,0.202
"6744","150145",2001,258,161,97,110,34,76,47.2,0.472,0.426,0.351
"6745","150163",2001,929,593,336,512,168,344,58.01,0.5801,0.551,0.5
"6746","150400",2001,620,350,270,481,205,276,78.86,0.7886,0.776,0.759
"6747","150534",2001,511,310,201,226,93,133,42.9,0.429,0.442,0.463
"6748","150668",2001,172,94,78,87,33,54,57.45,0.5745,0.506,0.423
"6749","150941",2001,220,135,85,117,43,74,54.81,0.5481,0.532,0.506
"6750","151102",2001,1426,735,691,69,30,39,5.31,0.0531,0.048,0.043
"6751","151111",2001,2275,1325,950,188,71,117,8.83,0.0883,0.083,0.075
"6752","151306",2001,1897,1135,762,236,64,172,15.15,0.1515,0.124,0.084
"6753","151324",2001,2156,1166,990,413,148,265,22.73,0.2273,0.192,0.149
"6754","151333",2001,343,233,110,36,8,28,12.02,0.1202,0.105,0.073
"6755","151342",2001,750,449,301,40,15,25,5.57,0.0557,0.053,0.05
"6756","151351",2001,6728,3716,3012,3353,1424,1929,51.91,0.5191,0.498,0.473
"6757","151360",2001,511,340,171,43,12,31,9.12,0.0912,0.084,0.07
"6758","151379",2001,722,440,282,57,13,44,10,0.1,0.079,0.046
"6759","151388",2001,264,172,92,18,5,13,7.56,0.0756,0.068,0.054
"6760","151777",2001,334,179,155,145,53,92,51.4,0.514,0.434,0.342
"6761","151786",2001,183,113,70,66,21,45,39.82,0.3982,0.361,0.3
"6762","152080",2001,2036,958,1078,1825,956,869,90.71,0.9071,0.896,0.887
"6763","152248",2001,958,507,451,37,12,25,4.93,0.0493,0.039,0.027
"6764","152363",2001,232,121,111,105,43,62,51.24,0.5124,0.453,0.387
"6765","152530",2001,491,251,240,341,160,181,72.11,0.7211,0.695,0.667
"6766","152600",2001,660,339,321,442,187,255,75.22,0.7522,0.67,0.583
"6767","153001",2001,379,189,190,166,69,97,51.32,0.5132,0.438,0.363
"6768","153108",2001,412,237,175,274,108,166,70.04,0.7004,0.665,0.617
"6769","153269",2001,755,476,279,361,122,239,50.21,0.5021,0.478,0.437
"6770","153384",2001,356,184,172,291,130,161,87.5,0.875,0.817,0.756
"6771","153603",2001,4589,2087,2502,1463,591,872,41.78,0.4178,0.319,0.236
"6772","153834",2001,636,397,239,401,144,257,64.74,0.6474,0.631,0.603
"6773","154095",2001,2055,1310,745,665,189,476,36.34,0.3634,0.324,0.254
"6774","155089",2001,197,133,64,23,6,17,12.78,0.1278,0.117,0.094
"6775","155317",2001,4024,2198,1826,1267,476,791,35.99,0.3599,0.315,0.261
"6776","155335",2001,130,76,54,40,18,22,28.95,0.2895,0.308,0.333
"6777","155399",2001,3358,1689,1669,836,274,562,33.27,0.3327,0.249,0.164
"6778","155520",2001,248,124,124,74,20,54,43.55,0.4355,0.298,0.161
"6779","155627",2001,132,46,86,35,11,24,52.17,0.5217,0.265,0.128
"6780","155937",2001,105,51,54,39,16,23,45.1,0.451,0.371,0.296
"6781","156213",2001,331,206,125,178,66,112,54.37,0.5437,0.538,0.528
"6782","156286",2001,376,255,121,178,47,131,51.37,0.5137,0.473,0.388
"6783","156295",2001,424,241,183,192,76,116,48.13,0.4813,0.453,0.415
"6784","156365",2001,330,175,155,58,24,34,19.43,0.1943,0.176,0.155
"6785","156541",2001,406,203,203,93,33,60,29.56,0.2956,0.229,0.163
"6786","156745",2001,356,203,153,173,69,104,51.23,0.5123,0.486,0.451
"6787","157058",2001,387,199,188,31,4,27,13.57,0.1357,0.08,0.021
"6788","157076",2001,164,60,104,24,8,16,26.67,0.2667,0.146,0.077
"6789","157085",2001,3129,1679,1450,942,374,568,33.83,0.3383,0.301,0.258
"6790","157289",2001,2209,1150,1059,351,137,214,18.61,0.1861,0.159,0.129
"6791","157386",2001,1588,894,694,185,66,119,13.31,0.1331,0.116,0.095
"6792","157401",2001,1409,827,582,423,135,288,34.82,0.3482,0.3,0.232
"6793","157447",2001,1787,1008,779,149,52,97,9.62,0.0962,0.083,0.067
"6794","157535",2001,258,142,116,41,11,30,21.13,0.2113,0.159,0.095
"6795","157951",2001,2640,1563,1077,651,192,459,29.37,0.2937,0.247,0.178
"6796","158477",2001,256,168,88,116,31,85,50.6,0.506,0.453,0.352
"6797","159009",2001,884,479,405,94,23,71,14.82,0.1482,0.106,0.057
"6798","159391",2001,5214,2873,2341,1282,424,858,29.86,0.2986,0.246,0.181
"6799","159647",2001,1770,850,920,481,211,270,31.76,0.3176,0.272,0.229
"6800","159717",2001,1350,745,605,151,56,95,12.75,0.1275,0.112,0.093
"6801","159966",2001,1408,841,567,121,28,93,11.06,0.1106,0.086,0.049
"6802","160038",2001,1543,951,592,198,43,155,16.3,0.163,0.128,0.073
"6803","160612",2001,2007,1209,798,199,51,148,12.24,0.1224,0.099,0.064
"6804","160621",2001,1206,690,516,75,14,61,8.84,0.0884,0.062,0.027
"6805","160658",2001,2301,1306,995,322,93,229,17.53,0.1753,0.14,0.093
"6806","161004",2001,452,228,224,374,191,183,80.26,0.8026,0.827,0.853
"6807","161226",2001,479,323,156,174,45,129,39.94,0.3994,0.363,0.288
"6808","161235",2001,99,49,50,24,8,16,32.65,0.3265,0.242,0.16
"6809","161244",2001,155,105,50,32,6,26,24.76,0.2476,0.206,0.12
"6810","161253",2001,1545,737,808,495,214,281,38.13,0.3813,0.32,0.265
"6811","161554",2001,922,538,384,93,26,67,12.45,0.1245,0.101,0.068
"6812","162007",2001,594,356,238,89,21,68,19.1,0.191,0.15,0.088
"6813","162210",2001,153,95,58,26,3,23,24.21,0.2421,0.17,0.052
"6814","162283",2001,540,384,156,36,4,32,8.33,0.0833,0.067,0.026
"6815","162584",2001,923,471,452,204,65,139,29.51,0.2951,0.221,0.144
"6816","162654",2001,341,247,94,197,45,152,61.54,0.6154,0.578,0.479
"6817","162760",2001,112,110,2,76,2,74,67.27,0.6727,0.679,1
"6818","162928",2001,1077,435,642,884,510,374,85.98,0.8598,0.821,0.794
"6819","163046",2001,880,517,363,679,252,427,82.59,0.8259,0.772,0.694
"6820","163268",2001,1332,603,729,461,204,257,42.62,0.4262,0.346,0.28
"6821","163286",2001,4341,2063,2278,2535,1169,1366,66.21,0.6621,0.584,0.513
"6822","163453",2001,1125,663,462,172,39,133,20.06,0.2006,0.153,0.084
"6823","163462",2001,355,197,158,230,105,125,63.45,0.6345,0.648,0.665
"6824","163851",2001,945,542,403,429,135,294,54.24,0.5424,0.454,0.335
"6825","163912",2001,457,287,170,344,114,230,80.14,0.8014,0.753,0.671
"6826","164076",2001,1910,1245,665,681,169,512,41.12,0.4112,0.357,0.254
"6827","164173",2001,512,374,138,246,56,190,50.8,0.508,0.48,0.406
"6828","164216",2001,338,204,134,234,89,145,71.08,0.7108,0.692,0.664
"6829","164270",2001,368,209,159,244,88,156,74.64,0.7464,0.663,0.553
"6830","164447",2001,197,98,99,91,34,57,58.16,0.5816,0.462,0.343
"6831","164492",2001,140,97,43,69,24,45,46.39,0.4639,0.493,0.558
"6832","164562",2001,604,369,235,402,148,254,68.83,0.6883,0.666,0.63
"6833","165015",2001,735,416,319,629,261,368,88.46,0.8846,0.856,0.818
"6834","165024",2001,1139,695,444,255,59,196,28.2,0.282,0.224,0.133
"6835","165334",2001,511,330,181,354,123,231,70,0.7,0.693,0.68
"6836","165662",2001,643,406,237,440,163,277,68.23,0.6823,0.684,0.688
"6837","165671",2001,277,189,88,128,32,96,50.79,0.5079,0.462,0.364
"6838","165820",2001,405,220,185,91,29,62,28.18,0.2818,0.225,0.157
"6839","165866",2001,645,455,190,145,28,117,25.71,0.2571,0.225,0.147
"6840","165936",2001,441,313,128,246,63,183,58.47,0.5847,0.558,0.492
"6841","166027",2001,1637,786,851,1448,742,706,89.82,0.8982,0.885,0.872
"6842","166124",2001,691,366,325,609,274,335,91.53,0.9153,0.881,0.843
"6843","166513",2001,967,349,618,269,128,141,40.4,0.404,0.278,0.207
"6844","166629",2001,4289,2298,1991,2046,783,1263,54.96,0.5496,0.477,0.393
"6845","166638",2001,676,359,317,67,22,45,12.53,0.1253,0.099,0.069
"6846","166683",2001,1027,426,601,857,479,378,88.73,0.8873,0.834,0.797
"6847","167288",2001,268,171,97,85,26,59,34.5,0.345,0.317,0.268
"6848","167987",2001,1148,575,573,310,125,185,32.17,0.3217,0.27,0.218
"6849","167996",2001,586,328,258,479,203,276,84.15,0.8415,0.817,0.787
"6850","168005",2001,710,393,317,285,116,169,43,0.43,0.401,0.366
"6851","168148",2001,1163,640,523,970,426,544,85,0.85,0.834,0.815
"6852","168254",2001,654,287,367,346,176,170,59.23,0.5923,0.529,0.48
"6853","168281",2001,494,328,166,364,114,250,76.22,0.7622,0.737,0.687
"6854","168342",2001,520,257,263,475,236,239,93,0.93,0.913,0.897
"6855","168546",2001,450,226,224,267,115,152,67.26,0.6726,0.593,0.513
"6856","168786",2001,321,227,94,107,29,78,34.36,0.3436,0.333,0.309
"6857","169080",2001,1026,601,425,571,214,357,59.4,0.594,0.557,0.504
"6858","169798",2001,2706,1627,1079,284,92,192,11.8,0.118,0.105,0.085
"6859","169910",2001,2128,901,1227,123,66,57,6.33,0.0633,0.058,0.054
"6860","170082",2001,2977,1826,1151,569,189,380,20.81,0.2081,0.191,0.164
"6861","170301",2001,763,468,295,474,158,316,67.52,0.6752,0.621,0.536
"6862","170532",2001,341,198,143,248,100,148,74.75,0.7475,0.727,0.699
"6863","170639",2001,536,235,301,83,42,41,17.45,0.1745,0.155,0.14
"6864","170976",2001,5531,2884,2647,3896,1752,2144,74.34,0.7434,0.704,0.662
"6865","171100",2001,6755,3808,2947,2878,1041,1837,48.24,0.4824,0.426,0.353
"6866","171128",2001,1189,281,908,281,181,100,35.59,0.3559,0.236,0.199
"6867","171137",2001,658,330,328,90,33,57,17.27,0.1727,0.137,0.101
"6868","171146",2001,549,330,219,54,17,37,11.21,0.1121,0.098,0.078
"6869","171599",2001,151,59,92,52,26,26,44.07,0.4407,0.344,0.283
"6870","172051",2001,1044,539,505,106,39,67,12.43,0.1243,0.102,0.077
"6871","172699",2001,4562,2306,2256,857,334,523,22.68,0.2268,0.188,0.148
"6872","173160",2001,645,385,260,442,173,269,69.87,0.6987,0.685,0.665
"6873","173258",2001,516,265,251,467,222,245,92.45,0.9245,0.905,0.884
"6874","173328",2001,200,87,113,57,26,31,35.63,0.3563,0.285,0.23
"6875","173647",2001,601,343,258,468,196,272,79.3,0.793,0.779,0.76
"6876","173902",2001,505,265,240,415,193,222,83.77,0.8377,0.822,0.804
"6877","174066",2001,5259,2677,2582,1939,841,1098,41.02,0.4102,0.369,0.326
"6878","174233",2001,2109,1094,1015,495,180,315,28.79,0.2879,0.235,0.177
"6879","174251",2001,474,296,178,206,74,132,44.59,0.4459,0.435,0.416
"6880","174491",2001,400,262,138,184,54,130,49.62,0.4962,0.46,0.391
"6881","174792",2001,502,0,502,360,360,0,NA,NA,0.717,0.717
"6882","174844",2001,744,432,312,608,253,355,82.18,0.8218,0.817,0.811
"6883","174899",2001,314,224,90,175,48,127,56.7,0.567,0.557,0.533
"6884","174914",2001,1080,579,501,601,253,348,60.1,0.601,0.556,0.505
"6885","175342",2001,495,262,233,97,36,61,23.28,0.2328,0.196,0.155
"6886","175421",2001,224,122,102,50,22,28,22.95,0.2295,0.223,0.216
"6887","175616",2001,430,253,177,77,21,56,22.13,0.2213,0.179,0.119
"6888","175856",2001,930,540,390,154,35,119,22.04,0.2204,0.166,0.09
"6889","175980",2001,324,178,146,208,80,128,71.91,0.7191,0.642,0.548
"6890","176017",2001,2126,1110,1016,402,215,187,16.85,0.1685,0.189,0.212
"6891","176035",2001,189,163,26,44,3,41,25.15,0.2515,0.233,0.115
"6892","176044",2001,258,158,100,42,9,33,20.89,0.2089,0.163,0.09
"6893","176080",2001,1826,909,917,483,201,282,31.02,0.3102,0.265,0.219
"6894","176406",2001,201,137,64,58,13,45,32.85,0.3285,0.289,0.203
"6895","176628",2001,155,62,93,32,7,25,40.32,0.4032,0.206,0.075
"6896","176947",2001,240,116,124,67,23,44,37.93,0.3793,0.279,0.185
"6897","176965",2001,1437,789,648,275,33,242,30.67,0.3067,0.191,0.051
"6898","177418",2001,153,111,42,50,12,38,34.23,0.3423,0.327,0.286
"6899","178059",2001,247,183,64,141,31,110,60.11,0.6011,0.571,0.484
"6900","178341",2001,786,411,375,117,47,70,17.03,0.1703,0.149,0.125
"6901","178387",2001,1079,666,413,140,44,96,14.41,0.1441,0.13,0.107
"6902","178396",2001,4112,2175,1937,1686,643,1043,47.95,0.4795,0.41,0.332
"6903","178402",2001,734,444,290,106,36,70,15.77,0.1577,0.144,0.124
"6904","178411",2001,691,126,565,144,109,35,27.78,0.2778,0.208,0.193
"6905","178420",2001,515,313,202,96,25,71,22.68,0.2268,0.186,0.124
"6906","178615",2001,1456,865,591,666,232,434,50.17,0.5017,0.457,0.393
"6907","179043",2001,298,150,148,165,76,89,59.33,0.5933,0.554,0.514
"6908","179159",2001,1329,695,634,827,374,453,65.18,0.6518,0.622,0.59
"6909","179557",2001,1502,910,592,356,98,258,28.35,0.2835,0.237,0.166
"6910","179566",2001,2508,1417,1091,672,213,459,32.39,0.3239,0.268,0.195
"6911","179867",2001,1262,637,625,1049,494,555,87.13,0.8713,0.831,0.79
"6912","179894",2001,399,250,149,179,64,115,46,0.46,0.449,0.43
"6913","179946",2001,248,102,146,97,42,55,53.92,0.5392,0.391,0.288
"6914","180179",2001,526,346,180,48,15,33,9.54,0.0954,0.091,0.083
"6915","180461",2001,1720,731,989,292,148,144,19.7,0.197,0.17,0.15
"6916","180522",2001,177,76,101,16,10,6,7.89,0.0789,0.09,0.099
"6917","180984",2001,265,163,102,71,23,48,29.45,0.2945,0.268,0.225
"6918","181002",2001,760,440,320,454,170,284,64.55,0.6455,0.597,0.531
"6919","181020",2001,218,118,100,128,62,66,55.93,0.5593,0.587,0.62
"6920","181127",2001,252,125,127,130,55,75,60,0.6,0.516,0.433
"6921","181215",2001,1038,602,436,213,62,151,25.08,0.2508,0.205,0.142
"6922","181394",2001,1588,857,731,170,62,108,12.6,0.126,0.107,0.085
"6923","181446",2001,392,223,169,219,84,135,60.54,0.6054,0.559,0.497
"6924","181464",2001,3480,1691,1789,788,308,480,28.39,0.2839,0.226,0.172
"6925","181534",2001,186,85,101,16,5,11,12.94,0.1294,0.086,0.05
"6926","181783",2001,583,359,224,138,40,98,27.3,0.273,0.237,0.179
"6927","182281",2001,2424,1411,1013,324,99,225,15.95,0.1595,0.134,0.098
"6928","182290",2001,1956,1125,831,268,78,190,16.89,0.1689,0.137,0.094
"6929","182634",2001,285,184,101,140,43,97,52.72,0.5272,0.491,0.426
"6930","182795",2001,477,249,228,153,67,86,34.54,0.3454,0.321,0.294
"6931","183062",2001,942,561,381,283,94,189,33.69,0.3369,0.3,0.247
"6932","183080",2001,872,463,409,272,89,183,39.52,0.3952,0.312,0.218
"6933","183239",2001,535,286,249,363,152,211,73.78,0.7378,0.679,0.61
"6934","183822",2001,250,150,100,41,16,25,16.67,0.1667,0.164,0.16
"6935","183974",2001,195,141,54,57,6,51,36.17,0.3617,0.292,0.111
"6936","184348",2001,395,254,141,261,89,172,67.72,0.6772,0.661,0.631
"6937","184603",2001,448,260,188,80,27,53,20.38,0.2038,0.179,0.144
"6938","184612",2001,272,188,84,46,9,37,19.68,0.1968,0.169,0.107
"6939","184782",2001,1276,680,596,498,201,297,43.68,0.4368,0.39,0.337
"6940","185129",2001,540,304,236,43,14,29,9.54,0.0954,0.08,0.059
"6941","185572",2001,881,484,397,339,125,214,44.21,0.4421,0.385,0.315
"6942","185590",2001,1378,826,552,371,102,269,32.57,0.3257,0.269,0.185
"6943","185828",2001,706,129,577,102,70,32,24.81,0.2481,0.144,0.121
"6944","186131",2001,1184,570,614,1051,526,525,92.11,0.9211,0.888,0.857
"6945","186201",2001,628,382,246,303,99,204,53.4,0.534,0.482,0.402
"6946","186283",2001,839,472,367,361,143,218,46.19,0.4619,0.43,0.39
"6947","186584",2001,1182,601,581,495,210,285,47.42,0.4742,0.419,0.361
"6948","186876",2001,751,424,327,335,122,213,50.24,0.5024,0.446,0.373
"6949","187134",2001,1258,750,508,852,302,550,73.33,0.7333,0.677,0.594
"6950","187444",2001,1247,697,550,185,59,126,18.08,0.1808,0.148,0.107
"6951","187985",2001,2364,1323,1041,280,103,177,13.38,0.1338,0.118,0.099
"6952","188030",2001,2051,1075,976,250,76,174,16.19,0.1619,0.122,0.078
"6953","188429",2001,664,469,195,367,89,278,59.28,0.5928,0.553,0.456
"6954","188641",2001,500,243,257,232,97,135,55.56,0.5556,0.464,0.377
"6955","190044",2001,722,164,558,382,290,92,56.1,0.561,0.529,0.52
"6956","190099",2001,740,392,348,631,282,349,89.03,0.8903,0.853,0.81
"6957","190150",2001,1330,607,723,1108,612,496,81.71,0.8171,0.833,0.846
"6958","190248",2001,132,88,44,50,9,41,46.59,0.4659,0.379,0.205
"6959","190415",2001,2984,1471,1513,2524,1246,1278,86.88,0.8688,0.846,0.824
"6960","190512",2001,1688,921,767,554,231,323,35.07,0.3507,0.328,0.301
"6961","190549",2001,1017,591,426,209,64,145,24.53,0.2453,0.206,0.15
"6962","190558",2001,1600,817,783,57,22,35,4.28,0.0428,0.036,0.028
"6963","190567",2001,705,310,395,54,17,37,11.94,0.1194,0.077,0.043
"6964","190594",2001,1877,1284,593,234,41,193,15.03,0.1503,0.125,0.069
"6965","190637",2001,642,441,201,77,18,59,13.38,0.1338,0.12,0.09
"6966","190664",2001,1204,704,500,325,100,225,31.96,0.3196,0.27,0.2
"6967","190691",2001,464,320,144,35,11,24,7.5,0.075,0.075,0.076
"6968","190725",2001,340,278,62,88,12,76,27.34,0.2734,0.259,0.194
"6969","191241",2001,1610,950,660,1218,470,748,78.74,0.7874,0.757,0.712
"6970","191515",2001,465,233,232,386,185,201,86.27,0.8627,0.83,0.797
"6971","191533",2001,433,232,201,200,73,127,54.74,0.5474,0.462,0.363
"6972","191630",2001,548,313,235,368,137,231,73.8,0.738,0.672,0.583
"6973","191649",2001,1974,1037,937,685,248,437,42.14,0.4214,0.347,0.265
"6974","191676",2001,355,229,126,222,77,145,63.32,0.6332,0.625,0.611
"6975","191931",2001,768,376,392,360,144,216,57.45,0.5745,0.469,0.367
"6976","191968",2001,1755,1002,753,1230,501,729,72.75,0.7275,0.701,0.665
"6977","192192",2001,253,188,65,88,14,74,39.36,0.3936,0.348,0.215
"6978","192323",2001,502,292,210,311,122,189,64.73,0.6473,0.62,0.581
"6979","192439",2001,825,574,251,55,20,35,6.1,0.061,0.067,0.08
"6980","192703",2001,597,276,321,344,162,182,65.94,0.6594,0.576,0.505
"6981","192749",2001,404,277,127,226,65,161,58.12,0.5812,0.559,0.512
"6982","192819",2001,908,484,424,632,281,351,72.52,0.7252,0.696,0.663
"6983","192925",2001,208,166,42,53,12,41,24.7,0.247,0.255,0.286
"6984","193016",2001,618,412,206,61,10,51,12.38,0.1238,0.099,0.049
"6985","193292",2001,210,145,65,66,16,50,34.48,0.3448,0.314,0.246
"6986","193353",2001,343,239,104,143,33,110,46.03,0.4603,0.417,0.317
"6987","193399",2001,286,214,72,111,21,90,42.06,0.4206,0.388,0.292
"6988","193584",2001,358,274,84,239,50,189,68.98,0.6898,0.668,0.595
"6989","193645",2001,774,650,124,169,13,156,24,0.24,0.218,0.105
"6990","193654",2001,617,422,195,269,74,195,46.21,0.4621,0.436,0.379
"6991","193900",2001,4136,2525,1611,2574,1016,1558,61.7,0.617,0.622,0.631
"6992","193973",2001,598,362,236,322,117,205,56.63,0.5663,0.538,0.496
"6993","194161",2001,320,206,114,103,35,68,33.01,0.3301,0.322,0.307
"6994","194310",2001,1573,948,625,567,192,375,39.56,0.3956,0.36,0.307
"6995","194824",2001,1109,283,826,730,532,198,69.96,0.6996,0.658,0.644
"6996","195003",2001,2227,574,1653,451,249,202,35.19,0.3519,0.203,0.151
"6997","195030",2001,1095,481,614,767,390,377,78.38,0.7838,0.7,0.635
"6998","195164",2001,518,263,255,280,121,159,60.46,0.6046,0.541,0.475
"6999","195173",2001,471,220,251,171,75,96,43.64,0.4364,0.363,0.299
"7000","195216",2001,511,269,242,377,179,198,73.61,0.7361,0.738,0.74
"7001","195234",2001,490,356,134,239,45,194,54.49,0.5449,0.488,0.336
"7002","195243",2001,301,164,137,101,35,66,40.24,0.4024,0.336,0.255
"7003","195304",2001,323,240,83,213,50,163,67.92,0.6792,0.659,0.602
"7004","195474",2001,713,394,319,530,230,300,76.14,0.7614,0.743,0.721
"7005","195526",2001,598,352,246,469,196,273,77.56,0.7756,0.784,0.797
"7006","195544",2001,66,56,10,43,4,39,69.64,0.6964,0.652,0.4
"7007","195809",2001,2670,1523,1147,957,357,600,39.4,0.394,0.358,0.311
"7008","196413",2001,2601,1493,1108,1837,716,1121,75.08,0.7508,0.706,0.646
"7009","196592",2001,1520,1064,456,146,42,104,9.77,0.0977,0.096,0.092
"7010","197045",2001,475,218,257,154,76,78,35.78,0.3578,0.324,0.296
"7011","197133",2001,695,447,248,612,211,401,89.71,0.8971,0.881,0.851
"7012","197869",2001,2303,1196,1107,857,309,548,45.82,0.4582,0.372,0.279
"7013","197984",2001,143,68,75,61,22,39,57.35,0.5735,0.427,0.293
"7014","198385",2001,465,246,219,420,193,227,92.28,0.9228,0.903,0.881
"7015","198464",2001,3182,1877,1305,813,242,571,30.42,0.3042,0.255,0.185
"7016","198507",2001,363,200,163,102,32,70,35,0.35,0.281,0.196
"7017","198516",2001,1212,757,455,797,263,534,70.54,0.7054,0.658,0.578
"7018","198835",2001,268,159,109,107,27,80,50.31,0.5031,0.399,0.248
"7019","198969",2001,379,117,262,59,28,31,26.5,0.265,0.156,0.107
"7020","199102",2001,1760,874,886,354,117,237,27.12,0.2712,0.201,0.132
"7021","199111",2001,446,281,165,149,43,106,37.72,0.3772,0.334,0.261
"7022","199120",2001,3681,2195,1486,2611,986,1625,74.03,0.7403,0.709,0.664
"7023","199139",2001,2309,1273,1036,610,209,401,31.5,0.315,0.264,0.202
"7024","199148",2001,1898,1350,548,511,102,409,30.3,0.303,0.269,0.186
"7025","199157",2001,763,492,271,174,29,145,29.47,0.2947,0.228,0.107
"7026","199193",2001,3862,1630,2232,1404,619,785,48.16,0.4816,0.364,0.277
"7027","199218",2001,1983,1246,737,824,205,619,49.68,0.4968,0.416,0.278
"7028","199281",2001,688,363,325,100,31,69,19.01,0.1901,0.145,0.095
"7029","199306",2001,146,69,77,63,26,37,53.62,0.5362,0.432,0.338
"7030","199412",2001,209,166,43,105,23,82,49.4,0.494,0.502,0.535
"7031","199582",2001,324,172,152,52,16,36,20.93,0.2093,0.16,0.105
"7032","199643",2001,445,283,162,83,18,65,22.97,0.2297,0.187,0.111
"7033","199847",2001,960,481,479,756,343,413,85.86,0.8586,0.787,0.716
"7034","199962",2001,393,209,184,147,44,103,49.28,0.4928,0.374,0.239
"7035","199999",2001,614,424,190,124,17,107,25.24,0.2524,0.202,0.089
"7036","200004",2001,1176,530,646,266,108,158,29.81,0.2981,0.226,0.167
"7037","200059",2001,375,188,187,39,8,31,16.49,0.1649,0.104,0.043
"7038","200156",2001,293,173,120,96,35,61,35.26,0.3526,0.328,0.292
"7039","200217",2001,372,213,159,143,43,100,46.95,0.4695,0.384,0.27
"7040","200226",2001,133,62,71,18,6,12,19.35,0.1935,0.135,0.085
"7041","200253",2001,419,241,178,43,11,32,13.28,0.1328,0.103,0.062
"7042","200280",2001,1969,870,1099,436,191,245,28.16,0.2816,0.221,0.174
"7043","200332",2001,1187,491,696,162,80,82,16.7,0.167,0.136,0.115
"7044","200572",2001,155,75,80,40,15,25,33.33,0.3333,0.258,0.188
"7045","201104",2001,492,273,219,200,69,131,47.99,0.4799,0.407,0.315
"7046","201371",2001,239,133,106,117,44,73,54.89,0.5489,0.49,0.415
"7047","201548",2001,519,324,195,243,68,175,54.01,0.5401,0.468,0.349
"7048","201645",2001,737,288,449,433,228,205,71.18,0.7118,0.588,0.508
"7049","201690",2001,397,204,193,33,7,26,12.75,0.1275,0.083,0.036
"7050","202134",2001,1008,493,515,95,47,48,9.74,0.0974,0.094,0.091
"7051","202480",2001,1715,879,836,971,389,582,66.21,0.6621,0.566,0.465
"7052","202523",2001,553,309,244,414,170,244,78.96,0.7896,0.749,0.697
"7053","202763",2001,613,377,236,255,69,186,49.34,0.4934,0.416,0.292
"7054","203085",2001,262,119,143,113,38,75,63.03,0.6303,0.431,0.266
"7055","203128",2001,269,157,112,149,52,97,61.78,0.6178,0.554,0.464
"7056","203368",2001,789,442,347,515,219,296,66.97,0.6697,0.653,0.631
"7057","203517",2001,3588,2202,1386,556,158,398,18.07,0.1807,0.155,0.114
"7058","203535",2001,424,243,181,344,149,195,80.25,0.8025,0.811,0.823
"7059","203580",2001,127,98,29,46,7,39,39.8,0.398,0.362,0.241
"7060","203775",2001,355,214,141,145,46,99,46.26,0.4626,0.408,0.326
"7061","203845",2001,362,151,211,164,77,87,57.62,0.5762,0.453,0.365
"7062","204024",2001,3440,1922,1518,2305,905,1400,72.84,0.7284,0.67,0.596
"7063","204185",2001,591,329,262,298,89,209,63.53,0.6353,0.504,0.34
"7064","204194",2001,321,176,145,110,34,76,43.18,0.4318,0.343,0.234
"7065","204617",2001,174,116,58,51,18,33,28.45,0.2845,0.293,0.31
"7066","204796",2001,5955,2935,3020,2381,906,1475,50.26,0.5026,0.4,0.3
"7067","204857",2001,3697,2200,1497,1778,594,1184,53.82,0.5382,0.481,0.397
"7068","206330",2001,202,67,135,42,19,23,34.33,0.3433,0.208,0.141
"7069","206589",2001,532,282,250,342,143,199,70.57,0.7057,0.643,0.572
"7070","206604",2001,2117,1165,952,373,129,244,20.94,0.2094,0.176,0.136
"7071","206622",2001,795,426,369,555,249,306,71.83,0.7183,0.698,0.675
"7072","206695",2001,1951,1041,910,243,81,162,15.56,0.1556,0.125,0.089
"7073","206914",2001,673,355,318,55,16,39,10.99,0.1099,0.082,0.05
"7074","207209",2001,446,232,214,18,5,13,5.6,0.056,0.04,0.023
"7075","207306",2001,310,138,172,36,16,20,14.49,0.1449,0.116,0.093
"7076","207324",2001,465,234,231,107,42,65,27.78,0.2778,0.23,0.182
"7077","207388",2001,3111,1594,1517,834,285,549,34.44,0.3444,0.268,0.188
"7078","207500",2001,3629,1908,1721,897,332,565,29.61,0.2961,0.247,0.193
"7079","207722",2001,261,138,123,26,11,15,10.87,0.1087,0.1,0.089
"7080","207847",2001,579,266,313,75,40,35,13.16,0.1316,0.13,0.128
"7081","207865",2001,853,481,372,128,45,83,17.26,0.1726,0.15,0.121
"7082","208822",2001,301,180,121,172,64,108,60,0.6,0.571,0.529
"7083","209056",2001,415,240,175,277,109,168,70,0.7,0.667,0.623
"7084","209065",2001,422,232,190,250,89,161,69.4,0.694,0.592,0.468
"7085","209542",2001,2982,1467,1515,885,356,529,36.06,0.3606,0.297,0.235
"7086","209551",2001,3049,1687,1362,1244,464,780,46.24,0.4624,0.408,0.341
"7087","209612",2001,310,206,104,171,47,124,60.19,0.6019,0.552,0.452
"7088","209807",2001,1020,548,472,129,42,87,15.88,0.1588,0.126,0.089
"7089","209922",2001,349,198,151,203,84,119,60.1,0.601,0.582,0.556
"7090","210146",2001,759,436,323,149,47,102,23.39,0.2339,0.196,0.146
"7091","210401",2001,476,261,215,345,143,202,77.39,0.7739,0.725,0.665
"7092","210429",2001,811,536,275,144,25,119,22.2,0.222,0.178,0.091
"7093","210571",2001,402,243,159,215,75,140,57.61,0.5761,0.535,0.472
"7094","210669",2001,486,271,215,312,128,184,67.9,0.679,0.642,0.595
"7095","210775",2001,248,159,89,90,28,62,38.99,0.3899,0.363,0.315
"7096","211088",2001,293,203,90,158,47,111,54.68,0.5468,0.539,0.522
"7097","211158",2001,1684,1021,663,646,183,463,45.35,0.4535,0.384,0.276
"7098","211291",2001,913,468,445,784,367,417,89.1,0.891,0.859,0.825
"7099","211352",2001,374,221,153,166,50,116,52.49,0.5249,0.444,0.327
"7100","211361",2001,817,413,404,208,84,124,30.02,0.3002,0.255,0.208
"7101","211431",2001,177,170,7,65,0,65,38.24,0.3824,0.367,0
"7102","211440",2001,1317,534,783,927,526,401,75.09,0.7509,0.704,0.672
"7103","211468",2001,170,170,0,78,0,78,45.88,0.4588,0.459,NA
"7104","211556",2001,133,133,0,56,0,56,42.11,0.4211,0.421,NA
"7105","211583",2001,94,94,0,50,0,50,53.19,0.5319,0.532,NA
"7106","211608",2001,292,146,146,32,7,25,17.12,0.1712,0.11,0.048
"7107","211644",2001,1286,814,472,313,82,231,28.38,0.2838,0.243,0.174
"7108","211981",2001,355,157,198,126,53,73,46.5,0.465,0.355,0.268
"7109","212009",2001,611,321,290,484,218,266,82.87,0.8287,0.792,0.752
"7110","212054",2001,1934,759,1175,313,124,189,24.9,0.249,0.162,0.106
"7111","212106",2001,1176,684,492,596,219,377,55.12,0.5512,0.507,0.445
"7112","212115",2001,969,564,405,259,66,193,34.22,0.3422,0.267,0.163
"7113","212133",2001,427,287,140,216,69,147,51.22,0.5122,0.506,0.493
"7114","212160",2001,1409,831,578,323,99,224,26.96,0.2696,0.229,0.171
"7115","212197",2001,514,319,195,326,116,210,65.83,0.6583,0.634,0.595
"7116","212577",2001,510,248,262,401,190,211,85.08,0.8508,0.786,0.725
"7117","212601",2001,525,313,212,244,83,161,51.44,0.5144,0.465,0.392
"7118","212832",2001,176,140,36,85,15,70,50,0.5,0.483,0.417
"7119","212911",2001,296,154,142,256,120,136,88.31,0.8831,0.865,0.845
"7120","213020",2001,2557,1460,1097,624,190,434,29.73,0.2973,0.244,0.173
"7121","213251",2001,340,205,135,242,87,155,75.61,0.7561,0.712,0.644
"7122","213321",2001,441,217,224,286,121,165,76.04,0.7604,0.649,0.54
"7123","213349",2001,1630,957,673,474,111,363,37.93,0.3793,0.291,0.165
"7124","213358",2001,214,133,81,91,34,57,42.86,0.4286,0.425,0.42
"7125","213367",2001,849,476,373,514,190,324,68.07,0.6807,0.605,0.509
"7126","213385",2001,575,287,288,487,238,249,86.76,0.8676,0.847,0.826
"7127","213507",2001,416,229,187,266,105,161,70.31,0.7031,0.639,0.561
"7128","213543",2001,1109,435,674,798,436,362,83.22,0.8322,0.72,0.647
"7129","213613",2001,978,581,397,286,96,190,32.7,0.327,0.292,0.242
"7130","213668",2001,407,218,189,249,100,149,68.35,0.6835,0.612,0.529
"7131","213783",2001,640,362,278,200,77,123,33.98,0.3398,0.312,0.277
"7132","213826",2001,287,215,72,114,23,91,42.33,0.4233,0.397,0.319
"7133","213996",2001,702,425,277,472,166,306,72,0.72,0.672,0.599
"7134","214041",2001,1245,758,487,518,162,356,46.97,0.4697,0.416,0.333
"7135","214069",2001,260,188,72,157,39,118,62.77,0.6277,0.604,0.542
"7136","214157",2001,315,200,115,219,68,151,75.5,0.755,0.695,0.591
"7137","214175",2001,574,330,244,456,184,272,82.42,0.8242,0.794,0.754
"7138","214272",2001,345,217,128,115,25,90,41.47,0.4147,0.333,0.195
"7139","214777",2001,6146,2983,3163,3576,1586,1990,66.71,0.6671,0.582,0.501
"7140","215062",2001,2316,1148,1168,2018,997,1021,88.94,0.8894,0.871,0.854
"7141","215743",2001,342,187,155,163,60,103,55.08,0.5508,0.477,0.387
"7142","215798",2001,262,128,134,161,69,92,71.88,0.7188,0.615,0.515
"7143","215929",2001,1013,578,435,674,258,416,71.97,0.7197,0.665,0.593
"7144","216010",2001,1478,805,673,683,239,444,55.16,0.5516,0.462,0.355
"7145","216038",2001,1314,751,563,378,117,261,34.75,0.3475,0.288,0.208
"7146","216287",2001,380,193,187,346,165,181,93.78,0.9378,0.911,0.882
"7147","216339",2001,3157,1826,1331,919,319,600,32.86,0.3286,0.291,0.24
"7148","216524",2001,387,230,157,278,114,164,71.3,0.713,0.718,0.726
"7149","216694",2001,315,159,156,141,56,85,53.46,0.5346,0.448,0.359
"7150","216764",2001,1626,1020,606,561,144,417,40.88,0.4088,0.345,0.238
"7151","216807",2001,375,219,156,224,76,148,67.58,0.6758,0.597,0.487
"7152","216852",2001,550,227,323,188,78,110,48.46,0.4846,0.342,0.241
"7153","216931",2001,407,198,209,198,99,99,50,0.5,0.486,0.474
"7154","217059",2001,968,540,428,383,137,246,45.56,0.4556,0.396,0.32
"7155","217156",2001,1375,760,615,1154,506,648,85.26,0.8526,0.839,0.823
"7156","217402",2001,933,531,402,795,334,461,86.82,0.8682,0.852,0.831
"7157","217536",2001,551,396,155,321,78,243,61.36,0.6136,0.583,0.503
"7158","217776",2001,139,78,61,46,18,28,35.9,0.359,0.331,0.295
"7159","217819",2001,1967,1295,672,868,248,620,47.88,0.4788,0.441,0.369
"7160","217882",2001,2530,1184,1346,1166,443,723,61.06,0.6106,0.461,0.329
"7161","217998",2001,217,127,90,125,44,81,63.78,0.6378,0.576,0.489
"7162","218061",2001,634,377,257,127,41,86,22.81,0.2281,0.2,0.16
"7163","218229",2001,488,291,197,118,25,93,31.96,0.3196,0.242,0.127
"7164","218238",2001,136,69,67,31,11,20,28.99,0.2899,0.228,0.164
"7165","218399",2001,268,167,101,56,13,43,25.75,0.2575,0.209,0.129
"7166","218414",2001,178,70,108,55,26,29,41.43,0.4143,0.309,0.241
"7167","218663",2001,3227,1770,1457,1304,461,843,47.63,0.4763,0.404,0.316
"7168","218724",2001,931,494,437,212,60,152,30.77,0.3077,0.228,0.137
"7169","218733",2001,615,358,257,135,47,88,24.58,0.2458,0.22,0.183
"7170","218742",2001,573,350,223,107,36,71,20.29,0.2029,0.187,0.161
"7171","218973",2001,303,152,151,218,100,118,77.63,0.7763,0.719,0.662
"7172","219000",2001,416,276,140,214,58,156,56.52,0.5652,0.514,0.414
"7173","219046",2001,565,354,211,65,27,38,10.73,0.1073,0.115,0.128
"7174","219082",2001,292,123,169,54,28,26,21.14,0.2114,0.185,0.166
"7175","219198",2001,148,109,39,49,10,39,35.78,0.3578,0.331,0.256
"7176","219259",2001,409,244,165,61,14,47,19.26,0.1926,0.149,0.085
"7177","219356",2001,1495,751,744,316,105,211,28.1,0.281,0.211,0.141
"7178","219471",2001,932,578,354,196,45,151,26.12,0.2612,0.21,0.127
"7179","219602",2001,900,569,331,77,20,57,10.02,0.1002,0.086,0.06
"7180","219709",2001,502,309,193,284,121,163,52.75,0.5275,0.566,0.627
"7181","219718",2001,141,63,78,21,3,18,28.57,0.2857,0.149,0.038
"7182","219949",2001,200,92,108,39,15,24,26.09,0.2609,0.195,0.139
"7183","220075",2001,1472,838,634,255,79,176,21,0.21,0.173,0.125
"7184","220215",2001,346,191,155,146,58,88,46.07,0.4607,0.422,0.374
"7185","220613",2001,663,405,258,204,57,147,36.3,0.363,0.308,0.221
"7186","220631",2001,153,101,52,34,12,22,21.78,0.2178,0.222,0.231
"7187","220710",2001,288,166,122,133,35,98,59.04,0.5904,0.462,0.287
"7188","221351",2001,417,249,168,292,107,185,74.3,0.743,0.7,0.637
"7189","221519",2001,353,185,168,259,117,142,76.76,0.7676,0.734,0.696
"7190","221731",2001,119,69,50,33,9,24,34.78,0.3478,0.277,0.18
"7191","221847",2001,1289,529,760,230,108,122,23.06,0.2306,0.178,0.142
"7192","221892",2001,216,112,104,82,36,46,41.07,0.4107,0.38,0.346
"7193","222178",2001,1031,598,433,387,127,260,43.48,0.4348,0.375,0.293
"7194","222983",2001,312,174,138,220,91,129,74.14,0.7414,0.705,0.659
"7195","223232",2001,2790,1664,1126,1340,434,906,54.45,0.5445,0.48,0.385
"7196","224004",2001,189,104,85,28,10,18,17.31,0.1731,0.148,0.118
"7197","224323",2001,310,180,130,170,77,93,51.67,0.5167,0.548,0.592
"7198","225432",2001,869,481,388,19,5,14,2.91,0.0291,0.022,0.013
"7199","225548",2001,319,152,167,80,34,46,30.26,0.3026,0.251,0.204
"7200","225627",2001,416,285,131,66,10,56,19.65,0.1965,0.159,0.076
"7201","226231",2001,242,66,176,74,47,27,40.91,0.4091,0.306,0.267
"7202","226833",2001,668,376,292,69,22,47,12.5,0.125,0.103,0.075
"7203","227216",2001,2803,1665,1138,466,146,320,19.22,0.1922,0.166,0.128
"7204","227331",2001,401,323,78,49,7,42,13,0.13,0.122,0.09
"7205","227526",2001,1380,771,609,182,62,120,15.56,0.1556,0.132,0.102
"7206","227757",2001,657,326,331,509,247,262,80.37,0.8037,0.775,0.746
"7207","227845",2001,413,254,159,131,37,94,37.01,0.3701,0.317,0.233
"7208","227863",2001,272,166,106,68,23,45,27.11,0.2711,0.25,0.217
"7209","228042",2001,180,110,70,46,12,34,30.91,0.3091,0.256,0.171
"7210","228149",2001,534,299,235,181,72,109,36.45,0.3645,0.339,0.306
"7211","228246",2001,1353,713,640,751,297,454,63.67,0.6367,0.555,0.464
"7212","228343",2001,327,174,153,196,77,119,68.39,0.6839,0.599,0.503
"7213","228431",2001,2191,1370,821,360,90,270,19.71,0.1971,0.164,0.11
"7214","228459",2001,2469,1508,961,553,134,419,27.79,0.2779,0.224,0.139
"7215","228501",2001,333,124,209,28,7,21,16.94,0.1694,0.084,0.033
"7216","228529",2001,783,411,372,126,37,89,21.65,0.2165,0.161,0.099
"7217","228705",2001,820,388,432,66,28,38,9.79,0.0979,0.08,0.065
"7218","228723",2001,6271,3265,3006,2408,815,1593,48.79,0.4879,0.384,0.271
"7219","228769",2001,1838,914,924,271,104,167,18.27,0.1827,0.147,0.113
"7220","228778",2001,7198,3742,3456,3385,1392,1993,53.26,0.5326,0.47,0.403
"7221","228787",2001,984,402,582,304,145,159,39.55,0.3955,0.309,0.249
"7222","228796",2001,2156,1156,1000,89,30,59,5.1,0.051,0.041,0.03
"7223","228875",2001,1514,894,620,761,251,510,57.05,0.5705,0.503,0.405
"7224","228981",2001,376,208,168,133,42,91,43.75,0.4375,0.354,0.25
"7225","229018",2001,165,104,61,36,9,27,25.96,0.2596,0.218,0.148
"7226","229027",2001,1910,977,933,137,60,77,7.88,0.0788,0.072,0.064
"7227","229115",2001,4075,1967,2108,1133,438,695,35.33,0.3533,0.278,0.208
"7228","229780",2001,204,111,93,50,17,33,29.73,0.2973,0.245,0.183
"7229","229814",2001,759,419,340,109,24,85,20.29,0.2029,0.144,0.071
"7230","230603",2001,562,443,119,113,18,95,21.44,0.2144,0.201,0.151
"7231","230728",2001,1892,1270,622,384,72,312,24.57,0.2457,0.203,0.116
"7232","230764",2001,1877,1038,839,390,135,255,24.57,0.2457,0.208,0.161
"7233","230782",2001,1509,897,612,47,18,29,3.23,0.0323,0.031,0.029
"7234","231059",2001,518,286,232,380,150,230,80.42,0.8042,0.734,0.647
"7235","231174",2001,1835,1052,783,1017,381,636,60.46,0.6046,0.554,0.487
"7236","231420",2001,175,81,94,48,12,36,44.44,0.4444,0.274,0.128
"7237","231554",2001,162,91,71,53,21,32,35.16,0.3516,0.327,0.296
"7238","231624",2001,1358,793,565,1140,441,699,88.15,0.8815,0.839,0.781
"7239","231712",2001,1042,595,447,318,100,218,36.64,0.3664,0.305,0.224
"7240","232025",2001,267,130,137,113,48,65,50,0.5,0.423,0.35
"7241","232043",2001,208,124,84,115,44,71,57.26,0.5726,0.553,0.524
"7242","232089",2001,269,104,165,51,20,31,29.81,0.2981,0.19,0.121
"7243","232186",2001,2068,1136,932,631,191,440,38.73,0.3873,0.305,0.205
"7244","232265",2001,1189,748,441,450,106,344,45.99,0.4599,0.378,0.24
"7245","232423",2001,3244,2004,1240,2103,696,1407,70.21,0.7021,0.648,0.561
"7246","232557",2001,1129,602,527,381,146,235,39.04,0.3904,0.337,0.277
"7247","232566",2001,891,611,280,410,103,307,50.25,0.5025,0.46,0.368
"7248","232609",2001,475,278,197,219,67,152,54.68,0.5468,0.461,0.34
"7249","232681",2001,840,574,266,570,158,412,71.78,0.7178,0.679,0.594
"7250","232706",2001,354,241,113,123,29,94,39,0.39,0.347,0.257
"7251","232937",2001,1067,655,412,113,25,88,13.44,0.1344,0.106,0.061
"7252","232982",2001,1502,821,681,340,116,224,27.28,0.2728,0.226,0.17
"7253","233277",2001,1875,1155,720,674,200,474,41.04,0.4104,0.359,0.278
"7254","233374",2001,790,430,360,640,277,363,84.42,0.8442,0.81,0.769
"7255","233426",2001,498,311,187,283,96,187,60.13,0.6013,0.568,0.513
"7256","233541",2001,308,158,150,106,40,66,41.77,0.4177,0.344,0.267
"7257","233897",2001,325,154,171,80,36,44,28.57,0.2857,0.246,0.211
"7258","233921",2001,5020,2063,2957,2511,1228,1283,62.19,0.6219,0.5,0.415
"7259","234030",2001,2675,1563,1112,547,170,377,24.12,0.2412,0.204,0.153
"7260","234085",2001,372,17,355,205,196,9,52.94,0.5294,0.551,0.552
"7261","234155",2001,1085,618,467,252,61,191,30.91,0.3091,0.232,0.131
"7262","234164",2001,534,316,218,68,12,56,17.72,0.1772,0.127,0.055
"7263","235097",2001,1179,694,485,256,98,158,22.77,0.2277,0.217,0.202
"7264","235167",2001,460,236,224,206,93,113,47.88,0.4788,0.448,0.415
"7265","236230",2001,578,348,230,287,89,198,56.9,0.569,0.497,0.387
"7266","236328",2001,702,423,279,477,182,295,69.74,0.6974,0.679,0.652
"7267","236577",2001,645,433,212,327,95,232,53.58,0.5358,0.507,0.448
"7268","236595",2001,643,412,231,321,101,220,53.4,0.534,0.499,0.437
"7269","236896",2001,285,149,136,63,26,37,24.83,0.2483,0.221,0.191
"7270","236939",2001,2575,1369,1206,852,314,538,39.3,0.393,0.331,0.26
"7271","236948",2001,5288,2737,2551,2555,1099,1456,53.2,0.532,0.483,0.431
"7272","237011",2001,2205,1284,921,641,207,434,33.8,0.338,0.291,0.225
"7273","237057",2001,362,195,167,288,126,162,83.08,0.8308,0.796,0.754
"7274","237066",2001,427,265,162,251,88,163,61.51,0.6151,0.588,0.543
"7275","237215",2001,380,233,147,3,1,2,0.86,0.0086,0.008,0.007
"7276","237330",2001,646,343,303,199,74,125,36.44,0.3644,0.308,0.244
"7277","237358",2001,123,71,52,31,13,18,25.35,0.2535,0.252,0.25
"7278","237367",2001,568,320,248,62,18,44,13.75,0.1375,0.109,0.073
"7279","237792",2001,647,333,314,71,27,44,13.21,0.1321,0.11,0.086
"7280","237899",2001,379,193,186,16,5,11,5.7,0.057,0.042,0.027
"7281","237932",2001,521,298,223,99,40,59,19.8,0.198,0.19,0.179
"7282","237969",2001,400,202,198,175,65,110,54.46,0.5446,0.438,0.328
"7283","238032",2001,3593,1743,1850,928,381,547,31.38,0.3138,0.258,0.206
"7284","238333",2001,311,189,122,234,86,148,78.31,0.7831,0.752,0.705
"7285","238430",2001,296,215,81,78,29,49,22.79,0.2279,0.264,0.358
"7286","238458",2001,471,319,152,197,48,149,46.71,0.4671,0.418,0.316
"7287","238476",2001,578,280,298,237,112,125,44.64,0.4464,0.41,0.376
"7288","238616",2001,351,169,182,158,82,76,44.97,0.4497,0.45,0.451
"7289","238661",2001,291,203,88,70,21,49,24.14,0.2414,0.241,0.239
"7290","239080",2001,227,149,78,65,18,47,31.54,0.3154,0.286,0.231
"7291","239105",2001,1658,950,708,947,374,573,60.32,0.6032,0.571,0.528
"7292","239628",2001,200,108,92,119,48,71,65.74,0.6574,0.595,0.522
"7293","239716",2001,558,306,252,359,142,217,70.92,0.7092,0.643,0.563
"7294","240107",2001,335,254,81,97,20,77,30.31,0.3031,0.29,0.247
"7295","240189",2001,1857,936,921,379,153,226,24.15,0.2415,0.204,0.166
"7296","240277",2001,866,608,258,214,45,169,27.8,0.278,0.247,0.174
"7297","240329",2001,1596,1022,574,444,138,306,29.94,0.2994,0.278,0.24
"7298","240338",2001,200,124,76,96,31,65,52.42,0.5242,0.48,0.408
"7299","240365",2001,1822,994,828,249,86,163,16.4,0.164,0.137,0.104
"7300","240374",2001,854,486,368,84,21,63,12.96,0.1296,0.098,0.057
"7301","240417",2001,1272,652,620,202,62,140,21.47,0.2147,0.159,0.1
"7302","240426",2001,339,192,147,53,24,29,15.1,0.151,0.156,0.163
"7303","240444",2001,6050,3370,2680,2758,1046,1712,50.8,0.508,0.456,0.39
"7304","240453",2001,2884,1532,1352,423,160,263,17.17,0.1717,0.147,0.118
"7305","240462",2001,1039,373,666,176,85,91,24.4,0.244,0.169,0.128
"7306","240471",2001,1108,680,428,265,86,179,26.32,0.2632,0.239,0.201
"7307","240480",2001,1505,849,656,297,108,189,22.26,0.2226,0.197,0.165
"7308","240727",2001,1411,724,687,369,135,234,32.32,0.3232,0.262,0.197
"7309","243443",2001,478,333,145,52,7,45,13.51,0.1351,0.109,0.048
"7310","243780",2001,6567,2601,3966,2218,1059,1159,44.56,0.4456,0.338,0.267
"7311","100654",2002,1043,506,537,118,37,81,16.01,0.1601,0.113,0.069
"7312","100663",2002,1398,820,578,228,86,142,17.32,0.1732,0.163,0.149
"7313","100751",2002,2585,1441,1144,932,318,614,42.61,0.4261,0.361,0.278
"7314","100858",2002,4148,2184,1964,1424,498,926,42.4,0.424,0.343,0.254
"7315","101435",2002,165,108,57,76,21,55,50.93,0.5093,0.461,0.368
"7316","101480",2002,1059,567,492,146,41,105,18.52,0.1852,0.138,0.083
"7317","101675",2002,391,195,196,24,7,17,8.72,0.0872,0.061,0.036
"7318","101879",2002,786,457,329,104,27,77,16.85,0.1685,0.132,0.082
"7319","102049",2002,652,428,224,5,0,5,1.17,0.0117,0.008,0
"7320","102094",2002,1004,597,407,135,42,93,15.58,0.1558,0.134,0.103
"7321","102234",2002,289,168,121,151,60,91,54.17,0.5417,0.522,0.496
"7322","102368",2002,1353,730,623,288,101,187,25.62,0.2562,0.213,0.162
"7323","102377",2002,738,426,312,168,36,132,30.99,0.3099,0.228,0.115
"7324","104151",2002,6094,3323,2771,1813,661,1152,34.67,0.3467,0.298,0.239
"7325","104179",2002,5613,3008,2605,1805,703,1102,36.64,0.3664,0.322,0.27
"7326","105330",2002,2153,1327,826,681,173,508,38.28,0.3828,0.316,0.209
"7327","106245",2002,739,456,283,72,19,53,11.62,0.1162,0.097,0.067
"7328","106342",2002,113,47,66,62,33,29,61.7,0.617,0.549,0.5
"7329","106397",2002,2137,1106,1031,707,284,423,38.25,0.3825,0.331,0.275
"7330","106412",2002,712,358,354,63,16,47,13.13,0.1313,0.088,0.045
"7331","106458",2002,1539,813,726,291,109,182,22.39,0.2239,0.189,0.15
"7332","106467",2002,1169,624,545,207,80,127,20.35,0.2035,0.177,0.147
"7333","106485",2002,645,368,277,46,14,32,8.7,0.087,0.071,0.051
"7334","106704",2002,1766,1062,704,389,108,281,26.46,0.2646,0.22,0.153
"7335","107044",2002,1011,580,431,383,138,245,42.24,0.4224,0.379,0.32
"7336","107080",2002,317,184,133,199,73,126,68.48,0.6848,0.628,0.549
"7337","107141",2002,303,186,117,176,64,112,60.22,0.6022,0.581,0.547
"7338","107512",2002,396,229,167,166,64,102,44.54,0.4454,0.419,0.383
"7339","107558",2002,200,97,103,60,28,32,32.99,0.3299,0.3,0.272
"7340","110097",2002,656,414,242,345,108,237,57.25,0.5725,0.526,0.446
"7341","110404",2002,252,73,179,203,138,65,89.04,0.8904,0.806,0.771
"7342","110422",2002,2565,1158,1407,587,209,378,32.64,0.3264,0.229,0.149
"7343","110486",2002,679,408,271,99,28,71,17.4,0.174,0.146,0.103
"7344","110495",2002,550,360,190,116,20,96,26.67,0.2667,0.211,0.105
"7345","110510",2002,1161,751,410,142,32,110,14.65,0.1465,0.122,0.078
"7346","110529",2002,2674,1080,1594,345,161,184,17.04,0.1704,0.129,0.101
"7347","110538",2002,1995,1125,870,372,95,277,24.62,0.2462,0.186,0.109
"7348","110547",2002,630,466,164,28,6,22,4.72,0.0472,0.044,0.037
"7349","110556",2002,2189,1274,915,346,109,237,18.6,0.186,0.158,0.119
"7350","110565",2002,3291,2039,1252,481,111,370,18.15,0.1815,0.146,0.089
"7351","110574",2002,746,473,273,119,43,76,16.07,0.1607,0.16,0.158
"7352","110583",2002,2912,1871,1041,365,91,274,14.64,0.1464,0.125,0.087
"7353","110592",2002,1404,906,498,116,34,82,9.05,0.0905,0.083,0.068
"7354","110617",2002,2378,1395,983,221,56,165,11.83,0.1183,0.093,0.057
"7355","113698",2002,202,145,57,75,19,56,38.62,0.3862,0.371,0.333
"7356","115755",2002,836,505,331,97,28,69,13.66,0.1366,0.116,0.085
"7357","119173",2002,127,123,4,64,1,63,51.22,0.5122,0.504,0.25
"7358","120184",2002,97,57,40,42,12,30,52.63,0.5263,0.433,0.3
"7359","121309",2002,535,324,211,321,111,210,64.81,0.6481,0.6,0.526
"7360","121345",2002,374,191,183,338,158,180,94.24,0.9424,0.904,0.863
"7361","122409",2002,3662,2217,1445,879,237,642,28.96,0.2896,0.24,0.164
"7362","122436",2002,1049,681,368,672,219,453,66.52,0.6652,0.641,0.595
"7363","122597",2002,2130,1378,752,211,52,159,11.54,0.1154,0.099,0.069
"7364","122612",2002,839,582,257,431,132,299,51.37,0.5137,0.514,0.514
"7365","122931",2002,1116,659,457,873,342,531,80.58,0.8058,0.782,0.748
"7366","123554",2002,663,408,255,381,141,240,58.82,0.5882,0.575,0.553
"7367","123572",2002,1210,816,394,289,53,236,28.92,0.2892,0.239,0.135
"7368","126562",2002,580,326,254,86,26,60,18.4,0.184,0.148,0.102
"7369","126580",2002,834,501,333,211,66,145,28.94,0.2894,0.253,0.198
"7370","126614",2002,5377,2607,2770,2218,1001,1217,46.68,0.4668,0.412,0.361
"7371","126818",2002,3783,2121,1662,1340,442,898,42.34,0.4234,0.354,0.266
"7372","127060",2002,988,527,461,571,235,336,63.76,0.6376,0.578,0.51
"7373","127185",2002,1035,467,568,147,59,88,18.84,0.1884,0.142,0.104
"7374","127565",2002,1655,852,803,73,25,48,5.63,0.0563,0.044,0.031
"7375","127741",2002,1938,1253,685,548,116,432,34.48,0.3448,0.283,0.169
"7376","128106",2002,642,329,313,105,39,66,20.06,0.2006,0.164,0.125
"7377","128744",2002,234,144,90,66,23,43,29.86,0.2986,0.282,0.256
"7378","128771",2002,1473,735,738,192,61,131,17.82,0.1782,0.13,0.083
"7379","129020",2002,3157,1722,1435,1766,674,1092,63.41,0.6341,0.559,0.47
"7380","129242",2002,813,461,352,609,240,369,80.04,0.8004,0.749,0.682
"7381","129941",2002,529,240,289,166,67,99,41.25,0.4125,0.314,0.232
"7382","130253",2002,797,457,340,445,171,274,59.96,0.5996,0.558,0.503
"7383","130314",2002,201,201,0,69,0,69,34.33,0.3433,0.343,NA
"7384","130493",2002,1276,719,557,144,46,98,13.63,0.1363,0.113,0.083
"7385","130590",2002,548,286,262,445,207,238,83.22,0.8322,0.812,0.79
"7386","130697",2002,716,377,339,634,288,346,91.78,0.9178,0.885,0.85
"7387","130776",2002,794,434,360,113,32,81,18.66,0.1866,0.142,0.089
"7388","130794",2002,1299,643,656,1164,576,588,91.45,0.9145,0.896,0.878
"7389","130934",2002,761,439,322,1,0,1,0.23,0.0023,0.001,0
"7390","130943",2002,3712,2222,1490,2282,777,1505,67.73,0.6773,0.615,0.521
"7391","131159",2002,1303,811,492,917,329,588,72.5,0.725,0.704,0.669
"7392","131283",2002,700,406,294,438,170,268,66.01,0.6601,0.626,0.578
"7393","131450",2002,235,122,113,12,6,6,4.92,0.0492,0.051,0.053
"7394","131469",2002,2283,1359,924,1735,660,1075,79.1,0.791,0.76,0.714
"7395","131496",2002,1477,795,682,1324,608,716,90.06,0.9006,0.896,0.891
"7396","131520",2002,1366,931,435,621,125,496,53.28,0.5328,0.455,0.287
"7397","132471",2002,446,273,173,110,34,76,27.84,0.2784,0.247,0.197
"7398","132602",2002,607,351,256,161,59,102,29.06,0.2906,0.265,0.23
"7399","132903",2002,5330,2851,2479,1736,578,1158,40.62,0.4062,0.326,0.233
"7400","133492",2002,442,239,203,261,117,144,60.25,0.6025,0.59,0.576
"7401","133553",2002,872,148,724,315,244,71,47.97,0.4797,0.361,0.337
"7402","133650",2002,2097,1249,848,280,77,203,16.25,0.1625,0.134,0.091
"7403","133669",2002,1994,1102,892,323,115,208,18.87,0.1887,0.162,0.129
"7404","133711",2002,481,308,173,231,70,161,52.27,0.5227,0.48,0.405
"7405","133881",2002,518,139,379,218,142,76,54.68,0.5468,0.421,0.375
"7406","133951",2002,2801,1617,1184,566,176,390,24.12,0.2412,0.202,0.149
"7407","134079",2002,491,322,169,184,41,143,44.41,0.4441,0.375,0.243
"7408","134097",2002,6258,3742,2516,2927,959,1968,52.59,0.5259,0.468,0.381
"7409","134130",2002,6406,3674,2732,3586,1215,2371,64.53,0.6453,0.56,0.445
"7410","134945",2002,389,165,224,105,52,53,32.12,0.3212,0.27,0.232
"7411","135726",2002,2046,1197,849,1311,497,814,68,0.68,0.641,0.585
"7412","136172",2002,1865,1067,798,395,129,266,24.93,0.2493,0.212,0.162
"7413","136950",2002,466,280,186,278,97,181,64.64,0.6464,0.597,0.522
"7414","137546",2002,542,325,217,299,104,195,60,0.6,0.552,0.479
"7415","138354",2002,760,443,317,172,52,120,27.09,0.2709,0.226,0.164
"7416","138716",2002,470,300,170,88,22,66,22,0.22,0.187,0.129
"7417","138789",2002,581,350,231,48,13,35,10,0.1,0.083,0.056
"7418","139144",2002,565,353,212,276,94,182,51.56,0.5156,0.488,0.443
"7419","139366",2002,943,548,395,91,18,73,13.32,0.1332,0.097,0.046
"7420","139393",2002,231,141,90,129,44,85,60.28,0.6028,0.558,0.489
"7421","139658",2002,1558,903,655,1061,444,617,68.33,0.6833,0.681,0.678
"7422","139719",2002,386,192,194,59,12,47,24.48,0.2448,0.153,0.062
"7423","139755",2002,2275,636,1639,711,445,266,41.82,0.4182,0.313,0.272
"7424","139764",2002,331,216,115,46,15,31,14.35,0.1435,0.139,0.13
"7425","139861",2002,984,612,372,199,45,154,25.16,0.2516,0.202,0.121
"7426","139931",2002,2597,1232,1365,434,138,296,24.03,0.2403,0.167,0.101
"7427","139940",2002,2469,1419,1050,423,107,316,22.27,0.2227,0.171,0.102
"7428","139959",2002,4282,2570,1712,2155,713,1442,56.11,0.5611,0.503,0.416
"7429","140447",2002,687,387,300,275,93,182,47.03,0.4703,0.4,0.31
"7430","140960",2002,496,269,227,52,7,45,16.73,0.1673,0.105,0.031
"7431","140988",2002,218,144,74,80,23,57,39.58,0.3958,0.367,0.311
"7432","141185",2002,175,106,69,88,37,51,48.11,0.4811,0.503,0.536
"7433","141264",2002,1584,973,611,239,54,185,19.01,0.1901,0.151,0.088
"7434","141334",2002,1617,921,696,181,41,140,15.2,0.152,0.112,0.059
"7435","141486",2002,212,154,58,23,8,15,9.74,0.0974,0.108,0.138
"7436","141565",2002,404,238,166,57,17,40,16.81,0.1681,0.141,0.102
"7437","141574",2002,1726,970,756,251,74,177,18.25,0.1825,0.145,0.098
"7438","142276",2002,704,474,230,59,5,54,11.39,0.1139,0.084,0.022
"7439","142285",2002,1619,784,835,371,153,218,27.81,0.2781,0.229,0.183
"7440","142461",2002,276,169,107,87,38,49,28.99,0.2899,0.315,0.355
"7441","143084",2002,601,349,252,417,158,259,74.21,0.7421,0.694,0.627
"7442","143288",2002,147,75,72,44,16,28,37.33,0.3733,0.299,0.222
"7443","144005",2002,438,302,136,11,2,9,2.98,0.0298,0.025,0.015
"7444","144281",2002,1589,854,735,401,164,237,27.75,0.2775,0.252,0.223
"7445","144740",2002,2231,1323,908,985,346,639,48.3,0.483,0.442,0.381
"7446","144892",2002,1984,1143,841,582,183,399,34.91,0.3491,0.293,0.218
"7447","144962",2002,295,185,110,157,41,116,62.7,0.627,0.532,0.373
"7448","144971",2002,136,70,66,50,16,34,48.57,0.4857,0.368,0.242
"7449","145600",2002,2952,1674,1278,607,248,359,21.45,0.2145,0.206,0.194
"7450","145619",2002,303,165,138,150,56,94,56.97,0.5697,0.495,0.406
"7451","145637",2002,6354,3120,3234,4027,1814,2213,70.93,0.7093,0.634,0.561
"7452","145691",2002,306,170,136,156,60,96,56.47,0.5647,0.51,0.441
"7453","145813",2002,3097,1933,1164,1279,366,913,47.23,0.4723,0.413,0.314
"7454","146481",2002,358,219,139,213,71,142,64.84,0.6484,0.595,0.511
"7455","146612",2002,366,161,205,132,66,66,40.99,0.4099,0.361,0.322
"7456","146719",2002,1623,1069,554,821,261,560,52.39,0.5239,0.506,0.471
"7457","146825",2002,127,72,55,46,14,32,44.44,0.4444,0.362,0.255
"7458","147013",2002,258,135,123,127,48,79,58.52,0.5852,0.492,0.39
"7459","147244",2002,634,351,283,335,117,218,62.11,0.6211,0.528,0.413
"7460","147341",2002,282,147,135,150,61,89,60.54,0.6054,0.532,0.452
"7461","147703",2002,3015,1585,1430,698,283,415,26.18,0.2618,0.232,0.198
"7462","147767",2002,2000,1075,925,1725,759,966,89.86,0.8986,0.863,0.821
"7463","147776",2002,977,589,388,27,9,18,3.06,0.0306,0.028,0.023
"7464","147828",2002,553,328,225,274,95,179,54.57,0.5457,0.495,0.422
"7465","148131",2002,229,112,117,88,33,55,49.11,0.4911,0.384,0.282
"7466","148496",2002,192,123,69,111,29,82,66.67,0.6667,0.578,0.42
"7467","148584",2002,149,86,63,49,17,32,37.21,0.3721,0.329,0.27
"7468","148627",2002,375,262,113,89,24,65,24.81,0.2481,0.237,0.212
"7469","149222",2002,2395,1037,1358,550,262,288,27.77,0.2777,0.23,0.193
"7470","149231",2002,1629,866,763,356,126,230,26.56,0.2656,0.219,0.165
"7471","149772",2002,1917,941,976,619,280,339,36.03,0.3603,0.323,0.287
"7472","149781",2002,569,286,283,447,213,234,81.82,0.8182,0.786,0.753
"7473","150066",2002,591,335,256,225,72,153,45.67,0.4567,0.381,0.281
"7474","150136",2002,4010,2207,1803,1327,507,820,37.15,0.3715,0.331,0.281
"7475","150145",2002,253,143,110,108,34,74,51.75,0.5175,0.427,0.309
"7476","150163",2002,936,595,341,485,157,328,55.13,0.5513,0.518,0.46
"7477","150400",2002,685,369,316,566,259,307,83.2,0.832,0.826,0.82
"7478","150534",2002,600,369,231,289,100,189,51.22,0.5122,0.482,0.433
"7479","150668",2002,133,81,52,74,28,46,56.79,0.5679,0.556,0.538
"7480","150941",2002,236,145,91,110,40,70,48.28,0.4828,0.466,0.44
"7481","151102",2002,1409,782,627,61,24,37,4.73,0.0473,0.043,0.038
"7482","151111",2002,2235,1286,949,195,63,132,10.26,0.1026,0.087,0.066
"7483","151306",2002,1891,1152,739,217,50,167,14.5,0.145,0.115,0.068
"7484","151324",2002,2083,1065,1018,393,143,250,23.47,0.2347,0.189,0.14
"7485","151333",2002,339,226,113,28,5,23,10.18,0.1018,0.083,0.044
"7486","151342",2002,660,390,270,36,9,27,6.92,0.0692,0.055,0.033
"7487","151351",2002,6987,3895,3092,3546,1471,2075,53.27,0.5327,0.508,0.476
"7488","151360",2002,602,365,237,39,14,25,6.85,0.0685,0.065,0.059
"7489","151379",2002,678,419,259,53,11,42,10.02,0.1002,0.078,0.042
"7490","151388",2002,303,200,103,19,4,15,7.5,0.075,0.063,0.039
"7491","151777",2002,309,178,131,137,54,83,46.63,0.4663,0.443,0.412
"7492","151786",2002,230,153,77,73,16,57,37.25,0.3725,0.317,0.208
"7493","152080",2002,1945,935,1010,1765,909,856,91.55,0.9155,0.907,0.9
"7494","152248",2002,927,474,453,36,16,20,4.22,0.0422,0.039,0.035
"7495","152363",2002,276,155,121,108,34,74,47.74,0.4774,0.391,0.281
"7496","152530",2002,452,244,208,322,142,180,73.77,0.7377,0.712,0.683
"7497","152600",2002,715,365,350,454,197,257,70.41,0.7041,0.635,0.563
"7498","153001",2002,356,192,164,184,79,105,54.69,0.5469,0.517,0.482
"7499","153108",2002,425,234,191,263,103,160,68.38,0.6838,0.619,0.539
"7500","153269",2002,775,459,316,360,148,212,46.19,0.4619,0.465,0.468
"7501","153384",2002,368,202,166,297,132,165,81.68,0.8168,0.807,0.795
"7502","153603",2002,4167,1915,2252,1399,566,833,43.5,0.435,0.336,0.251
"7503","153834",2002,608,365,243,371,135,236,64.66,0.6466,0.61,0.556
"7504","154095",2002,1821,1139,682,610,194,416,36.52,0.3652,0.335,0.284
"7505","155089",2002,203,121,82,35,15,20,16.53,0.1653,0.172,0.183
"7506","155317",2002,4013,2181,1832,1227,477,750,34.39,0.3439,0.306,0.26
"7507","155335",2002,143,79,64,37,17,20,25.32,0.2532,0.259,0.266
"7508","155399",2002,3338,1652,1686,828,278,550,33.29,0.3329,0.248,0.165
"7509","155520",2002,306,156,150,128,46,82,52.56,0.5256,0.418,0.307
"7510","155627",2002,112,35,77,32,15,17,48.57,0.4857,0.286,0.195
"7511","155937",2002,98,50,48,43,14,29,58,0.58,0.439,0.292
"7512","156213",2002,323,200,123,195,80,115,57.5,0.575,0.604,0.65
"7513","156286",2002,325,214,111,165,46,119,55.61,0.5561,0.508,0.414
"7514","156295",2002,356,206,150,158,61,97,47.09,0.4709,0.444,0.407
"7515","156365",2002,288,138,150,61,18,43,31.16,0.3116,0.212,0.12
"7516","156541",2002,386,209,177,93,31,62,29.67,0.2967,0.241,0.175
"7517","156745",2002,328,199,129,150,53,97,48.74,0.4874,0.457,0.411
"7518","157058",2002,373,203,170,34,6,28,13.79,0.1379,0.091,0.035
"7519","157076",2002,150,77,73,44,13,31,40.26,0.4026,0.293,0.178
"7520","157085",2002,3701,1999,1702,1045,362,683,34.17,0.3417,0.282,0.213
"7521","157289",2002,2209,1153,1056,428,157,271,23.5,0.235,0.194,0.149
"7522","157386",2002,1563,882,681,172,59,113,12.81,0.1281,0.11,0.087
"7523","157401",2002,1467,879,588,439,130,309,35.15,0.3515,0.299,0.221
"7524","157447",2002,1907,1084,823,185,66,119,10.98,0.1098,0.097,0.08
"7525","157535",2002,226,129,97,40,9,31,24.03,0.2403,0.177,0.093
"7526","157951",2002,2954,1714,1240,513,136,377,22,0.22,0.174,0.11
"7527","158477",2002,272,163,109,122,42,80,49.08,0.4908,0.449,0.385
"7528","159009",2002,850,430,420,107,44,63,14.65,0.1465,0.126,0.105
"7529","159391",2002,5170,2842,2328,1353,464,889,31.28,0.3128,0.262,0.199
"7530","159647",2002,1936,947,989,500,202,298,31.47,0.3147,0.258,0.204
"7531","159717",2002,1358,762,596,179,67,112,14.7,0.147,0.132,0.112
"7532","159966",2002,1404,821,583,120,27,93,11.33,0.1133,0.085,0.046
"7533","160038",2002,1875,1093,782,216,80,136,12.44,0.1244,0.115,0.102
"7534","160612",2002,2382,1370,1012,168,49,119,8.69,0.0869,0.071,0.048
"7535","160621",2002,1176,673,503,77,14,63,9.36,0.0936,0.065,0.028
"7536","160658",2002,2385,1326,1059,293,77,216,16.29,0.1629,0.123,0.073
"7537","161004",2002,457,237,220,384,196,188,79.32,0.7932,0.84,0.891
"7538","161226",2002,453,295,158,156,40,116,39.32,0.3932,0.344,0.253
"7539","161235",2002,130,61,69,30,15,15,24.59,0.2459,0.231,0.217
"7540","161244",2002,132,81,51,19,9,10,12.35,0.1235,0.144,0.176
"7541","161253",2002,1651,808,843,554,246,308,38.12,0.3812,0.336,0.292
"7542","161554",2002,895,519,376,118,39,79,15.22,0.1522,0.132,0.104
"7543","162007",2002,566,352,214,102,24,78,22.16,0.2216,0.18,0.112
"7544","162210",2002,176,104,72,17,2,15,14.42,0.1442,0.097,0.028
"7545","162283",2002,578,430,148,30,3,27,6.28,0.0628,0.052,0.02
"7546","162584",2002,999,492,507,220,67,153,31.1,0.311,0.22,0.132
"7547","162654",2002,365,265,100,208,48,160,60.38,0.6038,0.57,0.48
"7548","162760",2002,179,172,7,108,3,105,61.05,0.6105,0.603,0.429
"7549","162928",2002,1203,539,664,960,501,459,85.16,0.8516,0.798,0.755
"7550","163046",2002,901,527,374,733,295,438,83.11,0.8311,0.814,0.789
"7551","163268",2002,1356,572,784,437,210,227,39.69,0.3969,0.322,0.268
"7552","163286",2002,3886,1961,1925,2452,1128,1324,67.52,0.6752,0.631,0.586
"7553","163453",2002,1247,741,506,139,26,113,15.25,0.1525,0.111,0.051
"7554","163462",2002,399,211,188,233,97,136,64.45,0.6445,0.584,0.516
"7555","163851",2002,908,529,379,417,121,296,55.95,0.5595,0.459,0.319
"7556","163912",2002,425,243,182,286,113,173,71.19,0.7119,0.673,0.621
"7557","164076",2002,2198,1385,813,815,229,586,42.31,0.4231,0.371,0.282
"7558","164173",2002,487,365,122,281,63,218,59.73,0.5973,0.577,0.516
"7559","164216",2002,368,243,125,276,88,188,77.37,0.7737,0.75,0.704
"7560","164270",2002,440,253,187,307,124,183,72.33,0.7233,0.698,0.663
"7561","164447",2002,256,117,139,55,21,34,29.06,0.2906,0.215,0.151
"7562","164492",2002,159,108,51,82,29,53,49.07,0.4907,0.516,0.569
"7563","164562",2002,618,381,237,451,168,283,74.28,0.7428,0.73,0.709
"7564","165015",2002,837,456,381,708,316,392,85.96,0.8596,0.846,0.829
"7565","165024",2002,1272,769,503,277,72,205,26.66,0.2666,0.218,0.143
"7566","165334",2002,576,357,219,387,148,239,66.95,0.6695,0.672,0.676
"7567","165662",2002,656,419,237,473,179,294,70.17,0.7017,0.721,0.755
"7568","165671",2002,322,258,64,179,31,148,57.36,0.5736,0.556,0.484
"7569","165820",2002,496,292,204,119,41,78,26.71,0.2671,0.24,0.201
"7570","165866",2002,716,500,216,193,38,155,31,0.31,0.27,0.176
"7571","165936",2002,400,266,134,248,77,171,64.29,0.6429,0.62,0.575
"7572","166027",2002,1619,783,836,1422,710,712,90.93,0.9093,0.878,0.849
"7573","166124",2002,669,348,321,644,300,344,98.85,0.9885,0.963,0.935
"7574","166513",2002,1013,371,642,289,138,151,40.7,0.407,0.285,0.215
"7575","166629",2002,3411,1799,1612,1682,707,975,54.2,0.542,0.493,0.439
"7576","166638",2002,534,307,227,64,16,48,15.64,0.1564,0.12,0.07
"7577","166683",2002,977,420,557,806,446,360,85.71,0.8571,0.825,0.801
"7578","167288",2002,265,159,106,106,38,68,42.77,0.4277,0.4,0.358
"7579","167987",2002,1699,825,874,452,191,261,31.64,0.3164,0.266,0.219
"7580","167996",2002,566,342,224,448,160,288,84.21,0.8421,0.792,0.714
"7581","168005",2002,787,481,306,307,88,219,45.53,0.4553,0.39,0.288
"7582","168148",2002,1276,736,540,1094,455,639,86.82,0.8682,0.857,0.843
"7583","168254",2002,682,301,381,298,151,147,48.84,0.4884,0.437,0.396
"7584","168281",2002,411,255,156,316,106,210,82.35,0.8235,0.769,0.679
"7585","168342",2002,539,291,248,492,226,266,91.41,0.9141,0.913,0.911
"7586","168546",2002,525,293,232,330,129,201,68.6,0.686,0.629,0.556
"7587","168786",2002,346,216,130,85,25,60,27.78,0.2778,0.246,0.192
"7588","169080",2002,1045,577,468,586,228,358,62.05,0.6205,0.561,0.487
"7589","169798",2002,2601,1564,1037,272,91,181,11.57,0.1157,0.105,0.088
"7590","169910",2002,2035,882,1153,138,67,71,8.05,0.0805,0.068,0.058
"7591","170082",2002,2868,1801,1067,634,188,446,24.76,0.2476,0.221,0.176
"7592","170301",2002,725,465,260,457,139,318,68.39,0.6839,0.63,0.535
"7593","170532",2002,335,177,158,239,105,134,75.71,0.7571,0.713,0.665
"7594","170639",2002,574,262,312,53,29,24,9.16,0.0916,0.092,0.093
"7595","170976",2002,5180,2704,2476,3641,1634,2007,74.22,0.7422,0.703,0.66
"7596","171100",2002,6829,3864,2965,3127,1133,1994,51.6,0.516,0.458,0.382
"7597","171128",2002,1186,267,919,306,210,96,35.96,0.3596,0.258,0.229
"7598","171137",2002,735,342,393,105,48,57,16.67,0.1667,0.143,0.122
"7599","171146",2002,467,269,198,52,16,36,13.38,0.1338,0.111,0.081
"7600","171599",2002,238,85,153,82,42,40,47.06,0.4706,0.345,0.275
"7601","172051",2002,1109,654,455,97,27,70,10.7,0.107,0.087,0.059
"7602","172699",2002,4442,2318,2124,941,381,560,24.16,0.2416,0.212,0.179
"7603","173160",2002,567,348,219,370,125,245,70.4,0.704,0.653,0.571
"7604","173258",2002,499,264,235,447,203,244,92.42,0.9242,0.896,0.864
"7605","173328",2002,175,89,86,57,19,38,42.7,0.427,0.326,0.221
"7606","173647",2002,645,383,262,521,216,305,79.63,0.7963,0.808,0.824
"7607","173902",2002,440,241,199,370,169,201,83.4,0.834,0.841,0.849
"7608","174066",2002,5162,2762,2400,2118,869,1249,45.22,0.4522,0.41,0.362
"7609","174233",2002,2025,1029,996,476,183,293,28.47,0.2847,0.235,0.184
"7610","174251",2002,475,309,166,219,71,148,47.9,0.479,0.461,0.428
"7611","174491",2002,431,267,164,183,75,108,40.45,0.4045,0.425,0.457
"7612","174792",2002,468,0,468,340,340,0,NA,NA,0.726,0.726
"7613","174844",2002,777,479,298,645,235,410,85.59,0.8559,0.83,0.789
"7614","174899",2002,382,286,96,218,43,175,61.19,0.6119,0.571,0.448
"7615","174914",2002,1095,577,518,629,280,349,60.49,0.6049,0.574,0.541
"7616","175342",2002,423,249,174,86,23,63,25.3,0.253,0.203,0.132
"7617","175421",2002,266,150,116,68,19,49,32.67,0.3267,0.256,0.164
"7618","175616",2002,336,200,136,58,13,45,22.5,0.225,0.173,0.096
"7619","175856",2002,1014,581,433,206,49,157,27.02,0.2702,0.203,0.113
"7620","175980",2002,251,125,126,159,75,84,67.2,0.672,0.633,0.595
"7621","176017",2002,2230,1150,1080,724,271,453,39.39,0.3939,0.325,0.251
"7622","176035",2002,250,223,27,61,2,59,26.46,0.2646,0.244,0.074
"7623","176044",2002,269,129,140,37,14,23,17.83,0.1783,0.138,0.1
"7624","176080",2002,1737,833,904,476,181,295,35.41,0.3541,0.274,0.2
"7625","176406",2002,209,149,60,55,12,43,28.86,0.2886,0.263,0.2
"7626","176628",2002,129,70,59,29,5,24,34.29,0.3429,0.225,0.085
"7627","176947",2002,232,100,132,61,16,45,45,0.45,0.263,0.121
"7628","176965",2002,1248,668,580,306,106,200,29.94,0.2994,0.245,0.183
"7629","177418",2002,183,134,49,76,16,60,44.78,0.4478,0.415,0.327
"7630","178059",2002,279,194,85,132,46,86,44.33,0.4433,0.473,0.541
"7631","178341",2002,614,334,280,78,27,51,15.27,0.1527,0.127,0.096
"7632","178387",2002,1131,655,476,134,52,82,12.52,0.1252,0.118,0.109
"7633","178396",2002,4379,2284,2095,1813,669,1144,50.09,0.5009,0.414,0.319
"7634","178402",2002,747,454,293,128,41,87,19.16,0.1916,0.171,0.14
"7635","178411",2002,785,150,635,175,128,47,31.33,0.3133,0.223,0.202
"7636","178420",2002,426,234,192,96,29,67,28.63,0.2863,0.225,0.151
"7637","178615",2002,1441,872,569,654,227,427,48.97,0.4897,0.454,0.399
"7638","179043",2002,214,133,81,119,44,75,56.39,0.5639,0.556,0.543
"7639","179159",2002,1409,762,647,867,366,501,65.75,0.6575,0.615,0.566
"7640","179557",2002,1457,858,599,361,105,256,29.84,0.2984,0.248,0.175
"7641","179566",2002,2702,1609,1093,720,205,515,32.01,0.3201,0.266,0.188
"7642","179867",2002,1329,699,630,1127,513,614,87.84,0.8784,0.848,0.814
"7643","179894",2002,385,226,159,178,67,111,49.12,0.4912,0.462,0.421
"7644","179946",2002,207,93,114,100,48,52,55.91,0.5591,0.483,0.421
"7645","180179",2002,542,357,185,48,9,39,10.92,0.1092,0.089,0.049
"7646","180461",2002,1924,833,1091,307,130,177,21.25,0.2125,0.16,0.119
"7647","180522",2002,185,87,98,23,13,10,11.49,0.1149,0.124,0.133
"7648","180984",2002,319,175,144,130,41,89,50.86,0.5086,0.408,0.285
"7649","181002",2002,802,488,314,534,191,343,70.29,0.7029,0.666,0.608
"7650","181020",2002,273,142,131,178,84,94,66.2,0.662,0.652,0.641
"7651","181127",2002,276,132,144,148,57,91,68.94,0.6894,0.536,0.396
"7652","181215",2002,1022,574,448,216,69,147,25.61,0.2561,0.211,0.154
"7653","181394",2002,1601,851,750,199,77,122,14.34,0.1434,0.124,0.103
"7654","181446",2002,336,187,149,157,70,87,46.52,0.4652,0.467,0.47
"7655","181464",2002,3615,1878,1737,919,358,561,29.87,0.2987,0.254,0.206
"7656","181534",2002,171,85,86,29,10,19,22.35,0.2235,0.17,0.116
"7657","181783",2002,602,325,277,155,66,89,27.38,0.2738,0.257,0.238
"7658","182281",2002,2383,1373,1010,293,80,213,15.51,0.1551,0.123,0.079
"7659","182290",2002,2066,1137,929,308,102,206,18.12,0.1812,0.149,0.11
"7660","182634",2002,270,172,98,133,54,79,45.93,0.4593,0.493,0.551
"7661","182795",2002,505,252,253,197,88,109,43.25,0.4325,0.39,0.348
"7662","183062",2002,1170,668,502,333,119,214,32.04,0.3204,0.285,0.237
"7663","183080",2002,940,447,493,279,120,159,35.57,0.3557,0.297,0.243
"7664","183239",2002,570,330,240,406,148,258,78.18,0.7818,0.712,0.617
"7665","183822",2002,339,216,123,57,15,42,19.44,0.1944,0.168,0.122
"7666","183974",2002,236,147,89,97,27,70,47.62,0.4762,0.411,0.303
"7667","184348",2002,396,231,165,281,110,171,74.03,0.7403,0.71,0.667
"7668","184603",2002,474,281,193,87,34,53,18.86,0.1886,0.184,0.176
"7669","184612",2002,208,151,57,45,8,37,24.5,0.245,0.216,0.14
"7670","184782",2002,1257,637,620,542,224,318,49.92,0.4992,0.431,0.361
"7671","185129",2002,566,293,273,34,9,25,8.53,0.0853,0.06,0.033
"7672","185572",2002,948,521,427,351,116,235,45.11,0.4511,0.37,0.272
"7673","185590",2002,1470,881,589,410,117,293,33.26,0.3326,0.279,0.199
"7674","185828",2002,658,113,545,106,81,25,22.12,0.2212,0.161,0.149
"7675","186131",2002,1164,557,607,1049,542,507,91.02,0.9102,0.901,0.893
"7676","186201",2002,684,420,264,363,109,254,60.48,0.6048,0.531,0.413
"7677","186283",2002,958,542,416,439,173,266,49.08,0.4908,0.458,0.416
"7678","186584",2002,1157,607,550,523,232,291,47.94,0.4794,0.452,0.422
"7679","186876",2002,794,436,358,338,131,207,47.48,0.4748,0.426,0.366
"7680","187134",2002,1231,738,493,834,288,546,73.98,0.7398,0.677,0.584
"7681","187444",2002,1286,715,571,208,59,149,20.84,0.2084,0.162,0.103
"7682","187985",2002,2758,1565,1193,314,100,214,13.67,0.1367,0.114,0.084
"7683","188030",2002,1977,1111,866,257,78,179,16.11,0.1611,0.13,0.09
"7684","188429",2002,666,463,203,373,97,276,59.61,0.5961,0.56,0.478
"7685","188641",2002,474,223,251,247,111,136,60.99,0.6099,0.521,0.442
"7686","190044",2002,723,164,559,391,296,95,57.93,0.5793,0.541,0.53
"7687","190099",2002,728,386,342,629,292,337,87.31,0.8731,0.864,0.854
"7688","190150",2002,1386,636,750,1168,630,538,84.59,0.8459,0.843,0.84
"7689","190248",2002,135,75,60,43,16,27,36,0.36,0.319,0.267
"7690","190415",2002,2999,1530,1469,2605,1253,1352,88.37,0.8837,0.869,0.853
"7691","190512",2002,1654,830,824,554,217,337,40.6,0.406,0.335,0.263
"7692","190549",2002,1194,679,515,235,78,157,23.12,0.2312,0.197,0.151
"7693","190558",2002,1743,905,838,66,25,41,4.53,0.0453,0.038,0.03
"7694","190567",2002,961,435,526,65,28,37,8.51,0.0851,0.068,0.053
"7695","190594",2002,1445,1010,435,256,50,206,20.4,0.204,0.177,0.115
"7696","190637",2002,729,485,244,73,21,52,10.72,0.1072,0.1,0.086
"7697","190664",2002,1178,693,485,325,90,235,33.91,0.3391,0.276,0.186
"7698","190691",2002,563,385,178,34,8,26,6.75,0.0675,0.06,0.045
"7699","190725",2002,316,246,70,84,16,68,27.64,0.2764,0.266,0.229
"7700","191241",2002,1694,1020,674,1263,478,785,76.96,0.7696,0.746,0.709
"7701","191515",2002,492,252,240,418,195,223,88.49,0.8849,0.85,0.812
"7702","191533",2002,375,224,151,165,56,109,48.66,0.4866,0.44,0.371
"7703","191630",2002,532,283,249,367,151,216,76.33,0.7633,0.69,0.606
"7704","191649",2002,1764,912,852,693,254,439,48.14,0.4814,0.393,0.298
"7705","191676",2002,289,201,88,187,54,133,66.17,0.6617,0.647,0.614
"7706","191931",2002,731,379,352,337,123,214,56.46,0.5646,0.461,0.349
"7707","191968",2002,1515,896,619,1083,441,642,71.65,0.7165,0.715,0.712
"7708","192192",2002,195,138,57,81,21,60,43.48,0.4348,0.415,0.368
"7709","192323",2002,561,333,228,388,144,244,73.27,0.7327,0.692,0.632
"7710","192439",2002,776,561,215,48,9,39,6.95,0.0695,0.062,0.042
"7711","192703",2002,769,401,368,501,228,273,68.08,0.6808,0.651,0.62
"7712","192749",2002,420,287,133,212,50,162,56.45,0.5645,0.505,0.376
"7713","192819",2002,956,576,380,693,252,441,76.56,0.7656,0.725,0.663
"7714","192925",2002,308,204,104,69,25,44,21.57,0.2157,0.224,0.24
"7715","193016",2002,680,425,255,69,14,55,12.94,0.1294,0.101,0.055
"7716","193292",2002,229,168,61,77,19,58,34.52,0.3452,0.336,0.311
"7717","193353",2002,361,261,100,151,33,118,45.21,0.4521,0.418,0.33
"7718","193399",2002,326,239,87,128,21,107,44.77,0.4477,0.393,0.241
"7719","193584",2002,385,292,93,230,49,181,61.99,0.6199,0.597,0.527
"7720","193645",2002,850,733,117,151,12,139,18.96,0.1896,0.178,0.103
"7721","193654",2002,605,415,190,328,89,239,57.59,0.5759,0.542,0.468
"7722","193900",2002,4126,2577,1549,2564,963,1601,62.13,0.6213,0.621,0.622
"7723","193973",2002,735,440,295,409,148,261,59.32,0.5932,0.556,0.502
"7724","194161",2002,295,183,112,109,40,69,37.7,0.377,0.369,0.357
"7725","194310",2002,1508,916,592,592,190,402,43.89,0.4389,0.393,0.321
"7726","194824",2002,1047,263,784,672,490,182,69.2,0.692,0.642,0.625
"7727","195003",2002,2327,614,1713,563,299,264,43,0.43,0.242,0.175
"7728","195030",2002,1055,492,563,776,392,384,78.05,0.7805,0.736,0.696
"7729","195164",2002,584,295,289,300,136,164,55.59,0.5559,0.514,0.471
"7730","195173",2002,454,238,216,153,61,92,38.66,0.3866,0.337,0.282
"7731","195216",2002,615,316,299,443,197,246,77.85,0.7785,0.72,0.659
"7732","195234",2002,526,391,135,303,65,238,60.87,0.6087,0.576,0.481
"7733","195243",2002,329,191,138,130,38,92,48.17,0.4817,0.395,0.275
"7734","195304",2002,323,249,74,205,56,149,59.84,0.5984,0.635,0.757
"7735","195474",2002,677,405,272,497,185,312,77.04,0.7704,0.734,0.68
"7736","195526",2002,634,383,251,494,191,303,79.11,0.7911,0.779,0.761
"7737","195544",2002,109,92,17,78,11,67,72.83,0.7283,0.716,0.647
"7738","195809",2002,2954,1736,1218,1001,347,654,37.67,0.3767,0.339,0.285
"7739","196413",2002,2894,1676,1218,2021,793,1228,73.27,0.7327,0.698,0.651
"7740","196592",2002,1877,1306,571,159,40,119,9.11,0.0911,0.085,0.07
"7741","197045",2002,451,226,225,180,73,107,47.35,0.4735,0.399,0.324
"7742","197133",2002,632,377,255,552,217,335,88.86,0.8886,0.873,0.851
"7743","197869",2002,2412,1261,1151,964,385,579,45.92,0.4592,0.4,0.334
"7744","197984",2002,223,136,87,64,20,44,32.35,0.3235,0.287,0.23
"7745","198385",2002,468,243,225,430,201,229,94.24,0.9424,0.919,0.893
"7746","198464",2002,3561,2117,1444,968,294,674,31.84,0.3184,0.272,0.204
"7747","198507",2002,458,270,188,108,16,92,34.07,0.3407,0.236,0.085
"7748","198516",2002,1192,736,456,856,308,548,74.46,0.7446,0.718,0.675
"7749","198835",2002,319,161,158,145,69,76,47.2,0.472,0.455,0.437
"7750","198969",2002,395,118,277,58,20,38,32.2,0.322,0.147,0.072
"7751","199102",2002,2025,1043,982,299,90,209,20.04,0.2004,0.148,0.092
"7752","199111",2002,421,250,171,140,41,99,39.6,0.396,0.333,0.24
"7753","199120",2002,3455,2053,1402,2513,935,1578,76.86,0.7686,0.727,0.667
"7754","199139",2002,2383,1234,1149,577,204,373,30.23,0.3023,0.242,0.178
"7755","199148",2002,2071,1420,651,570,118,452,31.83,0.3183,0.275,0.181
"7756","199157",2002,821,542,279,191,42,149,27.49,0.2749,0.233,0.151
"7757","199193",2002,3713,1561,2152,1391,580,811,51.95,0.5195,0.375,0.27
"7758","199218",2002,1629,1014,615,733,209,524,51.68,0.5168,0.45,0.34
"7759","199281",2002,709,376,333,101,38,63,16.76,0.1676,0.142,0.114
"7760","199306",2002,166,97,69,71,29,42,43.3,0.433,0.428,0.42
"7761","199412",2002,193,150,43,111,24,87,58,0.58,0.575,0.558
"7762","199582",2002,449,183,266,25,13,12,6.56,0.0656,0.056,0.049
"7763","199643",2002,526,240,286,67,26,41,17.08,0.1708,0.127,0.091
"7764","199847",2002,999,509,490,832,393,439,86.25,0.8625,0.833,0.802
"7765","199962",2002,374,197,177,167,62,105,53.3,0.533,0.447,0.35
"7766","199999",2002,670,471,199,121,28,93,19.75,0.1975,0.181,0.141
"7767","200004",2002,1216,627,589,344,127,217,34.61,0.3461,0.283,0.216
"7768","200059",2002,368,193,175,32,8,24,12.44,0.1244,0.087,0.046
"7769","200156",2002,332,176,156,98,29,69,39.2,0.392,0.295,0.186
"7770","200217",2002,402,240,162,168,44,124,51.67,0.5167,0.418,0.272
"7771","200226",2002,135,79,56,32,4,28,35.44,0.3544,0.237,0.071
"7772","200253",2002,476,268,208,62,11,51,19.03,0.1903,0.13,0.053
"7773","200280",2002,1987,935,1052,438,205,233,24.92,0.2492,0.22,0.195
"7774","200332",2002,1803,785,1018,387,186,201,25.61,0.2561,0.215,0.183
"7775","200572",2002,153,72,81,41,21,20,27.78,0.2778,0.268,0.259
"7776","201104",2002,559,373,186,258,60,198,53.08,0.5308,0.462,0.323
"7777","201371",2002,262,141,121,135,55,80,56.74,0.5674,0.515,0.455
"7778","201548",2002,563,330,233,296,104,192,58.18,0.5818,0.526,0.446
"7779","201645",2002,835,322,513,482,264,218,67.7,0.677,0.577,0.515
"7780","201690",2002,378,207,171,51,14,37,17.87,0.1787,0.135,0.082
"7781","202134",2002,946,463,483,80,39,41,8.86,0.0886,0.085,0.081
"7782","202480",2002,1644,797,847,944,390,554,69.51,0.6951,0.574,0.46
"7783","202523",2002,633,338,295,469,192,277,81.95,0.8195,0.741,0.651
"7784","202763",2002,651,386,265,276,98,178,46.11,0.4611,0.424,0.37
"7785","203085",2002,278,160,118,103,34,69,43.12,0.4312,0.371,0.288
"7786","203128",2002,233,126,107,132,52,80,63.49,0.6349,0.567,0.486
"7787","203368",2002,843,456,387,599,256,343,75.22,0.7522,0.711,0.661
"7788","203517",2002,3640,2232,1408,892,283,609,27.28,0.2728,0.245,0.201
"7789","203535",2002,440,246,194,376,158,218,88.62,0.8862,0.855,0.814
"7790","203580",2002,133,102,31,38,4,34,33.33,0.3333,0.286,0.129
"7791","203775",2002,348,219,129,148,54,94,42.92,0.4292,0.425,0.419
"7792","203845",2002,263,129,134,120,49,71,55.04,0.5504,0.456,0.366
"7793","204024",2002,3614,1998,1616,2461,1008,1453,72.72,0.7272,0.681,0.624
"7794","204185",2002,579,299,280,299,115,184,61.54,0.6154,0.516,0.411
"7795","204194",2002,332,203,129,129,48,81,39.9,0.399,0.389,0.372
"7796","204617",2002,251,163,88,94,34,60,36.81,0.3681,0.375,0.386
"7797","204796",2002,5936,2945,2991,2511,989,1522,51.68,0.5168,0.423,0.331
"7798","204857",2002,3628,2068,1560,1832,670,1162,56.19,0.5619,0.505,0.429
"7799","206330",2002,150,51,99,22,11,11,21.57,0.2157,0.147,0.111
"7800","206589",2002,514,281,233,354,140,214,76.16,0.7616,0.689,0.601
"7801","206604",2002,2169,1225,944,407,128,279,22.78,0.2278,0.188,0.136
"7802","206622",2002,757,424,333,518,224,294,69.34,0.6934,0.684,0.673
"7803","206695",2002,1944,1058,886,234,76,158,14.93,0.1493,0.12,0.086
"7804","206914",2002,583,330,253,39,17,22,6.67,0.0667,0.067,0.067
"7805","207209",2002,492,248,244,31,8,23,9.27,0.0927,0.063,0.033
"7806","207306",2002,298,164,134,56,19,37,22.56,0.2256,0.188,0.142
"7807","207324",2002,405,215,190,93,43,50,23.26,0.2326,0.23,0.226
"7808","207388",2002,3206,1698,1508,939,327,612,36.04,0.3604,0.293,0.217
"7809","207500",2002,3749,1940,1809,973,350,623,32.11,0.3211,0.26,0.193
"7810","207722",2002,280,186,94,44,11,33,17.74,0.1774,0.157,0.117
"7811","207847",2002,577,287,290,64,29,35,12.2,0.122,0.111,0.1
"7812","207865",2002,926,486,440,121,46,75,15.43,0.1543,0.131,0.105
"7813","208822",2002,319,204,115,171,60,111,54.41,0.5441,0.536,0.522
"7814","209056",2002,503,309,194,339,123,216,69.9,0.699,0.674,0.634
"7815","209065",2002,425,245,180,258,92,166,67.76,0.6776,0.607,0.511
"7816","209542",2002,2864,1437,1427,906,319,587,40.85,0.4085,0.316,0.224
"7817","209551",2002,3272,1834,1438,1353,500,853,46.51,0.4651,0.414,0.348
"7818","209612",2002,275,166,109,171,64,107,64.46,0.6446,0.622,0.587
"7819","209807",2002,1177,632,545,153,43,110,17.41,0.1741,0.13,0.079
"7820","209922",2002,307,160,147,182,79,103,64.38,0.6438,0.593,0.537
"7821","210146",2002,787,412,375,166,56,110,26.7,0.267,0.211,0.149
"7822","210401",2002,353,181,172,210,92,118,65.19,0.6519,0.595,0.535
"7823","210429",2002,769,466,303,142,36,106,22.75,0.2275,0.185,0.119
"7824","210571",2002,453,250,203,254,104,150,60,0.6,0.561,0.512
"7825","210669",2002,536,271,265,374,165,209,77.12,0.7712,0.698,0.623
"7826","210775",2002,242,153,89,89,29,60,39.22,0.3922,0.368,0.326
"7827","211088",2002,399,308,91,237,55,182,59.09,0.5909,0.594,0.604
"7828","211158",2002,1478,938,540,650,169,481,51.28,0.5128,0.44,0.313
"7829","211291",2002,914,455,459,764,371,393,86.37,0.8637,0.836,0.808
"7830","211352",2002,408,277,131,191,53,138,49.82,0.4982,0.468,0.405
"7831","211361",2002,893,464,429,224,95,129,27.8,0.278,0.251,0.221
"7832","211431",2002,238,231,7,79,0,79,34.2,0.342,0.332,0
"7833","211440",2002,1364,542,822,957,557,400,73.8,0.738,0.702,0.678
"7834","211468",2002,185,185,0,89,0,89,48.11,0.4811,0.481,NA
"7835","211556",2002,108,108,0,49,0,49,45.37,0.4537,0.454,NA
"7836","211583",2002,105,104,1,27,0,27,25.96,0.2596,0.257,0
"7837","211608",2002,247,132,115,25,5,20,15.15,0.1515,0.101,0.043
"7838","211644",2002,1249,745,504,367,117,250,33.56,0.3356,0.294,0.232
"7839","211981",2002,406,204,202,159,59,100,49.02,0.4902,0.392,0.292
"7840","212009",2002,572,328,244,459,185,274,83.54,0.8354,0.802,0.758
"7841","212054",2002,1937,709,1228,374,150,224,31.59,0.3159,0.193,0.122
"7842","212106",2002,1429,875,554,748,253,495,56.57,0.5657,0.523,0.457
"7843","212115",2002,1123,587,536,314,100,214,36.46,0.3646,0.28,0.187
"7844","212133",2002,405,288,117,211,49,162,56.25,0.5625,0.521,0.419
"7845","212160",2002,1372,788,584,297,86,211,26.78,0.2678,0.216,0.147
"7846","212197",2002,456,304,152,293,85,208,68.42,0.6842,0.643,0.559
"7847","212577",2002,534,248,286,388,189,199,80.24,0.8024,0.727,0.661
"7848","212601",2002,536,311,225,255,80,175,56.27,0.5627,0.476,0.356
"7849","212832",2002,261,211,50,62,18,44,20.85,0.2085,0.238,0.36
"7850","212911",2002,312,168,144,283,128,155,92.26,0.9226,0.907,0.889
"7851","213020",2002,2666,1536,1130,697,207,490,31.9,0.319,0.261,0.183
"7852","213251",2002,375,215,160,285,119,166,77.21,0.7721,0.76,0.744
"7853","213321",2002,409,195,214,263,125,138,70.77,0.7077,0.643,0.584
"7854","213349",2002,1726,1027,699,498,141,357,34.76,0.3476,0.289,0.202
"7855","213358",2002,295,175,120,117,43,74,42.29,0.4229,0.397,0.358
"7856","213367",2002,837,456,381,445,173,272,59.65,0.5965,0.532,0.454
"7857","213385",2002,580,267,313,498,263,235,88.01,0.8801,0.859,0.84
"7858","213507",2002,422,234,188,266,99,167,71.37,0.7137,0.63,0.527
"7859","213543",2002,1143,442,701,822,461,361,81.67,0.8167,0.719,0.658
"7860","213613",2002,1038,646,392,305,89,216,33.44,0.3344,0.294,0.227
"7861","213668",2002,373,195,178,234,100,134,68.72,0.6872,0.627,0.562
"7862","213783",2002,654,381,273,171,48,123,32.28,0.3228,0.261,0.176
"7863","213826",2002,310,238,72,164,29,135,56.72,0.5672,0.529,0.403
"7864","213996",2002,763,475,288,526,168,358,75.37,0.7537,0.689,0.583
"7865","214041",2002,1270,748,522,463,158,305,40.78,0.4078,0.365,0.303
"7866","214069",2002,347,239,108,201,59,142,59.41,0.5941,0.579,0.546
"7867","214157",2002,372,214,158,264,102,162,75.7,0.757,0.71,0.646
"7868","214175",2002,547,300,247,445,191,254,84.67,0.8467,0.814,0.773
"7869","214272",2002,363,228,135,114,25,89,39.04,0.3904,0.314,0.185
"7870","214777",2002,5935,2911,3024,3558,1554,2004,68.84,0.6884,0.599,0.514
"7871","215062",2002,2373,1183,1190,2096,1030,1066,90.11,0.9011,0.883,0.866
"7872","215743",2002,281,154,127,122,47,75,48.7,0.487,0.434,0.37
"7873","215798",2002,322,159,163,209,102,107,67.3,0.673,0.649,0.626
"7874","215929",2002,958,569,389,702,258,444,78.03,0.7803,0.733,0.663
"7875","216010",2002,1507,831,676,721,270,451,54.27,0.5427,0.478,0.399
"7876","216038",2002,1421,796,625,416,139,277,34.8,0.348,0.293,0.222
"7877","216287",2002,371,189,182,326,155,171,90.48,0.9048,0.879,0.852
"7878","216339",2002,3467,2034,1433,1170,394,776,38.15,0.3815,0.337,0.275
"7879","216524",2002,427,212,215,301,134,167,78.77,0.7877,0.705,0.623
"7880","216694",2002,297,141,156,142,50,92,65.25,0.6525,0.478,0.321
"7881","216764",2002,1766,1104,662,642,168,474,42.93,0.4293,0.364,0.254
"7882","216807",2002,350,235,115,208,56,152,64.68,0.6468,0.594,0.487
"7883","216852",2002,716,327,389,284,119,165,50.46,0.5046,0.397,0.306
"7884","216931",2002,471,239,232,224,101,123,51.46,0.5146,0.476,0.435
"7885","217059",2002,921,521,400,373,138,235,45.11,0.4511,0.405,0.345
"7886","217156",2002,1451,817,634,1213,505,708,86.66,0.8666,0.836,0.797
"7887","217402",2002,877,540,337,734,274,460,85.19,0.8519,0.837,0.813
"7888","217536",2002,523,378,145,334,93,241,63.76,0.6376,0.639,0.641
"7889","217776",2002,141,76,65,36,11,25,32.89,0.3289,0.255,0.169
"7890","217819",2002,1991,1333,658,941,253,688,51.61,0.5161,0.473,0.384
"7891","217882",2002,2463,1214,1249,1231,462,769,63.34,0.6334,0.5,0.37
"7892","217998",2002,165,100,65,87,25,62,62,0.62,0.527,0.385
"7893","218061",2002,734,431,303,142,48,94,21.81,0.2181,0.193,0.158
"7894","218229",2002,526,335,191,117,25,92,27.46,0.2746,0.222,0.131
"7895","218238",2002,180,83,97,26,12,14,16.87,0.1687,0.144,0.124
"7896","218399",2002,289,175,114,51,11,40,22.86,0.2286,0.176,0.096
"7897","218414",2002,250,94,156,70,33,37,39.36,0.3936,0.28,0.212
"7898","218663",2002,3500,1909,1591,1557,594,963,50.45,0.5045,0.445,0.373
"7899","218724",2002,1072,523,549,236,104,132,25.24,0.2524,0.22,0.189
"7900","218733",2002,717,401,316,174,45,129,32.17,0.3217,0.243,0.142
"7901","218742",2002,647,414,233,119,19,100,24.15,0.2415,0.184,0.082
"7902","218973",2002,297,170,127,234,95,139,81.76,0.8176,0.788,0.748
"7903","219000",2002,416,259,157,208,74,134,51.74,0.5174,0.5,0.471
"7904","219046",2002,537,334,203,43,11,32,9.58,0.0958,0.08,0.054
"7905","219082",2002,273,111,162,45,22,23,20.72,0.2072,0.165,0.136
"7906","219198",2002,137,104,33,44,7,37,35.58,0.3558,0.321,0.212
"7907","219259",2002,376,214,162,51,12,39,18.22,0.1822,0.136,0.074
"7908","219356",2002,1767,864,903,348,140,208,24.07,0.2407,0.197,0.155
"7909","219471",2002,976,544,432,186,74,112,20.59,0.2059,0.191,0.171
"7910","219602",2002,986,636,350,126,37,89,13.99,0.1399,0.128,0.106
"7911","219709",2002,524,320,204,264,91,173,54.06,0.5406,0.504,0.446
"7912","219718",2002,139,53,86,16,5,11,20.75,0.2075,0.115,0.058
"7913","219949",2002,164,74,90,35,6,29,39.19,0.3919,0.213,0.067
"7914","220075",2002,1473,831,642,262,76,186,22.38,0.2238,0.178,0.118
"7915","220215",2002,414,231,183,181,73,108,46.75,0.4675,0.437,0.399
"7916","220613",2002,705,423,282,195,60,135,31.91,0.3191,0.277,0.213
"7917","220631",2002,151,109,42,33,8,25,22.94,0.2294,0.219,0.19
"7918","220710",2002,246,127,119,103,44,59,46.46,0.4646,0.419,0.37
"7919","221351",2002,439,238,201,306,136,170,71.43,0.7143,0.697,0.677
"7920","221519",2002,368,198,170,270,116,154,77.78,0.7778,0.734,0.682
"7921","221731",2002,128,79,49,34,5,29,36.71,0.3671,0.266,0.102
"7922","221847",2002,1376,585,791,251,99,152,25.98,0.2598,0.182,0.125
"7923","221892",2002,198,134,64,75,24,51,38.06,0.3806,0.379,0.375
"7924","222178",2002,942,536,406,360,112,248,46.27,0.4627,0.382,0.276
"7925","222983",2002,347,191,156,245,104,141,73.82,0.7382,0.706,0.667
"7926","223232",2002,2601,1558,1043,1323,439,884,56.74,0.5674,0.509,0.421
"7927","224004",2002,166,85,81,12,9,3,3.53,0.0353,0.072,0.111
"7928","224323",2002,307,185,122,142,52,90,48.65,0.4865,0.463,0.426
"7929","225432",2002,905,498,407,14,4,10,2.01,0.0201,0.015,0.01
"7930","225548",2002,325,157,168,78,24,54,34.39,0.3439,0.24,0.143
"7931","225627",2002,395,244,151,58,18,40,16.39,0.1639,0.147,0.119
"7932","226231",2002,243,55,188,68,46,22,40,0.4,0.28,0.245
"7933","226833",2002,624,327,297,66,23,43,13.15,0.1315,0.106,0.077
"7934","227216",2002,2912,1683,1229,523,147,376,22.34,0.2234,0.18,0.12
"7935","227331",2002,331,241,90,55,11,44,18.26,0.1826,0.166,0.122
"7936","227526",2002,1431,769,662,222,74,148,19.25,0.1925,0.155,0.112
"7937","227757",2002,700,318,382,570,301,269,84.59,0.8459,0.814,0.788
"7938","227845",2002,445,255,190,164,60,104,40.78,0.4078,0.369,0.316
"7939","227863",2002,276,174,102,65,15,50,28.74,0.2874,0.236,0.147
"7940","228042",2002,165,80,85,45,18,27,33.75,0.3375,0.273,0.212
"7941","228149",2002,667,397,270,214,63,151,38.04,0.3804,0.321,0.233
"7942","228246",2002,1380,764,616,811,315,496,64.92,0.6492,0.588,0.511
"7943","228343",2002,342,217,125,227,76,151,69.59,0.6959,0.664,0.608
"7944","228431",2002,2006,1229,777,314,83,231,18.8,0.188,0.157,0.107
"7945","228459",2002,2674,1665,1009,587,140,447,26.85,0.2685,0.22,0.139
"7946","228501",2002,315,130,185,14,3,11,8.46,0.0846,0.044,0.016
"7947","228529",2002,974,507,467,148,46,102,20.12,0.2012,0.152,0.099
"7948","228705",2002,962,401,561,135,75,60,14.96,0.1496,0.14,0.134
"7949","228723",2002,6589,3528,3061,2734,863,1871,53.03,0.5303,0.415,0.282
"7950","228769",2002,2126,1070,1056,269,112,157,14.67,0.1467,0.127,0.106
"7951","228778",2002,7842,4111,3731,3769,1531,2238,54.44,0.5444,0.481,0.41
"7952","228787",2002,903,405,498,325,141,184,45.43,0.4543,0.36,0.283
"7953","228796",2002,2279,1202,1077,101,41,60,4.99,0.0499,0.044,0.038
"7954","228875",2002,1450,904,546,719,207,512,56.64,0.5664,0.496,0.379
"7955","228981",2002,371,181,190,111,34,77,42.54,0.4254,0.299,0.179
"7956","229018",2002,216,126,90,31,9,22,17.46,0.1746,0.144,0.1
"7957","229027",2002,3001,1619,1382,234,76,158,9.76,0.0976,0.078,0.055
"7958","229115",2002,4283,2066,2217,1302,551,751,36.35,0.3635,0.304,0.249
"7959","229780",2002,182,104,78,41,13,28,26.92,0.2692,0.225,0.167
"7960","229814",2002,798,425,373,138,38,100,23.53,0.2353,0.173,0.102
"7961","230603",2002,528,383,145,106,12,94,24.54,0.2454,0.201,0.083
"7962","230728",2002,1497,1010,487,423,81,342,33.86,0.3386,0.283,0.166
"7963","230764",2002,1962,1109,853,391,127,264,23.81,0.2381,0.199,0.149
"7964","230782",2002,1675,1019,656,79,16,63,6.18,0.0618,0.047,0.024
"7965","231059",2002,527,301,226,406,172,234,77.74,0.7774,0.77,0.761
"7966","231174",2002,1828,1005,823,1000,415,585,58.21,0.5821,0.547,0.504
"7967","231420",2002,187,90,97,59,20,39,43.33,0.4333,0.316,0.206
"7968","231554",2002,131,62,69,36,17,19,30.65,0.3065,0.275,0.246
"7969","231624",2002,1314,721,593,1082,456,626,86.82,0.8682,0.823,0.769
"7970","231712",2002,1176,660,516,363,128,235,35.61,0.3561,0.309,0.248
"7971","232025",2002,235,130,105,118,48,70,53.85,0.5385,0.502,0.457
"7972","232043",2002,208,120,88,113,46,67,55.83,0.5583,0.543,0.523
"7973","232089",2002,288,97,191,69,32,37,38.14,0.3814,0.24,0.168
"7974","232186",2002,2161,1180,981,770,254,516,43.73,0.4373,0.356,0.259
"7975","232265",2002,1017,644,373,384,90,294,45.65,0.4565,0.378,0.241
"7976","232423",2002,3283,2116,1167,2220,690,1530,72.31,0.7231,0.676,0.591
"7977","232557",2002,1530,812,718,393,154,239,29.43,0.2943,0.257,0.214
"7978","232566",2002,860,593,267,410,101,309,52.11,0.5211,0.477,0.378
"7979","232609",2002,438,246,192,220,72,148,60.16,0.6016,0.502,0.375
"7980","232681",2002,862,618,244,607,164,443,71.68,0.7168,0.704,0.672
"7981","232706",2002,361,261,100,128,25,103,39.46,0.3946,0.355,0.25
"7982","232937",2002,1091,634,457,133,35,98,15.46,0.1546,0.122,0.077
"7983","232982",2002,1701,902,799,373,139,234,25.94,0.2594,0.219,0.174
"7984","233277",2002,1813,1109,704,754,244,510,45.99,0.4599,0.416,0.347
"7985","233374",2002,775,422,353,634,279,355,84.12,0.8412,0.818,0.79
"7986","233426",2002,460,274,186,256,95,161,58.76,0.5876,0.557,0.511
"7987","233541",2002,323,163,160,115,42,73,44.79,0.4479,0.356,0.262
"7988","233897",2002,345,181,164,100,34,66,36.46,0.3646,0.29,0.207
"7989","233921",2002,4714,2002,2712,2437,1151,1286,64.24,0.6424,0.517,0.424
"7990","234030",2002,3014,1810,1204,711,237,474,26.19,0.2619,0.236,0.197
"7991","234085",2002,356,24,332,209,197,12,50,0.5,0.587,0.593
"7992","234155",2002,1129,650,479,237,60,177,27.23,0.2723,0.21,0.125
"7993","234164",2002,437,259,178,74,14,60,23.17,0.2317,0.169,0.079
"7994","235097",2002,1265,768,497,274,84,190,24.74,0.2474,0.217,0.169
"7995","235167",2002,486,236,250,250,133,117,49.58,0.4958,0.514,0.532
"7996","236230",2002,625,400,225,325,98,227,56.75,0.5675,0.52,0.436
"7997","236328",2002,666,399,267,459,173,286,71.68,0.7168,0.689,0.648
"7998","236577",2002,601,412,189,302,94,208,50.49,0.5049,0.502,0.497
"7999","236595",2002,633,387,246,324,110,214,55.3,0.553,0.512,0.447
"8000","236896",2002,336,172,164,61,29,32,18.6,0.186,0.182,0.177
"8001","236939",2002,2771,1469,1302,1018,372,646,43.98,0.4398,0.367,0.286
"8002","236948",2002,4776,2561,2215,2450,1039,1411,55.1,0.551,0.513,0.469
"8003","237011",2002,2213,1290,923,761,225,536,41.55,0.4155,0.344,0.244
"8004","237057",2002,379,230,149,322,126,196,85.22,0.8522,0.85,0.846
"8005","237066",2002,433,232,201,261,107,154,66.38,0.6638,0.603,0.532
"8006","237215",2002,499,265,234,2,2,0,0,0,0.004,0.009
"8007","237330",2002,587,273,314,74,34,40,14.65,0.1465,0.126,0.108
"8008","237358",2002,122,68,54,29,18,11,16.18,0.1618,0.238,0.333
"8009","237367",2002,682,377,305,80,30,50,13.26,0.1326,0.117,0.098
"8010","237792",2002,705,378,327,92,24,68,17.99,0.1799,0.13,0.073
"8011","237899",2002,351,178,173,28,8,20,11.24,0.1124,0.08,0.046
"8012","237932",2002,445,253,192,107,23,84,33.2,0.332,0.24,0.12
"8013","237969",2002,500,283,217,224,83,141,49.82,0.4982,0.448,0.382
"8014","238032",2002,3917,1841,2076,1161,473,688,37.37,0.3737,0.296,0.228
"8015","238333",2002,303,191,112,210,75,135,70.68,0.7068,0.693,0.67
"8016","238430",2002,197,155,42,55,12,43,27.74,0.2774,0.279,0.286
"8017","238458",2002,529,324,205,240,70,170,52.47,0.5247,0.454,0.341
"8018","238476",2002,618,351,267,236,84,152,43.3,0.433,0.382,0.315
"8019","238616",2002,287,139,148,96,42,54,38.85,0.3885,0.334,0.284
"8020","238661",2002,271,205,66,70,10,60,29.27,0.2927,0.258,0.152
"8021","239080",2002,247,176,71,52,13,39,22.16,0.2216,0.211,0.183
"8022","239105",2002,1856,1034,822,1052,433,619,59.86,0.5986,0.567,0.527
"8023","239628",2002,250,116,134,139,75,64,55.17,0.5517,0.556,0.56
"8024","239716",2002,495,273,222,345,134,211,77.29,0.7729,0.697,0.604
"8025","240107",2002,321,236,85,91,19,72,30.51,0.3051,0.283,0.224
"8026","240189",2002,2004,1095,909,463,176,287,26.21,0.2621,0.231,0.194
"8027","240277",2002,896,595,301,204,55,149,25.04,0.2504,0.228,0.183
"8028","240329",2002,1555,1006,549,463,128,335,33.3,0.333,0.298,0.233
"8029","240338",2002,158,88,70,79,31,48,54.55,0.5455,0.5,0.443
"8030","240365",2002,1775,1045,730,259,71,188,17.99,0.1799,0.146,0.097
"8031","240374",2002,760,418,342,70,24,46,11,0.11,0.092,0.07
"8032","240417",2002,1303,658,645,219,51,168,25.53,0.2553,0.168,0.079
"8033","240426",2002,286,150,136,37,15,22,14.67,0.1467,0.129,0.11
"8034","240444",2002,5488,3016,2472,2729,1037,1692,56.1,0.561,0.497,0.419
"8035","240453",2002,3178,1736,1442,457,175,282,16.24,0.1624,0.144,0.121
"8036","240462",2002,1120,395,725,184,75,109,27.59,0.2759,0.164,0.103
"8037","240471",2002,1045,642,403,277,81,196,30.53,0.3053,0.265,0.201
"8038","240480",2002,1464,806,658,286,109,177,21.96,0.2196,0.195,0.166
"8039","240727",2002,1443,733,710,328,113,215,29.33,0.2933,0.227,0.159
"8040","243443",2002,496,320,176,43,8,35,10.94,0.1094,0.087,0.045
"8041","243780",2002,6294,2535,3759,2230,1046,1184,46.71,0.4671,0.354,0.278
"8042","100654",2003,1287,673,614,112,30,82,12.18,0.1218,0.087,0.049
"8043","100663",2003,1607,1042,565,266,61,205,19.67,0.1967,0.166,0.108
"8044","100751",2003,2982,1685,1297,1121,364,757,44.93,0.4493,0.376,0.281
"8045","100858",2003,3692,1965,1727,1352,444,908,46.21,0.4621,0.366,0.257
"8046","101435",2003,203,76,127,72,30,42,55.26,0.5526,0.355,0.236
"8047","101480",2003,1044,561,483,139,45,94,16.76,0.1676,0.133,0.093
"8048","101675",2003,347,179,168,24,6,18,10.06,0.1006,0.069,0.036
"8049","101879",2003,789,479,310,142,37,105,21.92,0.2192,0.18,0.119
"8050","102049",2003,682,426,256,362,123,239,56.1,0.561,0.531,0.48
"8051","102094",2003,1218,704,514,155,42,113,16.05,0.1605,0.127,0.082
"8052","102234",2003,308,193,115,157,61,96,49.74,0.4974,0.51,0.53
"8053","102368",2003,1229,672,557,215,66,149,22.17,0.2217,0.175,0.118
"8054","102377",2003,528,272,256,82,32,50,18.38,0.1838,0.155,0.125
"8055","104151",2003,6815,3652,3163,1997,730,1267,34.69,0.3469,0.293,0.231
"8056","104179",2003,5780,3154,2626,1870,708,1162,36.84,0.3684,0.324,0.27
"8057","105330",2003,2114,1249,865,644,196,448,35.87,0.3587,0.305,0.227
"8058","106245",2003,691,405,286,29,9,20,4.94,0.0494,0.042,0.031
"8059","106342",2003,120,67,53,53,23,30,44.78,0.4478,0.442,0.434
"8060","106397",2003,2260,1175,1085,775,318,457,38.89,0.3889,0.343,0.293
"8061","106412",2003,731,333,398,47,12,35,10.51,0.1051,0.064,0.03
"8062","106458",2003,1426,798,628,233,70,163,20.43,0.2043,0.163,0.111
"8063","106467",2003,1445,723,722,248,96,152,21.02,0.2102,0.172,0.133
"8064","106485",2003,674,371,303,57,25,32,8.63,0.0863,0.085,0.083
"8065","106704",2003,2414,1450,964,527,165,362,24.97,0.2497,0.218,0.171
"8066","107044",2003,966,543,423,369,132,237,43.65,0.4365,0.382,0.312
"8067","107080",2003,267,155,112,157,63,94,60.65,0.6065,0.588,0.562
"8068","107141",2003,274,140,134,145,68,77,55,0.55,0.529,0.507
"8069","107512",2003,343,195,148,140,52,88,45.13,0.4513,0.408,0.351
"8070","107558",2003,206,113,93,63,20,43,38.05,0.3805,0.306,0.215
"8071","110097",2003,685,459,226,348,104,244,53.16,0.5316,0.508,0.46
"8072","110404",2003,190,64,126,138,90,48,75,0.75,0.726,0.714
"8073","110422",2003,2798,1239,1559,673,264,409,33.01,0.3301,0.241,0.169
"8074","110486",2003,714,476,238,92,23,69,14.5,0.145,0.129,0.097
"8075","110495",2003,551,365,186,119,37,82,22.47,0.2247,0.216,0.199
"8076","110510",2003,1335,918,417,178,45,133,14.49,0.1449,0.133,0.108
"8077","110529",2003,2558,1107,1451,384,172,212,19.15,0.1915,0.15,0.119
"8078","110538",2003,1970,1140,830,322,71,251,22.02,0.2202,0.163,0.086
"8079","110547",2003,639,458,181,31,5,26,5.68,0.0568,0.049,0.028
"8080","110556",2003,2485,1503,982,353,101,252,16.77,0.1677,0.142,0.103
"8081","110565",2003,3098,1873,1225,481,107,374,19.97,0.1997,0.155,0.087
"8082","110574",2003,672,415,257,111,32,79,19.04,0.1904,0.165,0.125
"8083","110583",2003,3339,2236,1103,432,103,329,14.71,0.1471,0.129,0.093
"8084","110592",2003,1305,845,460,115,32,83,9.82,0.0982,0.088,0.07
"8085","110617",2003,2347,1415,932,227,62,165,11.66,0.1166,0.097,0.067
"8086","113698",2003,244,188,56,98,24,74,39.36,0.3936,0.402,0.429
"8087","115755",2003,853,481,372,97,26,71,14.76,0.1476,0.114,0.07
"8088","119173",2003,339,330,9,84,4,80,24.24,0.2424,0.248,0.444
"8089","120184",2003,190,106,84,90,36,54,50.94,0.5094,0.474,0.429
"8090","121309",2003,566,356,210,353,119,234,65.73,0.6573,0.624,0.567
"8091","121345",2003,398,202,196,354,170,184,91.09,0.9109,0.889,0.867
"8092","122409",2003,3418,2106,1312,973,286,687,32.62,0.3262,0.285,0.218
"8093","122436",2003,1059,718,341,695,208,487,67.83,0.6783,0.656,0.61
"8094","122597",2003,2291,1474,817,267,69,198,13.43,0.1343,0.117,0.084
"8095","122612",2003,914,632,282,452,131,321,50.79,0.5079,0.495,0.465
"8096","122931",2003,892,509,383,690,284,406,79.76,0.7976,0.774,0.742
"8097","123554",2003,562,317,245,285,106,179,56.47,0.5647,0.507,0.433
"8098","123572",2003,1287,838,449,341,80,261,31.15,0.3115,0.265,0.178
"8099","126562",2003,624,353,271,104,36,68,19.26,0.1926,0.167,0.133
"8100","126580",2003,892,552,340,193,43,150,27.17,0.2717,0.216,0.126
"8101","126614",2003,5515,2761,2754,2267,966,1301,47.12,0.4712,0.411,0.351
"8102","126818",2003,3730,2012,1718,1319,483,836,41.55,0.4155,0.354,0.281
"8103","127060",2003,1010,549,461,540,216,324,59.02,0.5902,0.535,0.469
"8104","127185",2003,899,422,477,138,51,87,20.62,0.2062,0.154,0.107
"8105","127565",2003,1809,931,878,82,26,56,6.02,0.0602,0.045,0.03
"8106","127741",2003,2118,1337,781,598,169,429,32.09,0.3209,0.282,0.216
"8107","128106",2003,686,372,314,93,35,58,15.59,0.1559,0.136,0.111
"8108","128744",2003,286,158,128,61,14,47,29.75,0.2975,0.213,0.109
"8109","128771",2003,1176,571,605,166,59,107,18.74,0.1874,0.141,0.098
"8110","129020",2003,3182,1733,1449,1912,757,1155,66.65,0.6665,0.601,0.522
"8111","129242",2003,789,459,330,636,260,376,81.92,0.8192,0.806,0.788
"8112","129941",2003,618,301,317,223,85,138,45.85,0.4585,0.361,0.268
"8113","130253",2003,816,497,319,462,144,318,63.98,0.6398,0.566,0.451
"8114","130314",2003,190,190,0,59,0,59,31.05,0.3105,0.311,NA
"8115","130493",2003,1310,802,508,7,2,5,0.62,0.0062,0.005,0.004
"8116","130590",2003,548,257,291,421,212,209,81.32,0.8132,0.768,0.729
"8117","130697",2003,713,376,337,631,291,340,90.43,0.9043,0.885,0.864
"8118","130776",2003,808,444,364,105,40,65,14.64,0.1464,0.13,0.11
"8119","130794",2003,1350,680,670,1221,582,639,93.97,0.9397,0.904,0.869
"8120","130934",2003,597,355,242,89,13,76,21.41,0.2141,0.149,0.054
"8121","130943",2003,3794,2157,1637,2016,761,1255,58.18,0.5818,0.531,0.465
"8122","131159",2003,1238,832,406,882,286,596,71.63,0.7163,0.712,0.704
"8123","131283",2003,646,362,284,423,167,256,70.72,0.7072,0.655,0.588
"8124","131450",2003,236,124,112,25,8,17,13.71,0.1371,0.106,0.071
"8125","131469",2003,2260,1333,927,1726,683,1043,78.24,0.7824,0.764,0.737
"8126","131496",2003,1504,827,677,1321,575,746,90.21,0.9021,0.878,0.849
"8127","131520",2003,1446,992,454,679,155,524,52.82,0.5282,0.47,0.341
"8128","132471",2003,517,336,181,91,33,58,17.26,0.1726,0.176,0.182
"8129","132602",2003,827,492,335,112,24,88,17.89,0.1789,0.135,0.072
"8130","132903",2003,5653,2956,2697,1923,673,1250,42.29,0.4229,0.34,0.25
"8131","133492",2003,434,248,186,250,101,149,60.08,0.6008,0.576,0.543
"8132","133553",2003,1012,164,848,292,238,54,32.93,0.3293,0.289,0.281
"8133","133650",2003,2403,1391,1012,289,79,210,15.1,0.151,0.12,0.078
"8134","133669",2003,2038,1143,895,335,109,226,19.77,0.1977,0.164,0.122
"8135","133711",2003,556,318,238,220,84,136,42.77,0.4277,0.396,0.353
"8136","133881",2003,549,174,375,219,136,83,47.7,0.477,0.399,0.363
"8137","133951",2003,3038,1756,1282,597,185,412,23.46,0.2346,0.197,0.144
"8138","134079",2003,436,250,186,163,51,112,44.8,0.448,0.374,0.274
"8139","134097",2003,6059,3522,2537,2847,987,1860,52.81,0.5281,0.47,0.389
"8140","134130",2003,6499,3790,2709,3779,1253,2526,66.65,0.6665,0.581,0.463
"8141","134945",2003,430,192,238,137,57,80,41.67,0.4167,0.319,0.239
"8142","135726",2003,2066,1142,924,1374,582,792,69.35,0.6935,0.665,0.63
"8143","136172",2003,1919,1115,804,444,120,324,29.06,0.2906,0.231,0.149
"8144","136950",2003,496,298,198,291,102,189,63.42,0.6342,0.587,0.515
"8145","137546",2003,523,284,239,260,109,151,53.17,0.5317,0.497,0.456
"8146","138354",2003,816,469,347,169,48,121,25.8,0.258,0.207,0.138
"8147","138716",2003,537,322,215,78,21,57,17.7,0.177,0.145,0.098
"8148","138789",2003,719,433,286,47,8,39,9.01,0.0901,0.065,0.028
"8149","139144",2003,504,321,183,240,76,164,51.09,0.5109,0.476,0.415
"8150","139366",2003,1037,619,418,114,32,82,13.25,0.1325,0.11,0.077
"8151","139393",2003,236,146,90,108,32,76,52.05,0.5205,0.458,0.356
"8152","139658",2003,1595,895,700,1060,453,607,67.82,0.6782,0.665,0.647
"8153","139719",2003,496,260,236,64,17,47,18.08,0.1808,0.129,0.072
"8154","139755",2003,2224,607,1617,683,427,256,42.17,0.4217,0.307,0.264
"8155","139764",2003,326,222,104,48,13,35,15.77,0.1577,0.147,0.125
"8156","139861",2003,1027,611,416,254,69,185,30.28,0.3028,0.247,0.166
"8157","139931",2003,2735,1305,1430,466,145,321,24.6,0.246,0.17,0.101
"8158","139940",2003,1920,1159,761,349,114,235,20.28,0.2028,0.182,0.15
"8159","139959",2003,5157,3146,2011,2535,807,1728,54.93,0.5493,0.492,0.401
"8160","140447",2003,663,381,282,292,88,204,53.54,0.5354,0.44,0.312
"8161","140960",2003,607,354,253,76,12,64,18.08,0.1808,0.125,0.047
"8162","140988",2003,184,96,88,80,33,47,48.96,0.4896,0.435,0.375
"8163","141185",2003,165,107,58,83,22,61,57.01,0.5701,0.503,0.379
"8164","141264",2003,1756,1007,749,262,73,189,18.77,0.1877,0.149,0.097
"8165","141334",2003,1738,1020,718,215,47,168,16.47,0.1647,0.124,0.065
"8166","141486",2003,254,174,80,54,18,36,20.69,0.2069,0.213,0.225
"8167","141565",2003,423,274,149,54,17,37,13.5,0.135,0.128,0.114
"8168","141574",2003,1878,1035,843,307,92,215,20.77,0.2077,0.163,0.109
"8169","142276",2003,787,499,288,53,10,43,8.62,0.0862,0.067,0.035
"8170","142285",2003,1590,748,842,393,163,230,30.75,0.3075,0.247,0.194
"8171","142461",2003,241,153,88,89,22,67,43.79,0.4379,0.369,0.25
"8172","143084",2003,614,369,245,443,153,290,78.59,0.7859,0.721,0.624
"8173","143288",2003,176,82,94,49,19,30,36.59,0.3659,0.278,0.202
"8174","144005",2003,476,336,140,12,4,8,2.38,0.0238,0.025,0.029
"8175","144281",2003,1446,777,669,389,166,223,28.7,0.287,0.269,0.248
"8176","144740",2003,2249,1351,898,966,341,625,46.26,0.4626,0.43,0.38
"8177","144892",2003,1892,1098,794,563,185,378,34.43,0.3443,0.298,0.233
"8178","144962",2003,366,230,136,194,54,140,60.87,0.6087,0.53,0.397
"8179","144971",2003,92,44,48,15,5,10,22.73,0.2273,0.163,0.104
"8180","145600",2003,2880,1573,1307,702,275,427,27.15,0.2715,0.244,0.21
"8181","145619",2003,302,169,133,116,49,67,39.64,0.3964,0.384,0.368
"8182","145637",2003,6807,3268,3539,4390,2070,2320,70.99,0.7099,0.645,0.585
"8183","145691",2003,318,180,138,157,59,98,54.44,0.5444,0.494,0.428
"8184","145813",2003,3088,1934,1154,1294,411,883,45.66,0.4566,0.419,0.356
"8185","146481",2003,347,194,153,203,86,117,60.31,0.6031,0.585,0.562
"8186","146612",2003,458,224,234,179,86,93,41.52,0.4152,0.391,0.368
"8187","146719",2003,1915,1292,623,924,296,628,48.61,0.4861,0.483,0.475
"8188","146825",2003,162,79,83,48,17,31,39.24,0.3924,0.296,0.205
"8189","147013",2003,287,124,163,113,55,58,46.77,0.4677,0.394,0.337
"8190","147244",2003,595,299,296,317,132,185,61.87,0.6187,0.533,0.446
"8191","147341",2003,355,175,180,215,97,118,67.43,0.6743,0.606,0.539
"8192","147703",2003,3229,1635,1594,737,300,437,26.73,0.2673,0.228,0.188
"8193","147767",2003,1941,1035,906,1694,753,941,90.92,0.9092,0.873,0.831
"8194","147776",2003,1046,657,389,36,12,24,3.65,0.0365,0.034,0.031
"8195","147828",2003,578,339,239,252,93,159,46.9,0.469,0.436,0.389
"8196","148131",2003,222,108,114,68,32,36,33.33,0.3333,0.306,0.281
"8197","148496",2003,240,176,64,146,40,106,60.23,0.6023,0.608,0.625
"8198","148584",2003,190,110,80,62,27,35,31.82,0.3182,0.326,0.338
"8199","148627",2003,371,231,140,107,32,75,32.47,0.3247,0.288,0.229
"8200","149222",2003,2532,1089,1443,595,280,315,28.93,0.2893,0.235,0.194
"8201","149231",2003,1699,982,717,399,129,270,27.49,0.2749,0.235,0.18
"8202","149772",2003,1938,939,999,675,322,353,37.59,0.3759,0.348,0.322
"8203","149781",2003,576,288,288,462,223,239,82.99,0.8299,0.802,0.774
"8204","150066",2003,559,337,222,246,81,165,48.96,0.4896,0.44,0.365
"8205","150136",2003,3963,2139,1824,1329,507,822,38.43,0.3843,0.335,0.278
"8206","150145",2003,291,175,116,117,39,78,44.57,0.4457,0.402,0.336
"8207","150163",2003,972,612,360,550,184,366,59.8,0.598,0.566,0.511
"8208","150400",2003,580,305,275,456,202,254,83.28,0.8328,0.786,0.735
"8209","150534",2003,662,418,244,346,119,227,54.31,0.5431,0.523,0.488
"8210","150668",2003,181,99,82,101,41,60,60.61,0.6061,0.558,0.5
"8211","150941",2003,190,103,87,94,45,49,47.57,0.4757,0.495,0.517
"8212","151102",2003,1366,757,609,76,29,47,6.21,0.0621,0.056,0.048
"8213","151111",2003,2336,1361,975,210,79,131,9.63,0.0963,0.09,0.081
"8214","151306",2003,1953,1151,802,271,78,193,16.77,0.1677,0.139,0.097
"8215","151324",2003,1974,974,1000,351,128,223,22.9,0.229,0.178,0.128
"8216","151333",2003,382,264,118,27,5,22,8.33,0.0833,0.071,0.042
"8217","151342",2003,707,417,290,42,18,24,5.76,0.0576,0.059,0.062
"8218","151351",2003,6739,3773,2966,3490,1419,2071,54.89,0.5489,0.518,0.478
"8219","151360",2003,660,417,243,49,14,35,8.39,0.0839,0.074,0.058
"8220","151379",2003,674,400,274,53,15,38,9.5,0.095,0.079,0.055
"8221","151388",2003,318,203,115,20,7,13,6.4,0.064,0.063,0.061
"8222","151777",2003,335,168,167,127,53,74,44.05,0.4405,0.379,0.317
"8223","151786",2003,239,162,77,71,27,44,27.16,0.2716,0.297,0.351
"8224","152080",2003,1995,928,1067,1797,955,842,90.73,0.9073,0.901,0.895
"8225","152248",2003,997,527,470,56,21,35,6.64,0.0664,0.056,0.045
"8226","152363",2003,306,159,147,134,66,68,42.77,0.4277,0.438,0.449
"8227","152530",2003,468,270,198,331,137,194,71.85,0.7185,0.707,0.692
"8228","152600",2003,791,400,391,501,229,272,68,0.68,0.633,0.586
"8229","153001",2003,377,193,184,172,74,98,50.78,0.5078,0.456,0.402
"8230","153108",2003,416,227,189,231,87,144,63.44,0.6344,0.555,0.46
"8231","153269",2003,809,474,335,410,151,259,54.64,0.5464,0.507,0.451
"8232","153384",2003,403,214,189,315,138,177,82.71,0.8271,0.782,0.73
"8233","153603",2003,3860,1683,2177,1364,577,787,46.76,0.4676,0.353,0.265
"8234","153834",2003,667,397,270,436,172,264,66.5,0.665,0.654,0.637
"8235","154095",2003,1739,1088,651,613,182,431,39.61,0.3961,0.353,0.28
"8236","155089",2003,201,102,99,38,14,24,23.53,0.2353,0.189,0.141
"8237","155317",2003,3971,2126,1845,1261,480,781,36.74,0.3674,0.318,0.26
"8238","155335",2003,200,118,82,57,19,38,32.2,0.322,0.285,0.232
"8239","155399",2003,3098,1529,1569,855,303,552,36.1,0.361,0.276,0.193
"8240","155520",2003,260,125,135,103,41,62,49.6,0.496,0.396,0.304
"8241","155627",2003,114,47,67,28,6,22,46.81,0.4681,0.246,0.09
"8242","155937",2003,124,57,67,44,16,28,49.12,0.4912,0.355,0.239
"8243","156213",2003,258,146,112,148,68,80,54.79,0.5479,0.574,0.607
"8244","156286",2003,450,289,161,235,79,156,53.98,0.5398,0.522,0.491
"8245","156295",2003,396,240,156,203,83,120,50,0.5,0.513,0.532
"8246","156365",2003,351,162,189,86,37,49,30.25,0.3025,0.245,0.196
"8247","156541",2003,401,191,210,98,33,65,34.03,0.3403,0.244,0.157
"8248","156745",2003,368,213,155,181,54,127,59.62,0.5962,0.492,0.348
"8249","157058",2003,309,162,147,23,9,14,8.64,0.0864,0.074,0.061
"8250","157076",2003,165,91,74,58,19,39,42.86,0.4286,0.352,0.257
"8251","157085",2003,3678,1951,1727,1160,460,700,35.88,0.3588,0.315,0.266
"8252","157289",2003,2197,1118,1079,468,173,295,26.39,0.2639,0.213,0.16
"8253","157386",2003,1555,867,688,185,60,125,14.42,0.1442,0.119,0.087
"8254","157401",2003,1500,876,624,477,160,317,36.19,0.3619,0.318,0.256
"8255","157447",2003,1962,1108,854,155,35,120,10.83,0.1083,0.079,0.041
"8256","157535",2003,147,67,80,27,10,17,25.37,0.2537,0.184,0.125
"8257","157951",2003,3034,1782,1252,541,169,372,20.88,0.2088,0.178,0.135
"8258","158477",2003,197,113,84,101,34,67,59.29,0.5929,0.513,0.405
"8259","159009",2003,1022,570,452,124,29,95,16.67,0.1667,0.121,0.064
"8260","159391",2003,5359,2938,2421,1396,468,928,31.59,0.3159,0.26,0.193
"8261","159647",2003,1948,958,990,485,190,295,30.79,0.3079,0.249,0.192
"8262","159717",2003,1506,843,663,176,51,125,14.83,0.1483,0.117,0.077
"8263","159966",2003,1391,813,578,121,36,85,10.46,0.1046,0.087,0.062
"8264","160038",2003,1826,1117,709,227,71,156,13.97,0.1397,0.124,0.1
"8265","160612",2003,2539,1451,1088,221,72,149,10.27,0.1027,0.087,0.066
"8266","160621",2003,1351,782,569,77,16,61,7.8,0.078,0.057,0.028
"8267","160658",2003,2576,1437,1139,333,86,247,17.19,0.1719,0.129,0.076
"8268","161004",2003,464,236,228,412,202,210,88.98,0.8898,0.888,0.886
"8269","161226",2003,482,339,143,221,59,162,47.79,0.4779,0.459,0.413
"8270","161235",2003,126,62,64,19,4,15,24.19,0.2419,0.151,0.062
"8271","161244",2003,142,92,50,17,1,16,17.39,0.1739,0.12,0.02
"8272","161253",2003,1599,812,787,538,235,303,37.32,0.3732,0.336,0.299
"8273","161554",2003,851,496,355,106,24,82,16.53,0.1653,0.125,0.068
"8274","162007",2003,762,479,283,98,18,80,16.7,0.167,0.129,0.064
"8275","162210",2003,187,120,67,24,6,18,15,0.15,0.128,0.09
"8276","162283",2003,571,432,139,29,9,20,4.63,0.0463,0.051,0.065
"8277","162584",2003,988,450,538,216,85,131,29.11,0.2911,0.219,0.158
"8278","162654",2003,342,207,135,207,60,147,71.01,0.7101,0.605,0.444
"8279","162760",2003,181,143,38,110,20,90,62.94,0.6294,0.608,0.526
"8280","162928",2003,1122,499,623,919,488,431,86.37,0.8637,0.819,0.783
"8281","163046",2003,915,545,370,704,277,427,78.35,0.7835,0.769,0.749
"8282","163268",2003,1487,657,830,506,215,291,44.29,0.4429,0.34,0.259
"8283","163286",2003,4045,2031,2014,2539,1158,1381,68,0.68,0.628,0.575
"8284","163453",2003,1220,699,521,138,34,104,14.88,0.1488,0.113,0.065
"8285","163462",2003,395,237,158,279,110,169,71.31,0.7131,0.706,0.696
"8286","163851",2003,947,531,416,433,142,291,54.8,0.548,0.457,0.341
"8287","163912",2003,421,249,172,300,106,194,77.91,0.7791,0.713,0.616
"8288","164076",2003,1756,1192,564,763,181,582,48.83,0.4883,0.435,0.321
"8289","164173",2003,539,384,155,247,63,184,47.92,0.4792,0.458,0.406
"8290","164216",2003,361,228,133,272,93,179,78.51,0.7851,0.753,0.699
"8291","164270",2003,451,249,202,274,94,180,72.29,0.7229,0.608,0.465
"8292","164447",2003,327,174,153,105,45,60,34.48,0.3448,0.321,0.294
"8293","164492",2003,154,102,52,76,19,57,55.88,0.5588,0.494,0.365
"8294","164562",2003,640,408,232,409,140,269,65.93,0.6593,0.639,0.603
"8295","165015",2003,824,486,338,692,285,407,83.74,0.8374,0.84,0.843
"8296","165024",2003,1285,745,540,320,93,227,30.47,0.3047,0.249,0.172
"8297","165334",2003,537,324,213,391,150,241,74.38,0.7438,0.728,0.704
"8298","165662",2003,706,413,293,525,229,296,71.67,0.7167,0.744,0.782
"8299","165671",2003,406,299,107,222,47,175,58.53,0.5853,0.547,0.439
"8300","165820",2003,585,320,265,144,50,94,29.38,0.2938,0.246,0.189
"8301","165866",2003,617,441,176,202,45,157,35.6,0.356,0.327,0.256
"8302","165936",2003,427,274,153,260,86,174,63.5,0.635,0.609,0.562
"8303","166027",2003,1633,782,851,1433,726,707,90.41,0.9041,0.878,0.853
"8304","166124",2003,698,378,320,607,270,337,89.15,0.8915,0.87,0.844
"8305","166513",2003,1008,393,615,291,145,146,37.15,0.3715,0.289,0.236
"8306","166629",2003,4149,2060,2089,1958,850,1108,53.79,0.5379,0.472,0.407
"8307","166638",2003,602,353,249,60,21,39,11.05,0.1105,0.1,0.084
"8308","166683",2003,1018,459,559,842,450,392,85.4,0.854,0.827,0.805
"8309","167288",2003,244,149,95,91,28,63,42.28,0.4228,0.373,0.295
"8310","167987",2003,1510,764,746,489,187,302,39.53,0.3953,0.324,0.251
"8311","167996",2003,565,307,258,451,193,258,84.04,0.8404,0.798,0.748
"8312","168005",2003,914,542,372,320,117,203,37.45,0.3745,0.35,0.315
"8313","168148",2003,1281,664,617,1087,507,580,87.35,0.8735,0.849,0.822
"8314","168254",2003,672,279,393,275,148,127,45.52,0.4552,0.409,0.377
"8315","168281",2003,445,286,159,324,104,220,76.92,0.7692,0.728,0.654
"8316","168342",2003,533,272,261,497,245,252,92.65,0.9265,0.932,0.939
"8317","168546",2003,486,263,223,306,118,188,71.48,0.7148,0.63,0.529
"8318","168786",2003,284,182,102,94,31,63,34.62,0.3462,0.331,0.304
"8319","169080",2003,1041,577,464,572,230,342,59.27,0.5927,0.549,0.496
"8320","169798",2003,2479,1510,969,295,85,210,13.91,0.1391,0.119,0.088
"8321","169910",2003,2205,960,1245,137,67,70,7.29,0.0729,0.062,0.054
"8322","170082",2003,3270,2096,1174,851,257,594,28.34,0.2834,0.26,0.219
"8323","170301",2003,810,515,295,531,167,364,70.68,0.7068,0.656,0.566
"8324","170532",2003,382,220,162,275,118,157,71.36,0.7136,0.72,0.728
"8325","170639",2003,551,243,308,42,17,25,10.29,0.1029,0.076,0.055
"8326","170976",2003,5538,2903,2635,4025,1840,2185,75.27,0.7527,0.727,0.698
"8327","171100",2003,6938,3932,3006,3315,1201,2114,53.76,0.5376,0.478,0.4
"8328","171128",2003,1168,238,930,251,177,74,31.09,0.3109,0.215,0.19
"8329","171137",2003,704,313,391,123,62,61,19.49,0.1949,0.175,0.159
"8330","171146",2003,420,252,168,57,17,40,15.87,0.1587,0.136,0.101
"8331","171599",2003,271,99,172,101,53,48,48.48,0.4848,0.373,0.308
"8332","172051",2003,1156,667,489,104,32,72,10.79,0.1079,0.09,0.065
"8333","172699",2003,4218,2191,2027,915,388,527,24.05,0.2405,0.217,0.191
"8334","173160",2003,690,419,271,427,172,255,60.86,0.6086,0.619,0.635
"8335","173258",2003,488,241,247,435,215,220,91.29,0.9129,0.891,0.87
"8336","173328",2003,167,83,84,59,25,34,40.96,0.4096,0.353,0.298
"8337","173647",2003,623,331,292,514,235,279,84.29,0.8429,0.825,0.805
"8338","173902",2003,513,300,213,422,168,254,84.67,0.8467,0.823,0.789
"8339","174066",2003,5160,2820,2340,2341,902,1439,51.03,0.5103,0.454,0.385
"8340","174233",2003,2155,1073,1082,514,218,296,27.59,0.2759,0.239,0.201
"8341","174251",2003,412,249,163,179,60,119,47.79,0.4779,0.434,0.368
"8342","174491",2003,431,291,140,191,55,136,46.74,0.4674,0.443,0.393
"8343","174792",2003,490,0,490,346,346,0,NA,NA,0.706,0.706
"8344","174844",2003,719,422,297,593,234,359,85.07,0.8507,0.825,0.788
"8345","174899",2003,411,299,112,256,75,181,60.54,0.6054,0.623,0.67
"8346","174914",2003,1038,547,491,584,244,340,62.16,0.6216,0.563,0.497
"8347","175342",2003,495,271,224,108,32,76,28.04,0.2804,0.218,0.143
"8348","175421",2003,170,96,74,53,15,38,39.58,0.3958,0.312,0.203
"8349","175616",2003,327,191,136,55,19,36,18.85,0.1885,0.168,0.14
"8350","175856",2003,883,470,413,141,43,98,20.85,0.2085,0.16,0.104
"8351","175980",2003,259,141,118,152,63,89,63.12,0.6312,0.587,0.534
"8352","176017",2003,2377,1297,1080,851,286,565,43.56,0.4356,0.358,0.265
"8353","176035",2003,202,178,24,48,3,45,25.28,0.2528,0.238,0.125
"8354","176044",2003,325,187,138,57,16,41,21.93,0.2193,0.175,0.116
"8355","176080",2003,1659,822,837,509,185,324,39.42,0.3942,0.307,0.221
"8356","176406",2003,221,166,55,53,9,44,26.51,0.2651,0.24,0.164
"8357","176628",2003,152,93,59,36,5,31,33.33,0.3333,0.237,0.085
"8358","176947",2003,223,93,130,64,25,39,41.94,0.4194,0.287,0.192
"8359","176965",2003,1355,737,618,323,115,208,28.22,0.2822,0.238,0.186
"8360","177418",2003,194,143,51,61,14,47,32.87,0.3287,0.314,0.275
"8361","178059",2003,318,236,82,163,39,124,52.54,0.5254,0.513,0.476
"8362","178341",2003,568,319,249,76,25,51,15.99,0.1599,0.134,0.1
"8363","178387",2003,994,572,422,111,27,84,14.69,0.1469,0.112,0.064
"8364","178396",2003,4605,2443,2162,1985,737,1248,51.08,0.5108,0.431,0.341
"8365","178402",2003,758,455,303,124,38,86,18.9,0.189,0.164,0.125
"8366","178411",2003,870,181,689,217,154,63,34.81,0.3481,0.249,0.224
"8367","178420",2003,464,280,184,97,26,71,25.36,0.2536,0.209,0.141
"8368","178615",2003,1310,787,523,612,198,414,52.6,0.526,0.467,0.379
"8369","179043",2003,244,130,114,141,60,81,62.31,0.6231,0.578,0.526
"8370","179159",2003,1377,752,625,832,338,494,65.69,0.6569,0.604,0.541
"8371","179557",2003,1410,826,584,336,98,238,28.81,0.2881,0.238,0.168
"8372","179566",2003,2645,1495,1150,1044,382,662,44.28,0.4428,0.395,0.332
"8373","179867",2003,1349,699,650,1138,517,621,88.84,0.8884,0.844,0.795
"8374","179894",2003,419,260,159,201,62,139,53.46,0.5346,0.48,0.39
"8375","179946",2003,240,93,147,96,56,40,43.01,0.4301,0.4,0.381
"8376","180179",2003,588,380,208,54,13,41,10.79,0.1079,0.092,0.062
"8377","180461",2003,2004,837,1167,383,193,190,22.7,0.227,0.191,0.165
"8378","180522",2003,214,108,106,36,20,16,14.81,0.1481,0.168,0.189
"8379","180984",2003,222,138,84,77,25,52,37.68,0.3768,0.347,0.298
"8380","181002",2003,933,567,366,601,223,378,66.67,0.6667,0.644,0.609
"8381","181020",2003,288,152,136,173,75,98,64.47,0.6447,0.601,0.551
"8382","181127",2003,338,143,195,185,87,98,68.53,0.6853,0.547,0.446
"8383","181215",2003,1012,588,424,229,73,156,26.53,0.2653,0.226,0.172
"8384","181394",2003,1465,787,678,189,85,104,13.21,0.1321,0.129,0.125
"8385","181446",2003,417,241,176,216,83,133,55.19,0.5519,0.518,0.472
"8386","181464",2003,3639,1825,1814,904,341,563,30.85,0.3085,0.248,0.188
"8387","181534",2003,188,89,99,29,9,20,22.47,0.2247,0.154,0.091
"8388","181783",2003,598,342,256,163,59,104,30.41,0.3041,0.273,0.23
"8389","182281",2003,2827,1596,1231,338,107,231,14.47,0.1447,0.12,0.087
"8390","182290",2003,2047,1154,893,254,76,178,15.42,0.1542,0.124,0.085
"8391","182634",2003,304,207,97,158,34,124,59.9,0.599,0.52,0.351
"8392","182795",2003,514,244,270,172,74,98,40.16,0.4016,0.335,0.274
"8393","183062",2003,991,598,393,369,126,243,40.64,0.4064,0.372,0.321
"8394","183080",2003,900,469,431,310,134,176,37.53,0.3753,0.344,0.311
"8395","183239",2003,587,336,251,418,172,246,73.21,0.7321,0.712,0.685
"8396","183822",2003,341,215,126,39,6,33,15.35,0.1535,0.114,0.048
"8397","183974",2003,221,126,95,112,47,65,51.59,0.5159,0.507,0.495
"8398","184348",2003,419,247,172,289,109,180,72.87,0.7287,0.69,0.634
"8399","184603",2003,540,303,237,105,40,65,21.45,0.2145,0.194,0.169
"8400","184612",2003,218,158,60,33,10,23,14.56,0.1456,0.151,0.167
"8401","184782",2003,1243,600,643,588,265,323,53.83,0.5383,0.473,0.412
"8402","185129",2003,652,380,272,49,15,34,8.95,0.0895,0.075,0.055
"8403","185572",2003,904,484,420,358,125,233,48.14,0.4814,0.396,0.298
"8404","185590",2003,1594,934,660,471,134,337,36.08,0.3608,0.295,0.203
"8405","185828",2003,685,119,566,118,92,26,21.85,0.2185,0.172,0.163
"8406","186131",2003,1161,539,622,1044,549,495,91.84,0.9184,0.899,0.883
"8407","186201",2003,719,423,296,439,165,274,64.78,0.6478,0.611,0.557
"8408","186283",2003,944,575,369,443,154,289,50.26,0.5026,0.469,0.417
"8409","186584",2003,1241,616,625,620,301,319,51.79,0.5179,0.5,0.482
"8410","186876",2003,816,439,377,319,119,200,45.56,0.4556,0.391,0.316
"8411","187134",2003,1176,679,497,855,327,528,77.76,0.7776,0.727,0.658
"8412","187444",2003,1269,711,558,262,86,176,24.75,0.2475,0.206,0.154
"8413","187985",2003,2940,1660,1280,300,76,224,13.49,0.1349,0.102,0.059
"8414","188030",2003,2016,1087,929,257,90,167,15.36,0.1536,0.127,0.097
"8415","188429",2003,772,514,258,402,117,285,55.45,0.5545,0.521,0.453
"8416","188641",2003,472,250,222,237,89,148,59.2,0.592,0.502,0.401
"8417","190044",2003,720,193,527,372,257,115,59.59,0.5959,0.517,0.488
"8418","190099",2003,725,355,370,615,301,314,88.45,0.8845,0.848,0.814
"8419","190150",2003,1355,626,729,1131,606,525,83.87,0.8387,0.835,0.831
"8420","190248",2003,137,85,52,37,12,25,29.41,0.2941,0.27,0.231
"8421","190415",2003,3131,1533,1598,2672,1322,1350,88.06,0.8806,0.853,0.827
"8422","190512",2003,1659,819,840,544,214,330,40.29,0.4029,0.328,0.255
"8423","190549",2003,1296,679,617,220,73,147,21.65,0.2165,0.17,0.118
"8424","190558",2003,1885,1013,872,67,17,50,4.94,0.0494,0.036,0.019
"8425","190567",2003,1124,547,577,62,20,42,7.68,0.0768,0.055,0.035
"8426","190594",2003,1661,1113,548,280,63,217,19.5,0.195,0.169,0.115
"8427","190637",2003,790,529,261,85,20,65,12.29,0.1229,0.108,0.077
"8428","190664",2003,1290,790,500,327,88,239,30.25,0.3025,0.253,0.176
"8429","190691",2003,565,366,199,30,8,22,6.01,0.0601,0.053,0.04
"8430","190725",2003,356,252,104,108,23,85,33.73,0.3373,0.303,0.221
"8431","191241",2003,1687,961,726,1265,547,718,74.71,0.7471,0.75,0.753
"8432","191515",2003,464,234,230,383,185,198,84.62,0.8462,0.825,0.804
"8433","191533",2003,447,236,211,210,77,133,56.36,0.5636,0.47,0.365
"8434","191630",2003,516,267,249,383,176,207,77.53,0.7753,0.742,0.707
"8435","191649",2003,1855,979,876,768,290,478,48.83,0.4883,0.414,0.331
"8436","191676",2003,299,203,96,179,53,126,62.07,0.6207,0.599,0.552
"8437","191931",2003,811,434,377,409,152,257,59.22,0.5922,0.504,0.403
"8438","191968",2003,1581,912,669,1118,456,662,72.59,0.7259,0.707,0.682
"8439","192192",2003,239,168,71,107,29,78,46.43,0.4643,0.448,0.408
"8440","192323",2003,503,310,193,323,115,208,67.1,0.671,0.642,0.596
"8441","192439",2003,680,480,200,45,10,35,7.29,0.0729,0.066,0.05
"8442","192703",2003,638,342,296,400,173,227,66.37,0.6637,0.627,0.584
"8443","192749",2003,422,295,127,223,68,155,52.54,0.5254,0.528,0.535
"8444","192819",2003,961,528,433,732,310,422,79.92,0.7992,0.762,0.716
"8445","192925",2003,241,146,95,100,42,58,39.73,0.3973,0.415,0.442
"8446","193016",2003,611,379,232,58,10,48,12.66,0.1266,0.095,0.043
"8447","193292",2003,262,185,77,89,29,60,32.43,0.3243,0.34,0.377
"8448","193353",2003,347,246,101,137,31,106,43.09,0.4309,0.395,0.307
"8449","193399",2003,336,272,64,136,13,123,45.22,0.4522,0.405,0.203
"8450","193584",2003,383,284,99,236,54,182,64.08,0.6408,0.616,0.545
"8451","193645",2003,769,668,101,121,5,116,17.37,0.1737,0.157,0.05
"8452","193654",2003,581,409,172,288,81,207,50.61,0.5061,0.496,0.471
"8453","193900",2003,4203,2563,1640,2664,1069,1595,62.23,0.6223,0.634,0.652
"8454","193973",2003,686,417,269,403,152,251,60.19,0.6019,0.587,0.565
"8455","194161",2003,267,166,101,79,26,53,31.93,0.3193,0.296,0.257
"8456","194310",2003,1553,997,556,653,214,439,44.03,0.4403,0.42,0.385
"8457","194824",2003,1341,320,1021,856,626,230,71.88,0.7188,0.638,0.613
"8458","195003",2003,2121,567,1554,538,286,252,44.44,0.4444,0.254,0.184
"8459","195030",2003,1086,508,578,747,368,379,74.61,0.7461,0.688,0.637
"8460","195164",2003,595,292,303,296,135,161,55.14,0.5514,0.497,0.446
"8461","195173",2003,428,224,204,71,18,53,23.66,0.2366,0.166,0.088
"8462","195216",2003,565,296,269,444,196,248,83.78,0.8378,0.786,0.729
"8463","195234",2003,531,397,134,277,52,225,56.68,0.5668,0.522,0.388
"8464","195243",2003,343,188,155,97,39,58,30.85,0.3085,0.283,0.252
"8465","195304",2003,322,234,88,218,63,155,66.24,0.6624,0.677,0.716
"8466","195474",2003,759,438,321,519,204,315,71.92,0.7192,0.684,0.636
"8467","195526",2003,642,377,265,527,208,319,84.62,0.8462,0.821,0.785
"8468","195544",2003,96,80,16,67,10,57,71.25,0.7125,0.698,0.625
"8469","195809",2003,2966,1749,1217,1058,381,677,38.71,0.3871,0.357,0.313
"8470","196413",2003,2628,1501,1127,1914,755,1159,77.22,0.7722,0.728,0.67
"8471","196592",2003,1967,1343,624,247,74,173,12.88,0.1288,0.126,0.119
"8472","197045",2003,447,254,193,169,70,99,38.98,0.3898,0.378,0.363
"8473","197133",2003,631,367,264,554,226,328,89.37,0.8937,0.878,0.856
"8474","197869",2003,2462,1216,1246,920,360,560,46.05,0.4605,0.374,0.289
"8475","197984",2003,147,70,77,48,25,23,32.86,0.3286,0.327,0.325
"8476","198385",2003,489,237,252,435,218,217,91.56,0.9156,0.89,0.865
"8477","198464",2003,3458,2117,1341,1035,293,742,35.05,0.3505,0.299,0.218
"8478","198507",2003,459,258,201,104,36,68,26.36,0.2636,0.227,0.179
"8479","198516",2003,1227,775,452,875,294,581,74.97,0.7497,0.713,0.65
"8480","198835",2003,308,178,130,124,45,79,44.38,0.4438,0.403,0.346
"8481","198969",2003,384,120,264,58,26,32,26.67,0.2667,0.151,0.098
"8482","199102",2003,2221,1176,1045,389,104,285,24.23,0.2423,0.175,0.1
"8483","199111",2003,590,332,258,170,45,125,37.65,0.3765,0.288,0.174
"8484","199120",2003,3511,2068,1443,2535,945,1590,76.89,0.7689,0.722,0.655
"8485","199139",2003,2472,1291,1181,630,244,386,29.9,0.299,0.255,0.207
"8486","199148",2003,2039,1422,617,577,123,454,31.93,0.3193,0.283,0.199
"8487","199157",2003,1025,679,346,190,32,158,23.27,0.2327,0.185,0.092
"8488","199193",2003,3915,1665,2250,1595,734,861,51.71,0.5171,0.407,0.326
"8489","199218",2003,1764,1133,631,783,227,556,49.07,0.4907,0.444,0.36
"8490","199281",2003,792,415,377,130,45,85,20.48,0.2048,0.164,0.119
"8491","199306",2003,158,86,72,56,20,36,41.86,0.4186,0.354,0.278
"8492","199412",2003,252,186,66,127,34,93,50,0.5,0.504,0.515
"8493","199582",2003,542,238,304,46,15,31,13.03,0.1303,0.085,0.049
"8494","199643",2003,469,249,220,79,31,48,19.28,0.1928,0.168,0.141
"8495","199847",2003,984,507,477,834,386,448,88.36,0.8836,0.848,0.809
"8496","199962",2003,372,198,174,160,55,105,53.03,0.5303,0.43,0.316
"8497","199999",2003,883,580,303,124,25,99,17.07,0.1707,0.14,0.083
"8498","200004",2003,1485,739,746,394,138,256,34.64,0.3464,0.265,0.185
"8499","200059",2003,383,201,182,42,14,28,13.93,0.1393,0.11,0.077
"8500","200156",2003,261,142,119,82,27,55,38.73,0.3873,0.314,0.227
"8501","200217",2003,390,226,164,147,36,111,49.12,0.4912,0.377,0.22
"8502","200226",2003,135,70,65,26,9,17,24.29,0.2429,0.193,0.138
"8503","200253",2003,435,252,183,70,16,54,21.43,0.2143,0.161,0.087
"8504","200280",2003,2213,1039,1174,511,244,267,25.7,0.257,0.231,0.208
"8505","200332",2003,1944,902,1042,423,178,245,27.16,0.2716,0.218,0.171
"8506","200572",2003,159,71,88,36,15,21,29.58,0.2958,0.226,0.17
"8507","201104",2003,605,379,226,275,76,199,52.51,0.5251,0.455,0.336
"8508","201371",2003,236,143,93,133,51,82,57.34,0.5734,0.564,0.548
"8509","201548",2003,565,352,213,284,100,184,52.27,0.5227,0.503,0.469
"8510","201645",2003,874,350,524,552,292,260,74.29,0.7429,0.632,0.557
"8511","201690",2003,542,277,265,43,10,33,11.91,0.1191,0.079,0.038
"8512","202134",2003,925,463,462,65,34,31,6.7,0.067,0.07,0.074
"8513","202480",2003,1858,956,902,1084,431,653,68.31,0.6831,0.583,0.478
"8514","202523",2003,629,358,271,502,199,303,84.64,0.8464,0.798,0.734
"8515","202763",2003,671,441,230,260,72,188,42.63,0.4263,0.387,0.313
"8516","203085",2003,298,142,156,116,43,73,51.41,0.5141,0.389,0.276
"8517","203128",2003,236,127,109,151,59,92,72.44,0.7244,0.64,0.541
"8518","203368",2003,859,453,406,543,226,317,69.98,0.6998,0.632,0.557
"8519","203517",2003,3746,2293,1453,895,266,629,27.43,0.2743,0.239,0.183
"8520","203535",2003,453,247,206,386,176,210,85.02,0.8502,0.852,0.854
"8521","203580",2003,120,86,34,41,13,28,32.56,0.3256,0.342,0.382
"8522","203775",2003,389,238,151,173,48,125,52.52,0.5252,0.445,0.318
"8523","203845",2003,376,168,208,160,70,90,53.57,0.5357,0.426,0.337
"8524","204024",2003,3362,1844,1518,2371,1002,1369,74.24,0.7424,0.705,0.66
"8525","204185",2003,579,276,303,287,114,173,62.68,0.6268,0.496,0.376
"8526","204194",2003,373,221,152,137,51,86,38.91,0.3891,0.367,0.336
"8527","204617",2003,296,191,105,88,27,61,31.94,0.3194,0.297,0.257
"8528","204796",2003,6347,3201,3146,2938,1132,1806,56.42,0.5642,0.463,0.36
"8529","204857",2003,3587,2026,1561,1722,638,1084,53.5,0.535,0.48,0.409
"8530","206330",2003,216,72,144,27,6,21,29.17,0.2917,0.125,0.042
"8531","206589",2003,552,281,271,373,169,204,72.6,0.726,0.676,0.624
"8532","206604",2003,2272,1312,960,78,16,62,4.73,0.0473,0.034,0.017
"8533","206622",2003,786,428,358,526,230,296,69.16,0.6916,0.669,0.642
"8534","206695",2003,1976,1048,928,207,73,134,12.79,0.1279,0.105,0.079
"8535","206914",2003,667,375,292,34,15,19,5.07,0.0507,0.051,0.051
"8536","207209",2003,553,256,297,23,9,14,5.47,0.0547,0.042,0.03
"8537","207306",2003,308,139,169,45,20,25,17.99,0.1799,0.146,0.118
"8538","207324",2003,356,199,157,99,38,61,30.65,0.3065,0.278,0.242
"8539","207388",2003,3128,1666,1462,958,336,622,37.33,0.3733,0.306,0.23
"8540","207500",2003,3729,1921,1808,1100,406,694,36.13,0.3613,0.295,0.225
"8541","207722",2003,282,172,110,54,11,43,25,0.25,0.191,0.1
"8542","207847",2003,651,339,312,70,27,43,12.68,0.1268,0.108,0.087
"8543","207865",2003,980,492,488,119,38,81,16.46,0.1646,0.121,0.078
"8544","208822",2003,336,203,133,177,73,104,51.23,0.5123,0.527,0.549
"8545","209056",2003,493,308,185,352,127,225,73.05,0.7305,0.714,0.686
"8546","209065",2003,448,243,205,286,101,185,76.13,0.7613,0.638,0.493
"8547","209542",2003,2862,1371,1491,811,321,490,35.74,0.3574,0.283,0.215
"8548","209551",2003,2826,1594,1232,1300,519,781,49,0.49,0.46,0.421
"8549","209612",2003,303,174,129,158,58,100,57.47,0.5747,0.521,0.45
"8550","209807",2003,1264,668,596,159,55,104,15.57,0.1557,0.126,0.092
"8551","209922",2003,297,153,144,169,74,95,62.09,0.6209,0.569,0.514
"8552","210146",2003,896,497,399,158,51,107,21.53,0.2153,0.176,0.128
"8553","210401",2003,541,312,229,383,143,240,76.92,0.7692,0.708,0.624
"8554","210429",2003,903,555,348,144,37,107,19.28,0.1928,0.159,0.106
"8555","210571",2003,456,259,197,252,96,156,60.23,0.6023,0.553,0.487
"8556","210669",2003,478,234,244,317,143,174,74.36,0.7436,0.663,0.586
"8557","210775",2003,278,165,113,99,32,67,40.61,0.4061,0.356,0.283
"8558","211088",2003,489,360,129,259,77,182,50.56,0.5056,0.53,0.597
"8559","211158",2003,1665,1000,665,677,201,476,47.6,0.476,0.407,0.302
"8560","211291",2003,906,462,444,794,374,420,90.91,0.9091,0.876,0.842
"8561","211352",2003,401,270,131,184,55,129,47.78,0.4778,0.459,0.42
"8562","211361",2003,982,520,462,251,105,146,28.08,0.2808,0.256,0.227
"8563","211431",2003,236,229,7,71,3,68,29.69,0.2969,0.301,0.429
"8564","211440",2003,1338,528,810,903,532,371,70.27,0.7027,0.675,0.657
"8565","211468",2003,233,233,0,105,0,105,45.06,0.4506,0.451,NA
"8566","211556",2003,74,74,0,38,0,38,51.35,0.5135,0.514,NA
"8567","211583",2003,188,125,63,66,19,47,37.6,0.376,0.351,0.302
"8568","211608",2003,378,208,170,51,13,38,18.27,0.1827,0.135,0.076
"8569","211644",2003,1219,729,490,366,113,253,34.71,0.3471,0.3,0.231
"8570","211981",2003,438,198,240,164,70,94,47.47,0.4747,0.374,0.292
"8571","212009",2003,624,356,268,496,205,291,81.74,0.8174,0.795,0.765
"8572","212054",2003,1980,768,1212,486,176,310,40.36,0.4036,0.245,0.145
"8573","212106",2003,1485,899,586,774,283,491,54.62,0.5462,0.521,0.483
"8574","212115",2003,1076,650,426,394,107,287,44.15,0.4415,0.366,0.251
"8575","212133",2003,438,298,140,242,74,168,56.38,0.5638,0.553,0.529
"8576","212160",2003,1392,818,574,304,103,201,24.57,0.2457,0.218,0.179
"8577","212197",2003,495,326,169,328,100,228,69.94,0.6994,0.663,0.592
"8578","212577",2003,503,233,270,398,198,200,85.84,0.8584,0.791,0.733
"8579","212601",2003,587,339,248,246,91,155,45.72,0.4572,0.419,0.367
"8580","212832",2003,322,245,77,105,26,79,32.24,0.3224,0.326,0.338
"8581","212911",2003,313,164,149,275,132,143,87.2,0.872,0.879,0.886
"8582","213020",2003,2847,1669,1178,822,242,580,34.75,0.3475,0.289,0.205
"8583","213251",2003,381,200,181,284,135,149,74.5,0.745,0.745,0.746
"8584","213321",2003,448,166,282,284,164,120,72.29,0.7229,0.634,0.582
"8585","213349",2003,1825,1035,790,549,158,391,37.78,0.3778,0.301,0.2
"8586","213358",2003,174,124,50,58,13,45,36.29,0.3629,0.333,0.26
"8587","213367",2003,809,423,386,461,204,257,60.76,0.6076,0.57,0.528
"8588","213385",2003,584,268,316,502,267,235,87.69,0.8769,0.86,0.845
"8589","213507",2003,429,231,198,292,119,173,74.89,0.7489,0.681,0.601
"8590","213543",2003,1124,448,676,854,487,367,81.92,0.8192,0.76,0.72
"8591","213613",2003,1145,657,488,316,104,212,32.27,0.3227,0.276,0.213
"8592","213668",2003,381,226,155,254,97,157,69.47,0.6947,0.667,0.626
"8593","213783",2003,690,403,287,179,74,105,26.05,0.2605,0.259,0.258
"8594","213826",2003,277,199,78,152,34,118,59.3,0.593,0.549,0.436
"8595","213996",2003,735,463,272,529,189,340,73.43,0.7343,0.72,0.695
"8596","214041",2003,1334,754,580,478,159,319,42.31,0.4231,0.358,0.274
"8597","214069",2003,313,233,80,206,49,157,67.38,0.6738,0.658,0.613
"8598","214157",2003,379,239,140,270,90,180,75.31,0.7531,0.712,0.643
"8599","214175",2003,589,354,235,485,179,306,86.44,0.8644,0.823,0.762
"8600","214272",2003,510,327,183,209,72,137,41.9,0.419,0.41,0.393
"8601","214777",2003,6035,3058,2977,3747,1598,2149,70.27,0.7027,0.621,0.537
"8602","215062",2003,2378,1221,1157,2082,992,1090,89.27,0.8927,0.876,0.857
"8603","215743",2003,332,200,132,174,63,111,55.5,0.555,0.524,0.477
"8604","215798",2003,362,196,166,221,91,130,66.33,0.6633,0.61,0.548
"8605","215929",2003,974,538,436,716,307,409,76.02,0.7602,0.735,0.704
"8606","216010",2003,1485,742,743,666,271,395,53.23,0.5323,0.448,0.365
"8607","216038",2003,1465,803,662,455,158,297,36.99,0.3699,0.311,0.239
"8608","216287",2003,368,198,170,316,141,175,88.38,0.8838,0.859,0.829
"8609","216339",2003,3590,2106,1484,1232,459,773,36.7,0.367,0.343,0.309
"8610","216524",2003,453,233,220,356,163,193,82.83,0.8283,0.786,0.741
"8611","216694",2003,327,157,170,157,70,87,55.41,0.5541,0.48,0.412
"8612","216764",2003,1723,1119,604,685,152,533,47.63,0.4763,0.398,0.252
"8613","216807",2003,337,206,131,200,61,139,67.48,0.6748,0.593,0.466
"8614","216852",2003,578,286,292,237,90,147,51.4,0.514,0.41,0.308
"8615","216931",2003,509,235,274,254,107,147,62.55,0.6255,0.499,0.391
"8616","217059",2003,1013,541,472,425,171,254,46.95,0.4695,0.42,0.362
"8617","217156",2003,1392,736,656,1192,539,653,88.72,0.8872,0.856,0.822
"8618","217402",2003,975,561,414,823,339,484,86.27,0.8627,0.844,0.819
"8619","217536",2003,571,401,170,361,91,270,67.33,0.6733,0.632,0.535
"8620","217776",2003,160,100,60,41,17,24,24,0.24,0.256,0.283
"8621","217819",2003,1868,1229,639,896,251,645,52.48,0.5248,0.48,0.393
"8622","217882",2003,2748,1293,1455,1379,535,844,65.27,0.6527,0.502,0.368
"8623","217998",2003,176,102,74,111,43,68,66.67,0.6667,0.631,0.581
"8624","218061",2003,765,447,318,153,48,105,23.49,0.2349,0.2,0.151
"8625","218229",2003,541,356,185,139,30,109,30.62,0.3062,0.257,0.162
"8626","218238",2003,176,98,78,35,15,20,20.41,0.2041,0.199,0.192
"8627","218399",2003,276,168,108,46,9,37,22.02,0.2202,0.167,0.083
"8628","218414",2003,203,69,134,64,36,28,40.58,0.4058,0.315,0.269
"8629","218663",2003,3441,1949,1492,1578,586,992,50.9,0.509,0.459,0.393
"8630","218724",2003,1266,618,648,283,109,174,28.16,0.2816,0.224,0.168
"8631","218733",2003,794,453,341,106,33,73,16.11,0.1611,0.134,0.097
"8632","218742",2003,684,450,234,139,35,104,23.11,0.2311,0.203,0.15
"8633","218973",2003,330,163,167,255,127,128,78.53,0.7853,0.773,0.76
"8634","219000",2003,424,281,143,217,61,156,55.52,0.5552,0.512,0.427
"8635","219046",2003,653,409,244,62,17,45,11,0.11,0.095,0.07
"8636","219082",2003,290,120,170,43,18,25,20.83,0.2083,0.148,0.106
"8637","219198",2003,158,113,45,33,11,22,19.47,0.1947,0.209,0.244
"8638","219259",2003,380,210,170,59,16,43,20.48,0.2048,0.155,0.094
"8639","219356",2003,1993,957,1036,427,176,251,26.23,0.2623,0.214,0.17
"8640","219471",2003,982,539,443,186,76,110,20.41,0.2041,0.189,0.172
"8641","219602",2003,967,609,358,118,33,85,13.96,0.1396,0.122,0.092
"8642","219709",2003,599,360,239,312,110,202,56.11,0.5611,0.521,0.46
"8643","219718",2003,129,59,70,27,10,17,28.81,0.2881,0.209,0.143
"8644","219949",2003,149,76,73,24,9,15,19.74,0.1974,0.161,0.123
"8645","220075",2003,1563,921,642,301,99,202,21.93,0.2193,0.193,0.154
"8646","220215",2003,374,211,163,138,53,85,40.28,0.4028,0.369,0.325
"8647","220613",2003,646,393,253,197,66,131,33.33,0.3333,0.305,0.261
"8648","220631",2003,183,129,54,33,7,26,20.16,0.2016,0.18,0.13
"8649","220710",2003,293,140,153,133,51,82,58.57,0.5857,0.454,0.333
"8650","221351",2003,456,274,182,343,140,203,74.09,0.7409,0.752,0.769
"8651","221519",2003,426,239,187,318,142,176,73.64,0.7364,0.746,0.759
"8652","221731",2003,106,63,43,33,4,29,46.03,0.4603,0.311,0.093
"8653","221847",2003,1374,577,797,300,133,167,28.94,0.2894,0.218,0.167
"8654","221892",2003,219,126,93,82,31,51,40.48,0.4048,0.374,0.333
"8655","222178",2003,948,489,459,369,125,244,49.9,0.499,0.389,0.272
"8656","222983",2003,338,193,145,228,86,142,73.58,0.7358,0.675,0.593
"8657","223232",2003,2667,1673,994,1266,347,919,54.93,0.5493,0.475,0.349
"8658","224004",2003,154,83,71,26,13,13,15.66,0.1566,0.169,0.183
"8659","224323",2003,299,189,110,185,58,127,67.2,0.672,0.619,0.527
"8660","225432",2003,1012,559,453,16,5,11,1.97,0.0197,0.016,0.011
"8661","225548",2003,293,136,157,76,27,49,36.03,0.3603,0.259,0.172
"8662","225627",2003,396,280,116,70,18,52,18.57,0.1857,0.177,0.155
"8663","226231",2003,333,94,239,93,52,41,43.62,0.4362,0.279,0.218
"8664","226833",2003,613,302,311,41,18,23,7.62,0.0762,0.067,0.058
"8665","227216",2003,3320,1945,1375,632,194,438,22.52,0.2252,0.19,0.141
"8666","227331",2003,322,238,84,60,10,50,21.01,0.2101,0.186,0.119
"8667","227526",2003,1553,820,733,175,71,104,12.68,0.1268,0.113,0.097
"8668","227757",2003,716,364,352,591,279,312,85.71,0.8571,0.825,0.793
"8669","227845",2003,544,327,217,239,78,161,49.24,0.4924,0.439,0.359
"8670","227863",2003,292,172,120,87,33,54,31.4,0.314,0.298,0.275
"8671","228042",2003,168,88,80,40,14,26,29.55,0.2955,0.238,0.175
"8672","228149",2003,470,292,178,147,41,106,36.3,0.363,0.313,0.23
"8673","228246",2003,1383,772,611,853,324,529,68.52,0.6852,0.617,0.53
"8674","228343",2003,343,196,147,234,80,154,78.57,0.7857,0.682,0.544
"8675","228431",2003,1839,1148,691,348,88,260,22.65,0.2265,0.189,0.127
"8676","228459",2003,2818,1681,1137,667,195,472,28.08,0.2808,0.237,0.172
"8677","228501",2003,357,163,194,30,11,19,11.66,0.1166,0.084,0.057
"8678","228529",2003,1277,686,591,201,62,139,20.26,0.2026,0.157,0.105
"8679","228705",2003,828,370,458,60,24,36,9.73,0.0973,0.072,0.052
"8680","228723",2003,6389,3358,3031,2898,981,1917,57.09,0.5709,0.454,0.324
"8681","228769",2003,2431,1182,1249,364,144,220,18.61,0.1861,0.15,0.115
"8682","228778",2003,6477,3537,2940,3300,1309,1991,56.29,0.5629,0.509,0.445
"8683","228787",2003,1043,420,623,446,242,204,48.57,0.4857,0.428,0.388
"8684","228796",2003,2386,1237,1149,111,46,65,5.25,0.0525,0.047,0.04
"8685","228875",2003,1598,1005,593,877,273,604,60.1,0.601,0.549,0.46
"8686","228981",2003,375,212,163,117,38,79,37.26,0.3726,0.312,0.233
"8687","229018",2003,292,160,132,52,19,33,20.62,0.2062,0.178,0.144
"8688","229027",2003,4091,2070,2021,310,107,203,9.81,0.0981,0.076,0.053
"8689","229115",2003,4312,2039,2273,1372,547,825,40.46,0.4046,0.318,0.241
"8690","229780",2003,205,112,93,41,13,28,25,0.25,0.2,0.14
"8691","229814",2003,774,404,370,125,31,94,23.27,0.2327,0.161,0.084
"8692","230603",2003,478,338,140,103,17,86,25.44,0.2544,0.215,0.121
"8693","230728",2003,1829,1229,600,491,86,405,32.95,0.3295,0.268,0.143
"8694","230764",2003,1870,1073,797,405,129,276,25.72,0.2572,0.217,0.162
"8695","230782",2003,1688,944,744,90,31,59,6.25,0.0625,0.053,0.042
"8696","231059",2003,512,263,249,362,158,204,77.57,0.7757,0.707,0.635
"8697","231174",2003,1916,1089,827,1087,439,648,59.5,0.595,0.567,0.531
"8698","231420",2003,219,83,136,78,34,44,53.01,0.5301,0.356,0.25
"8699","231554",2003,83,50,33,27,10,17,34,0.34,0.325,0.303
"8700","231624",2003,1319,736,583,1098,439,659,89.54,0.8954,0.832,0.753
"8701","231712",2003,1205,619,586,475,176,299,48.3,0.483,0.394,0.3
"8702","232025",2003,223,106,117,96,43,53,50,0.5,0.43,0.368
"8703","232043",2003,195,121,74,94,32,62,51.24,0.5124,0.482,0.432
"8704","232089",2003,301,106,195,71,37,34,32.08,0.3208,0.236,0.19
"8705","232186",2003,2191,1166,1025,847,284,563,48.28,0.4828,0.387,0.277
"8706","232265",2003,1379,873,506,506,131,375,42.96,0.4296,0.367,0.259
"8707","232423",2003,3386,2167,1219,2220,697,1523,70.28,0.7028,0.656,0.572
"8708","232557",2003,1811,1024,787,506,190,316,30.86,0.3086,0.279,0.241
"8709","232566",2003,872,576,296,340,91,249,43.23,0.4323,0.39,0.307
"8710","232609",2003,589,342,247,316,116,200,58.48,0.5848,0.537,0.47
"8711","232681",2003,879,572,307,590,181,409,71.5,0.715,0.671,0.59
"8712","232706",2003,379,290,89,158,30,128,44.14,0.4414,0.417,0.337
"8713","232937",2003,1080,593,487,123,41,82,13.83,0.1383,0.114,0.084
"8714","232982",2003,2001,1139,862,457,136,321,28.18,0.2818,0.228,0.158
"8715","233277",2003,1800,1097,703,719,214,505,46.03,0.4603,0.399,0.304
"8716","233374",2003,835,440,395,688,313,375,85.23,0.8523,0.824,0.792
"8717","233426",2003,519,282,237,301,130,171,60.64,0.6064,0.58,0.549
"8718","233541",2003,328,185,143,106,34,72,38.92,0.3892,0.323,0.238
"8719","233897",2003,349,177,172,109,39,70,39.55,0.3955,0.312,0.227
"8720","233921",2003,4923,2092,2831,2588,1213,1375,65.73,0.6573,0.526,0.428
"8721","234030",2003,3230,1912,1318,779,218,561,29.34,0.2934,0.241,0.165
"8722","234085",2003,384,36,348,246,223,23,63.89,0.6389,0.641,0.641
"8723","234155",2003,959,563,396,240,62,178,31.62,0.3162,0.25,0.157
"8724","234164",2003,512,318,194,99,16,83,26.1,0.261,0.193,0.082
"8725","235097",2003,1374,843,531,295,81,214,25.39,0.2539,0.215,0.153
"8726","235167",2003,454,246,208,193,98,95,38.62,0.3862,0.425,0.471
"8727","236230",2003,693,426,267,361,118,243,57.04,0.5704,0.521,0.442
"8728","236328",2003,639,358,281,438,164,274,76.54,0.7654,0.685,0.584
"8729","236577",2003,683,485,198,410,105,305,62.89,0.6289,0.6,0.53
"8730","236595",2003,619,418,201,323,75,248,59.33,0.5933,0.522,0.373
"8731","236896",2003,326,157,169,66,31,35,22.29,0.2229,0.202,0.183
"8732","236939",2003,2997,1613,1384,1204,417,787,48.79,0.4879,0.402,0.301
"8733","236948",2003,4948,2654,2294,2665,1106,1559,58.74,0.5874,0.539,0.482
"8734","237011",2003,2194,1266,928,778,233,545,43.05,0.4305,0.355,0.251
"8735","237057",2003,362,182,180,294,144,150,82.42,0.8242,0.812,0.8
"8736","237066",2003,438,259,179,267,105,162,62.55,0.6255,0.61,0.587
"8737","237215",2003,273,155,118,15,7,8,5.16,0.0516,0.055,0.059
"8738","237330",2003,508,286,222,98,29,69,24.13,0.2413,0.193,0.131
"8739","237358",2003,104,60,44,27,8,19,31.67,0.3167,0.26,0.182
"8740","237367",2003,631,317,314,85,31,54,17.03,0.1703,0.135,0.099
"8741","237792",2003,768,440,328,134,48,86,19.55,0.1955,0.174,0.146
"8742","237899",2003,333,187,146,20,6,14,7.49,0.0749,0.06,0.041
"8743","237932",2003,453,248,205,69,16,53,21.37,0.2137,0.152,0.078
"8744","237969",2003,457,257,200,197,64,133,51.75,0.5175,0.431,0.32
"8745","238032",2003,4366,2104,2262,1387,583,804,38.21,0.3821,0.318,0.258
"8746","238333",2003,346,217,129,251,88,163,75.12,0.7512,0.725,0.682
"8747","238430",2003,205,136,69,28,11,17,12.5,0.125,0.137,0.159
"8748","238458",2003,501,329,172,220,62,158,48.02,0.4802,0.439,0.36
"8749","238476",2003,575,307,268,249,103,146,47.56,0.4756,0.433,0.384
"8750","238616",2003,352,192,160,111,35,76,39.58,0.3958,0.315,0.219
"8751","238661",2003,307,229,78,85,14,71,31,0.31,0.277,0.179
"8752","239080",2003,251,170,81,72,17,55,32.35,0.3235,0.287,0.21
"8753","239105",2003,1882,1042,840,1125,462,663,63.63,0.6363,0.598,0.55
"8754","239628",2003,259,130,129,156,72,84,64.62,0.6462,0.602,0.558
"8755","239716",2003,529,289,240,336,128,208,71.97,0.7197,0.635,0.533
"8756","240107",2003,355,261,94,107,18,89,34.1,0.341,0.301,0.191
"8757","240189",2003,1825,975,850,459,199,260,26.67,0.2667,0.252,0.234
"8758","240277",2003,960,640,320,241,70,171,26.72,0.2672,0.251,0.219
"8759","240329",2003,1506,984,522,507,153,354,35.98,0.3598,0.337,0.293
"8760","240338",2003,207,126,81,110,31,79,62.7,0.627,0.531,0.383
"8761","240365",2003,1765,1077,688,261,67,194,18.01,0.1801,0.148,0.097
"8762","240374",2003,863,469,394,68,27,41,8.74,0.0874,0.079,0.069
"8763","240417",2003,1267,654,613,244,75,169,25.84,0.2584,0.193,0.122
"8764","240426",2003,336,213,123,66,14,52,24.41,0.2441,0.196,0.114
"8765","240444",2003,5553,2968,2585,2689,1114,1575,53.07,0.5307,0.484,0.431
"8766","240453",2003,3716,2023,1693,552,217,335,16.56,0.1656,0.149,0.128
"8767","240462",2003,1116,406,710,203,105,98,24.14,0.2414,0.182,0.148
"8768","240471",2003,1220,757,463,305,98,207,27.34,0.2734,0.25,0.212
"8769","240480",2003,1498,853,645,335,101,234,27.43,0.2743,0.224,0.157
"8770","240727",2003,1388,709,679,310,102,208,29.34,0.2934,0.223,0.15
"8771","243443",2003,425,274,151,10,3,7,2.55,0.0255,0.024,0.02
"8772","243780",2003,6459,2559,3900,2254,1121,1133,44.28,0.4428,0.349,0.287
"8773","100654",2004,1198,611,587,146,31,115,18.82,0.1882,0.122,0.053
"8774","100663",2004,1536,973,563,284,82,202,20.76,0.2076,0.185,0.146
"8775","100751",2004,3290,1853,1437,1248,426,822,44.36,0.4436,0.379,0.296
"8776","100858",2004,3579,1849,1730,1279,445,834,45.11,0.4511,0.357,0.257
"8777","101435",2004,192,72,120,71,38,33,45.83,0.4583,0.37,0.317
"8778","101480",2004,1017,555,462,91,20,71,12.79,0.1279,0.089,0.043
"8779","101675",2004,427,203,224,49,9,40,19.7,0.197,0.115,0.04
"8780","101879",2004,856,469,387,107,27,80,17.06,0.1706,0.125,0.07
"8781","102049",2004,665,423,242,359,111,248,58.63,0.5863,0.54,0.459
"8782","102094",2004,1278,725,553,180,60,120,16.55,0.1655,0.141,0.108
"8783","102234",2004,309,203,106,156,44,112,55.17,0.5517,0.505,0.415
"8784","102368",2004,1450,788,662,230,67,163,20.69,0.2069,0.159,0.101
"8785","102377",2004,701,389,312,123,35,88,22.62,0.2262,0.175,0.112
"8786","104151",2004,7293,3998,3295,2324,816,1508,37.72,0.3772,0.319,0.248
"8787","104179",2004,5566,3008,2558,1880,723,1157,38.46,0.3846,0.338,0.283
"8788","105330",2004,2274,1309,965,652,190,462,35.29,0.3529,0.287,0.197
"8789","106245",2004,759,452,307,54,18,36,7.96,0.0796,0.071,0.059
"8790","106342",2004,141,66,75,62,37,25,37.88,0.3788,0.44,0.493
"8791","106397",2004,2420,1222,1198,835,329,506,41.41,0.4141,0.345,0.275
"8792","106412",2004,690,365,325,47,14,33,9.04,0.0904,0.068,0.043
"8793","106458",2004,1296,749,547,212,71,141,18.83,0.1883,0.164,0.13
"8794","106467",2004,1398,728,670,199,72,127,17.45,0.1745,0.142,0.107
"8795","106485",2004,629,327,302,60,25,35,10.7,0.107,0.095,0.083
"8796","106704",2004,2216,1313,903,468,131,337,25.67,0.2567,0.211,0.145
"8797","107044",2004,961,516,445,387,161,226,43.8,0.438,0.403,0.362
"8798","107080",2004,295,165,130,159,69,90,54.55,0.5455,0.539,0.531
"8799","107141",2004,296,156,140,155,67,88,56.41,0.5641,0.524,0.479
"8800","107512",2004,380,223,157,170,49,121,54.26,0.5426,0.447,0.312
"8801","107558",2004,134,74,60,44,18,26,35.14,0.3514,0.328,0.3
"8802","110097",2004,691,443,248,346,120,226,51.02,0.5102,0.501,0.484
"8803","110404",2004,207,59,148,167,117,50,84.75,0.8475,0.807,0.791
"8804","110422",2004,2900,1169,1731,767,304,463,39.61,0.3961,0.264,0.176
"8805","110486",2004,745,483,262,128,32,96,19.88,0.1988,0.172,0.122
"8806","110495",2004,653,456,197,153,41,112,24.56,0.2456,0.234,0.208
"8807","110510",2004,1587,1099,488,208,53,155,14.1,0.141,0.131,0.109
"8808","110529",2004,2115,921,1194,412,188,224,24.32,0.2432,0.195,0.157
"8809","110538",2004,2198,1266,932,436,102,334,26.38,0.2638,0.198,0.109
"8810","110547",2004,673,459,214,35,10,25,5.45,0.0545,0.052,0.047
"8811","110556",2004,2243,1351,892,378,102,276,20.43,0.2043,0.169,0.114
"8812","110565",2004,3539,2094,1445,583,148,435,20.77,0.2077,0.165,0.102
"8813","110574",2004,840,516,324,122,38,84,16.28,0.1628,0.145,0.117
"8814","110583",2004,3300,2222,1078,406,103,303,13.64,0.1364,0.123,0.096
"8815","110592",2004,1087,687,400,87,22,65,9.46,0.0946,0.08,0.055
"8816","110617",2004,2268,1375,893,240,57,183,13.31,0.1331,0.106,0.064
"8817","113698",2004,276,205,71,119,24,95,46.34,0.4634,0.431,0.338
"8818","115755",2004,760,427,333,66,18,48,11.24,0.1124,0.087,0.054
"8819","119173",2004,364,352,12,93,4,89,25.28,0.2528,0.255,0.333
"8820","120184",2004,161,108,53,68,19,49,45.37,0.4537,0.422,0.358
"8821","121309",2004,535,339,196,395,141,254,74.93,0.7493,0.738,0.719
"8822","121345",2004,393,196,197,356,181,175,89.29,0.8929,0.906,0.919
"8823","122409",2004,3527,2128,1399,1073,307,766,36,0.36,0.304,0.219
"8824","122436",2004,1174,705,469,706,259,447,63.4,0.634,0.601,0.552
"8825","122597",2004,2739,1770,969,390,114,276,15.59,0.1559,0.142,0.118
"8826","122612",2004,929,614,315,518,151,367,59.77,0.5977,0.558,0.479
"8827","122931",2004,1171,658,513,941,392,549,83.43,0.8343,0.804,0.764
"8828","123554",2004,603,388,215,319,102,217,55.93,0.5593,0.529,0.474
"8829","123572",2004,1102,713,389,344,76,268,37.59,0.3759,0.312,0.195
"8830","126562",2004,686,387,299,101,34,67,17.31,0.1731,0.147,0.114
"8831","126580",2004,939,562,377,198,54,144,25.62,0.2562,0.211,0.143
"8832","126614",2004,5124,2484,2640,2093,909,1184,47.67,0.4767,0.408,0.344
"8833","126818",2004,4047,2216,1831,1484,522,962,43.41,0.4341,0.367,0.285
"8834","127060",2004,1124,588,536,633,286,347,59.01,0.5901,0.563,0.534
"8835","127185",2004,930,448,482,181,67,114,25.45,0.2545,0.195,0.139
"8836","127565",2004,1815,937,878,86,34,52,5.55,0.0555,0.047,0.039
"8837","127741",2004,2412,1459,953,648,190,458,31.39,0.3139,0.269,0.199
"8838","128106",2004,753,423,330,118,34,84,19.86,0.1986,0.157,0.103
"8839","128744",2004,241,134,107,47,19,28,20.9,0.209,0.195,0.178
"8840","128771",2004,1278,596,682,213,80,133,22.32,0.2232,0.167,0.117
"8841","129020",2004,3229,1789,1440,2104,830,1274,71.21,0.7121,0.652,0.576
"8842","129242",2004,856,475,381,679,282,397,83.58,0.8358,0.793,0.74
"8843","129941",2004,571,264,307,197,111,86,32.58,0.3258,0.345,0.362
"8844","130253",2004,876,521,355,528,196,332,63.72,0.6372,0.603,0.552
"8845","130314",2004,189,189,0,56,0,56,29.63,0.2963,0.296,NA
"8846","130493",2004,1396,899,497,219,46,173,19.24,0.1924,0.157,0.093
"8847","130590",2004,569,283,286,442,213,229,80.92,0.8092,0.777,0.745
"8848","130697",2004,728,385,343,649,300,349,90.65,0.9065,0.891,0.875
"8849","130776",2004,755,382,373,120,53,67,17.54,0.1754,0.159,0.142
"8850","130794",2004,1306,632,674,1161,589,572,90.51,0.9051,0.889,0.874
"8851","130934",2004,687,400,287,133,23,110,27.5,0.275,0.194,0.08
"8852","130943",2004,3769,2173,1596,2131,776,1355,62.36,0.6236,0.565,0.486
"8853","131159",2004,1210,776,434,902,306,596,76.8,0.768,0.745,0.705
"8854","131283",2004,719,387,332,429,182,247,63.82,0.6382,0.597,0.548
"8855","131450",2004,227,121,106,18,8,10,8.26,0.0826,0.079,0.075
"8856","131469",2004,2623,1441,1182,1957,830,1127,78.21,0.7821,0.746,0.702
"8857","131496",2004,1523,855,668,1358,574,784,91.7,0.917,0.892,0.859
"8858","131520",2004,1445,987,458,691,151,540,54.71,0.5471,0.478,0.33
"8859","132471",2004,553,349,204,101,29,72,20.63,0.2063,0.183,0.142
"8860","132602",2004,818,503,315,118,29,89,17.69,0.1769,0.144,0.092
"8861","132903",2004,5710,3041,2669,1986,723,1263,41.53,0.4153,0.348,0.271
"8862","133492",2004,471,272,199,297,119,178,65.44,0.6544,0.631,0.598
"8863","133553",2004,933,139,794,282,231,51,36.69,0.3669,0.302,0.291
"8864","133650",2004,2105,1242,863,268,73,195,15.7,0.157,0.127,0.085
"8865","133669",2004,2278,1231,1047,364,122,242,19.66,0.1966,0.16,0.117
"8866","133711",2004,500,296,204,250,98,152,51.35,0.5135,0.5,0.48
"8867","133881",2004,551,181,370,218,132,86,47.51,0.4751,0.396,0.357
"8868","133951",2004,3370,1906,1464,647,198,449,23.56,0.2356,0.192,0.135
"8869","134079",2004,553,342,211,227,70,157,45.91,0.4591,0.41,0.332
"8870","134097",2004,6198,3727,2471,3112,1029,2083,55.89,0.5589,0.502,0.416
"8871","134130",2004,6621,3706,2915,3933,1418,2515,67.86,0.6786,0.594,0.486
"8872","134945",2004,462,197,265,118,59,59,29.95,0.2995,0.255,0.223
"8873","135726",2004,2025,1157,868,1381,551,830,71.74,0.7174,0.682,0.635
"8874","136172",2004,2199,1252,947,447,116,331,26.44,0.2644,0.203,0.122
"8875","136950",2004,486,284,202,285,116,169,59.51,0.5951,0.586,0.574
"8876","137546",2004,598,354,244,303,100,203,57.34,0.5734,0.507,0.41
"8877","138354",2004,859,475,384,168,57,111,23.37,0.2337,0.196,0.148
"8878","138716",2004,602,399,203,98,22,76,19.05,0.1905,0.163,0.108
"8879","138789",2004,776,449,327,70,21,49,10.91,0.1091,0.09,0.064
"8880","139144",2004,514,349,165,261,76,185,53.01,0.5301,0.508,0.461
"8881","139366",2004,972,584,388,116,31,85,14.55,0.1455,0.119,0.08
"8882","139393",2004,260,156,104,123,41,82,52.56,0.5256,0.473,0.394
"8883","139658",2004,1587,911,676,1044,436,608,66.74,0.6674,0.658,0.645
"8884","139719",2004,456,227,229,66,18,48,21.15,0.2115,0.145,0.079
"8885","139755",2004,2572,766,1806,845,514,331,43.21,0.4321,0.329,0.285
"8886","139764",2004,359,247,112,40,6,34,13.77,0.1377,0.111,0.054
"8887","139861",2004,918,582,336,322,90,232,39.86,0.3986,0.351,0.268
"8888","139931",2004,2982,1393,1589,546,158,388,27.85,0.2785,0.183,0.099
"8889","139940",2004,2272,1338,934,389,132,257,19.21,0.1921,0.171,0.141
"8890","139959",2004,4500,2724,1776,2335,774,1561,57.31,0.5731,0.519,0.436
"8891","140447",2004,632,373,259,270,90,180,48.26,0.4826,0.427,0.347
"8892","140960",2004,568,316,252,73,22,51,16.14,0.1614,0.129,0.087
"8893","140988",2004,226,128,98,95,31,64,50,0.5,0.42,0.316
"8894","141185",2004,161,98,63,67,20,47,47.96,0.4796,0.416,0.317
"8895","141264",2004,1690,969,721,279,78,201,20.74,0.2074,0.165,0.108
"8896","141334",2004,1702,976,726,202,67,135,13.83,0.1383,0.119,0.092
"8897","141486",2004,247,167,80,62,21,41,24.55,0.2455,0.251,0.262
"8898","141565",2004,412,225,187,50,18,32,14.22,0.1422,0.121,0.096
"8899","141574",2004,1892,1039,853,325,109,216,20.79,0.2079,0.172,0.128
"8900","142276",2004,983,522,461,63,18,45,8.62,0.0862,0.064,0.039
"8901","142285",2004,1602,755,847,383,147,236,31.26,0.3126,0.239,0.174
"8902","142461",2004,247,159,88,99,28,71,44.65,0.4465,0.401,0.318
"8903","143084",2004,599,321,278,426,178,248,77.26,0.7726,0.711,0.64
"8904","143288",2004,176,87,89,55,23,32,36.78,0.3678,0.312,0.258
"8905","144005",2004,563,367,196,17,13,4,1.09,0.0109,0.03,0.066
"8906","144281",2004,1744,873,871,449,217,232,26.58,0.2658,0.257,0.249
"8907","144740",2004,2304,1367,937,1097,377,720,52.67,0.5267,0.476,0.402
"8908","144892",2004,1725,1032,693,594,177,417,40.41,0.4041,0.344,0.255
"8909","144962",2004,386,225,161,215,66,149,66.22,0.6622,0.557,0.41
"8910","144971",2004,116,57,59,35,15,20,35.09,0.3509,0.302,0.254
"8911","145600",2004,2671,1488,1183,681,278,403,27.08,0.2708,0.255,0.235
"8912","145619",2004,301,151,150,121,53,68,45.03,0.4503,0.402,0.353
"8913","145637",2004,7225,3555,3670,4848,2215,2633,74.06,0.7406,0.671,0.604
"8914","145691",2004,258,136,122,135,49,86,63.24,0.6324,0.523,0.402
"8915","145813",2004,2824,1739,1085,1280,392,888,51.06,0.5106,0.453,0.361
"8916","146481",2004,405,247,158,257,83,174,70.45,0.7045,0.635,0.525
"8917","146612",2004,509,275,234,186,81,105,38.18,0.3818,0.365,0.346
"8918","146719",2004,1787,1176,611,856,296,560,47.62,0.4762,0.479,0.484
"8919","146825",2004,152,74,78,37,17,20,27.03,0.2703,0.243,0.218
"8920","147013",2004,337,134,203,122,55,67,50,0.5,0.362,0.271
"8921","147244",2004,530,302,228,268,99,169,55.96,0.5596,0.506,0.434
"8922","147341",2004,389,227,162,169,59,110,48.46,0.4846,0.434,0.364
"8923","147703",2004,2933,1585,1348,807,334,473,29.84,0.2984,0.275,0.248
"8924","147767",2004,1914,1030,884,1652,728,924,89.71,0.8971,0.863,0.824
"8925","147776",2004,972,580,392,37,7,30,5.17,0.0517,0.038,0.018
"8926","147828",2004,699,427,272,338,97,241,56.44,0.5644,0.484,0.357
"8927","148131",2004,228,124,104,75,27,48,38.71,0.3871,0.329,0.26
"8928","148496",2004,271,181,90,156,41,115,63.54,0.6354,0.576,0.456
"8929","148584",2004,157,94,63,64,21,43,45.74,0.4574,0.408,0.333
"8930","148627",2004,406,259,147,130,44,86,33.2,0.332,0.32,0.299
"8931","149222",2004,2545,1053,1492,646,308,338,32.1,0.321,0.254,0.206
"8932","149231",2004,1695,986,709,485,162,323,32.76,0.3276,0.286,0.228
"8933","149772",2004,2056,1025,1031,681,301,380,37.07,0.3707,0.331,0.292
"8934","149781",2004,595,318,277,469,202,267,83.96,0.8396,0.788,0.729
"8935","150066",2004,579,340,239,248,92,156,45.88,0.4588,0.428,0.385
"8936","150136",2004,3662,1951,1711,1141,390,751,38.49,0.3849,0.312,0.228
"8937","150145",2004,306,174,132,125,38,87,50,0.5,0.408,0.288
"8938","150163",2004,925,571,354,458,143,315,55.17,0.5517,0.495,0.404
"8939","150400",2004,661,367,294,546,229,317,86.38,0.8638,0.826,0.779
"8940","150534",2004,634,382,252,357,131,226,59.16,0.5916,0.563,0.52
"8941","150668",2004,168,95,73,84,38,46,48.42,0.4842,0.5,0.521
"8942","150941",2004,203,123,80,108,44,64,52.03,0.5203,0.532,0.55
"8943","151102",2004,1553,859,694,103,29,74,8.61,0.0861,0.066,0.042
"8944","151111",2004,2294,1371,923,226,80,146,10.65,0.1065,0.099,0.087
"8945","151306",2004,2004,1196,808,269,71,198,16.56,0.1656,0.134,0.088
"8946","151324",2004,1813,901,912,341,128,213,23.64,0.2364,0.188,0.14
"8947","151333",2004,356,237,119,18,5,13,5.49,0.0549,0.051,0.042
"8948","151342",2004,704,432,272,29,11,18,4.17,0.0417,0.041,0.04
"8949","151351",2004,6300,3407,2893,3110,1273,1837,53.92,0.5392,0.494,0.44
"8950","151360",2004,604,375,229,28,10,18,4.8,0.048,0.046,0.044
"8951","151379",2004,714,420,294,63,12,51,12.14,0.1214,0.088,0.041
"8952","151388",2004,270,182,88,14,3,11,6.04,0.0604,0.052,0.034
"8953","151777",2004,278,154,124,113,34,79,51.3,0.513,0.406,0.274
"8954","151786",2004,245,166,79,84,26,58,34.94,0.3494,0.343,0.329
"8955","152080",2004,1987,947,1040,1789,914,875,92.4,0.924,0.9,0.879
"8956","152248",2004,954,492,462,55,24,31,6.3,0.063,0.058,0.052
"8957","152363",2004,246,145,101,128,37,91,62.76,0.6276,0.52,0.366
"8958","152530",2004,476,265,211,334,134,200,75.47,0.7547,0.702,0.635
"8959","152600",2004,746,376,370,446,201,245,65.16,0.6516,0.598,0.543
"8960","153001",2004,331,173,158,150,63,87,50.29,0.5029,0.453,0.399
"8961","153108",2004,441,223,218,260,118,142,63.68,0.6368,0.59,0.541
"8962","153269",2004,782,462,320,408,162,246,53.25,0.5325,0.522,0.506
"8963","153384",2004,434,237,197,363,155,208,87.76,0.8776,0.836,0.787
"8964","153603",2004,3674,1618,2056,1348,572,776,47.96,0.4796,0.367,0.278
"8965","153834",2004,661,387,274,435,183,252,65.12,0.6512,0.658,0.668
"8966","154095",2004,1652,995,657,581,172,409,41.11,0.4111,0.352,0.262
"8967","155089",2004,207,112,95,27,14,13,11.61,0.1161,0.13,0.147
"8968","155317",2004,4182,2148,2034,1345,527,818,38.08,0.3808,0.322,0.259
"8969","155335",2004,216,112,104,43,17,26,23.21,0.2321,0.199,0.163
"8970","155399",2004,3282,1691,1591,823,270,553,32.7,0.327,0.251,0.17
"8971","155520",2004,249,117,132,84,40,44,37.61,0.3761,0.337,0.303
"8972","155627",2004,79,30,49,23,11,12,40,0.4,0.291,0.224
"8973","155937",2004,136,52,84,36,19,17,32.69,0.3269,0.265,0.226
"8974","156213",2004,302,183,119,160,68,92,50.27,0.5027,0.53,0.571
"8975","156286",2004,407,271,136,225,58,167,61.62,0.6162,0.553,0.426
"8976","156295",2004,400,209,191,201,84,117,55.98,0.5598,0.502,0.44
"8977","156365",2004,381,178,203,102,39,63,35.39,0.3539,0.268,0.192
"8978","156541",2004,418,190,228,104,36,68,35.79,0.3579,0.249,0.158
"8979","156745",2004,354,192,162,205,73,132,68.75,0.6875,0.579,0.451
"8980","157058",2004,346,196,150,37,8,29,14.8,0.148,0.107,0.053
"8981","157076",2004,210,93,117,64,25,39,41.94,0.4194,0.305,0.214
"8982","157085",2004,3935,2097,1838,1276,486,790,37.67,0.3767,0.324,0.264
"8983","157289",2004,2303,1197,1106,489,164,325,27.15,0.2715,0.212,0.148
"8984","157386",2004,1307,737,570,125,39,86,11.67,0.1167,0.096,0.068
"8985","157401",2004,1414,804,610,531,176,355,44.15,0.4415,0.376,0.289
"8986","157447",2004,1915,1123,792,151,43,108,9.62,0.0962,0.079,0.054
"8987","157535",2004,175,103,72,31,8,23,22.33,0.2233,0.177,0.111
"8988","157951",2004,2918,1647,1271,456,155,301,18.28,0.1828,0.156,0.122
"8989","158477",2004,282,190,92,145,42,103,54.21,0.5421,0.514,0.457
"8990","159009",2004,1132,675,457,115,33,82,12.15,0.1215,0.102,0.072
"8991","159391",2004,5692,3099,2593,1492,539,953,30.75,0.3075,0.262,0.208
"8992","159647",2004,1644,730,914,432,189,243,33.29,0.3329,0.263,0.207
"8993","159717",2004,1603,923,680,196,61,135,14.63,0.1463,0.122,0.09
"8994","159966",2004,1574,939,635,146,44,102,10.86,0.1086,0.093,0.069
"8995","160038",2004,1793,1084,709,187,55,132,12.18,0.1218,0.104,0.078
"8996","160612",2004,2137,1250,887,210,68,142,11.36,0.1136,0.098,0.077
"8997","160621",2004,1575,931,644,115,30,85,9.13,0.0913,0.073,0.047
"8998","160658",2004,2643,1517,1126,345,101,244,16.08,0.1608,0.131,0.09
"8999","161004",2004,470,235,235,421,212,209,88.94,0.8894,0.896,0.902
"9000","161226",2004,510,342,168,196,46,150,43.86,0.4386,0.384,0.274
"9001","161235",2004,166,85,81,17,2,15,17.65,0.1765,0.102,0.025
"9002","161244",2004,80,54,26,14,3,11,20.37,0.2037,0.175,0.115
"9003","161253",2004,1607,777,830,550,236,314,40.41,0.4041,0.342,0.284
"9004","161554",2004,871,524,347,146,39,107,20.42,0.2042,0.168,0.112
"9005","162007",2004,627,408,219,94,16,78,19.12,0.1912,0.15,0.073
"9006","162210",2004,208,130,78,26,4,22,16.92,0.1692,0.125,0.051
"9007","162283",2004,588,446,142,27,5,22,4.93,0.0493,0.046,0.035
"9008","162584",2004,955,427,528,207,78,129,30.21,0.3021,0.217,0.148
"9009","162654",2004,401,270,131,241,62,179,66.3,0.663,0.601,0.473
"9010","162760",2004,242,189,53,160,31,129,68.25,0.6825,0.661,0.585
"9011","162928",2004,1127,525,602,928,480,448,85.33,0.8533,0.823,0.797
"9012","163046",2004,951,579,372,726,277,449,77.55,0.7755,0.763,0.745
"9013","163268",2004,1403,560,843,472,249,223,39.82,0.3982,0.336,0.295
"9014","163286",2004,4174,2055,2119,2607,1173,1434,69.78,0.6978,0.625,0.554
"9015","163453",2004,1336,750,586,153,32,121,16.13,0.1613,0.115,0.055
"9016","163462",2004,391,243,148,270,99,171,70.37,0.7037,0.691,0.669
"9017","163851",2004,981,536,445,457,148,309,57.65,0.5765,0.466,0.333
"9018","163912",2004,431,233,198,303,122,181,77.68,0.7768,0.703,0.616
"9019","164076",2004,2082,1376,706,835,229,606,44.04,0.4404,0.401,0.324
"9020","164173",2004,561,378,183,252,81,171,45.24,0.4524,0.449,0.443
"9021","164216",2004,304,185,119,205,71,134,72.43,0.7243,0.674,0.597
"9022","164270",2004,357,196,161,237,100,137,69.9,0.699,0.664,0.621
"9023","164447",2004,321,167,154,83,35,48,28.74,0.2874,0.259,0.227
"9024","164492",2004,189,107,82,69,32,37,34.58,0.3458,0.365,0.39
"9025","164562",2004,633,364,269,447,170,277,76.1,0.761,0.706,0.632
"9026","165015",2004,761,417,344,655,287,368,88.25,0.8825,0.861,0.834
"9027","165024",2004,1266,713,553,306,99,207,29.03,0.2903,0.242,0.179
"9028","165334",2004,523,328,195,383,137,246,75,0.75,0.732,0.703
"9029","165662",2004,700,402,298,533,242,291,72.39,0.7239,0.761,0.812
"9030","165671",2004,455,332,123,237,58,179,53.92,0.5392,0.521,0.472
"9031","165820",2004,713,386,327,153,52,101,26.17,0.2617,0.215,0.159
"9032","165866",2004,642,434,208,187,49,138,31.8,0.318,0.291,0.236
"9033","165936",2004,401,264,137,235,75,160,60.61,0.6061,0.586,0.547
"9034","166027",2004,1638,823,815,1427,688,739,89.79,0.8979,0.871,0.844
"9035","166124",2004,703,389,314,635,274,361,92.8,0.928,0.903,0.873
"9036","166513",2004,996,333,663,286,134,152,45.65,0.4565,0.287,0.202
"9037","166629",2004,4311,2126,2185,2196,968,1228,57.76,0.5776,0.509,0.443
"9038","166638",2004,543,323,220,61,12,49,15.17,0.1517,0.112,0.055
"9039","166683",2004,1076,457,619,909,507,402,87.96,0.8796,0.845,0.819
"9040","167288",2004,263,161,102,99,28,71,44.1,0.441,0.376,0.275
"9041","167987",2004,1456,715,741,416,147,269,37.62,0.3762,0.286,0.198
"9042","167996",2004,614,384,230,494,171,323,84.11,0.8411,0.805,0.743
"9043","168005",2004,1014,589,425,350,123,227,38.54,0.3854,0.345,0.289
"9044","168148",2004,1273,635,638,1101,537,564,88.82,0.8882,0.865,0.842
"9045","168254",2004,798,302,496,353,197,156,51.66,0.5166,0.442,0.397
"9046","168281",2004,443,280,163,310,114,196,70,0.7,0.7,0.699
"9047","168342",2004,532,272,260,484,234,250,91.91,0.9191,0.91,0.9
"9048","168546",2004,559,310,249,358,149,209,67.42,0.6742,0.64,0.598
"9049","168786",2004,316,199,117,119,45,74,37.19,0.3719,0.377,0.385
"9050","169080",2004,899,467,432,524,245,279,59.74,0.5974,0.583,0.567
"9051","169798",2004,2281,1329,952,280,85,195,14.67,0.1467,0.123,0.089
"9052","169910",2004,1924,834,1090,127,60,67,8.03,0.0803,0.066,0.055
"9053","170082",2004,3324,2123,1201,875,270,605,28.5,0.285,0.263,0.225
"9054","170301",2004,780,463,317,531,194,337,72.79,0.7279,0.681,0.612
"9055","170532",2004,310,188,122,240,86,154,81.91,0.8191,0.774,0.705
"9056","170639",2004,527,242,285,67,27,40,16.53,0.1653,0.127,0.095
"9057","170976",2004,6016,3033,2983,4334,1990,2344,77.28,0.7728,0.72,0.667
"9058","171100",2004,7426,4073,3353,3531,1334,2197,53.94,0.5394,0.475,0.398
"9059","171128",2004,1219,243,976,327,221,106,43.62,0.4362,0.268,0.226
"9060","171137",2004,656,311,345,106,45,61,19.61,0.1961,0.162,0.13
"9061","171146",2004,474,293,181,53,17,36,12.29,0.1229,0.112,0.094
"9062","171599",2004,198,72,126,51,26,25,34.72,0.3472,0.258,0.206
"9063","172051",2004,1209,720,489,129,32,97,13.47,0.1347,0.107,0.065
"9064","172699",2004,3725,1872,1853,802,301,501,26.76,0.2676,0.215,0.162
"9065","173160",2004,669,386,283,385,160,225,58.29,0.5829,0.575,0.565
"9066","173258",2004,487,263,224,432,195,237,90.11,0.9011,0.887,0.871
"9067","173328",2004,176,102,74,64,24,40,39.22,0.3922,0.364,0.324
"9068","173647",2004,651,361,290,468,221,247,68.42,0.6842,0.719,0.762
"9069","173902",2004,485,284,201,410,164,246,86.62,0.8662,0.845,0.816
"9070","174066",2004,5562,3081,2481,2549,994,1555,50.47,0.5047,0.458,0.401
"9071","174233",2004,2205,1153,1052,568,208,360,31.22,0.3122,0.258,0.198
"9072","174251",2004,383,235,148,205,73,132,56.17,0.5617,0.535,0.493
"9073","174491",2004,409,245,164,194,67,127,51.84,0.5184,0.474,0.409
"9074","174792",2004,512,0,512,338,338,0,NA,NA,0.66,0.66
"9075","174844",2004,777,446,331,631,258,373,83.63,0.8363,0.812,0.779
"9076","174899",2004,437,300,137,227,66,161,53.67,0.5367,0.519,0.482
"9077","174914",2004,1161,608,553,710,312,398,65.46,0.6546,0.612,0.564
"9078","175342",2004,572,309,263,116,33,83,26.86,0.2686,0.203,0.125
"9079","175421",2004,237,144,93,94,28,66,45.83,0.4583,0.397,0.301
"9080","175616",2004,381,211,170,76,24,52,24.64,0.2464,0.199,0.141
"9081","175856",2004,995,587,408,200,50,150,25.55,0.2555,0.201,0.123
"9082","175980",2004,278,136,142,170,83,87,63.97,0.6397,0.612,0.585
"9083","176017",2004,2248,1185,1063,761,292,469,39.58,0.3958,0.339,0.275
"9084","176035",2004,242,207,35,55,1,54,26.09,0.2609,0.227,0.029
"9085","176044",2004,372,184,188,51,15,36,19.57,0.1957,0.137,0.08
"9086","176080",2004,1735,829,906,492,193,299,36.07,0.3607,0.284,0.213
"9087","176406",2004,278,190,88,68,16,52,27.37,0.2737,0.245,0.182
"9088","176628",2004,129,88,41,39,3,36,40.91,0.4091,0.302,0.073
"9089","176947",2004,193,86,107,64,21,43,50,0.5,0.332,0.196
"9090","176965",2004,1434,798,636,369,120,249,31.2,0.312,0.257,0.189
"9091","177418",2004,190,132,58,52,16,36,27.27,0.2727,0.274,0.276
"9092","178059",2004,313,248,65,160,29,131,52.82,0.5282,0.511,0.446
"9093","178341",2004,695,368,327,97,33,64,17.39,0.1739,0.14,0.101
"9094","178387",2004,1021,573,448,109,26,83,14.49,0.1449,0.107,0.058
"9095","178396",2004,4625,2442,2183,1993,765,1228,50.29,0.5029,0.431,0.35
"9096","178402",2004,904,540,364,160,50,110,20.37,0.2037,0.177,0.137
"9097","178411",2004,836,169,667,211,162,49,28.99,0.2899,0.252,0.243
"9098","178420",2004,398,235,163,82,25,57,24.26,0.2426,0.206,0.153
"9099","178615",2004,1477,872,605,631,228,403,46.22,0.4622,0.427,0.377
"9100","179043",2004,305,176,129,184,76,108,61.36,0.6136,0.603,0.589
"9101","179159",2004,1456,864,592,892,336,556,64.35,0.6435,0.613,0.568
"9102","179557",2004,1386,823,563,334,98,236,28.68,0.2868,0.241,0.174
"9103","179566",2004,2663,1572,1091,755,234,521,33.14,0.3314,0.284,0.214
"9104","179867",2004,1436,725,711,1233,592,641,88.41,0.8841,0.859,0.833
"9105","179894",2004,448,256,192,229,89,140,54.69,0.5469,0.511,0.464
"9106","179946",2004,231,108,123,105,54,51,47.22,0.4722,0.455,0.439
"9107","180179",2004,502,338,164,64,18,46,13.61,0.1361,0.127,0.11
"9108","180461",2004,1998,836,1162,341,159,182,21.77,0.2177,0.171,0.137
"9109","180522",2004,175,57,118,19,12,7,12.28,0.1228,0.109,0.102
"9110","180984",2004,278,146,132,103,28,75,51.37,0.5137,0.371,0.212
"9111","181002",2004,968,584,384,633,246,387,66.27,0.6627,0.654,0.641
"9112","181020",2004,303,172,131,162,67,95,55.23,0.5523,0.535,0.511
"9113","181127",2004,289,140,149,152,60,92,65.71,0.6571,0.526,0.403
"9114","181215",2004,1061,589,472,238,85,153,25.98,0.2598,0.224,0.18
"9115","181394",2004,1577,878,699,201,78,123,14.01,0.1401,0.127,0.112
"9116","181446",2004,428,238,190,223,101,122,51.26,0.5126,0.521,0.532
"9117","181464",2004,3236,1559,1677,950,394,556,35.66,0.3566,0.294,0.235
"9118","181534",2004,217,114,103,21,5,16,14.04,0.1404,0.097,0.049
"9119","181783",2004,552,310,242,128,39,89,28.71,0.2871,0.232,0.161
"9120","182281",2004,3108,1760,1348,428,134,294,16.7,0.167,0.138,0.099
"9121","182290",2004,2132,1157,975,289,104,185,15.99,0.1599,0.136,0.107
"9122","182634",2004,263,179,84,140,42,98,54.75,0.5475,0.532,0.5
"9123","182795",2004,568,285,283,232,97,135,47.37,0.4737,0.408,0.343
"9124","183062",2004,1068,649,419,425,148,277,42.68,0.4268,0.398,0.353
"9125","183080",2004,1052,524,528,356,156,200,38.17,0.3817,0.338,0.295
"9126","183239",2004,516,284,232,370,149,221,77.82,0.7782,0.717,0.642
"9127","183822",2004,361,233,128,32,14,18,7.73,0.0773,0.089,0.109
"9128","183974",2004,258,169,89,123,38,85,50.3,0.503,0.477,0.427
"9129","184348",2004,418,243,175,264,98,166,68.31,0.6831,0.632,0.56
"9130","184603",2004,504,282,222,150,61,89,31.56,0.3156,0.298,0.275
"9131","184612",2004,232,170,62,38,13,25,14.71,0.1471,0.164,0.21
"9132","184782",2004,1247,622,625,546,255,291,46.78,0.4678,0.438,0.408
"9133","185129",2004,512,300,212,40,12,28,9.33,0.0933,0.078,0.057
"9134","185572",2004,946,514,432,341,120,221,43,0.43,0.36,0.278
"9135","185590",2004,1737,1015,722,534,164,370,36.45,0.3645,0.307,0.227
"9136","185828",2004,663,130,533,108,74,34,26.15,0.2615,0.163,0.139
"9137","186131",2004,1170,548,622,1054,549,505,92.15,0.9215,0.901,0.883
"9138","186201",2004,746,451,295,486,165,321,71.18,0.7118,0.651,0.559
"9139","186283",2004,890,514,376,456,190,266,51.75,0.5175,0.512,0.505
"9140","186584",2004,1234,672,562,626,269,357,53.12,0.5312,0.507,0.479
"9141","186876",2004,819,435,384,331,127,204,46.9,0.469,0.404,0.331
"9142","187134",2004,1230,681,549,876,357,519,76.21,0.7621,0.712,0.65
"9143","187444",2004,1430,801,629,245,85,160,19.98,0.1998,0.171,0.135
"9144","187985",2004,3018,1720,1298,370,98,272,15.81,0.1581,0.123,0.076
"9145","188030",2004,2061,1125,936,260,92,168,14.93,0.1493,0.126,0.098
"9146","188429",2004,801,549,252,463,119,344,62.66,0.6266,0.578,0.472
"9147","188641",2004,505,226,279,218,99,119,52.65,0.5265,0.432,0.355
"9148","190044",2004,658,142,516,364,275,89,62.68,0.6268,0.553,0.533
"9149","190099",2004,738,396,342,616,277,339,85.61,0.8561,0.835,0.81
"9150","190150",2004,1366,632,734,1133,604,529,83.7,0.837,0.829,0.823
"9151","190248",2004,143,61,82,38,13,25,40.98,0.4098,0.266,0.159
"9152","190415",2004,3051,1494,1557,2621,1289,1332,89.16,0.8916,0.859,0.828
"9153","190512",2004,1693,865,828,569,233,336,38.84,0.3884,0.336,0.281
"9154","190549",2004,1170,653,517,268,90,178,27.26,0.2726,0.229,0.174
"9155","190558",2004,2020,1147,873,67,12,55,4.8,0.048,0.033,0.014
"9156","190567",2004,1168,531,637,106,45,61,11.49,0.1149,0.091,0.071
"9157","190594",2004,1824,1235,589,312,81,231,18.7,0.187,0.171,0.138
"9158","190637",2004,852,571,281,100,27,73,12.78,0.1278,0.117,0.096
"9159","190664",2004,1352,815,537,352,102,250,30.67,0.3067,0.26,0.19
"9160","190691",2004,727,453,274,27,8,19,4.19,0.0419,0.037,0.029
"9161","190725",2004,264,198,66,62,11,51,25.76,0.2576,0.235,0.167
"9162","191241",2004,1674,997,677,1269,486,783,78.54,0.7854,0.758,0.718
"9163","191515",2004,457,236,221,385,180,205,86.86,0.8686,0.842,0.814
"9164","191533",2004,409,219,190,189,80,109,49.77,0.4977,0.462,0.421
"9165","191630",2004,482,255,227,337,142,195,76.47,0.7647,0.699,0.626
"9166","191649",2004,1713,885,828,750,303,447,50.51,0.5051,0.438,0.366
"9167","191676",2004,320,212,108,186,56,130,61.32,0.6132,0.581,0.519
"9168","191931",2004,854,458,396,448,175,273,59.61,0.5961,0.525,0.442
"9169","191968",2004,1458,831,627,1013,411,602,72.44,0.7244,0.695,0.656
"9170","192192",2004,245,170,75,120,29,91,53.53,0.5353,0.49,0.387
"9171","192323",2004,473,277,196,305,115,190,68.59,0.6859,0.645,0.587
"9172","192439",2004,912,629,283,39,12,27,4.29,0.0429,0.043,0.042
"9173","192703",2004,657,343,314,420,182,238,69.39,0.6939,0.639,0.58
"9174","192749",2004,450,312,138,261,78,183,58.65,0.5865,0.58,0.565
"9175","192819",2004,955,536,419,699,282,417,77.8,0.778,0.732,0.673
"9176","192925",2004,296,179,117,85,36,49,27.37,0.2737,0.287,0.308
"9177","193016",2004,649,421,228,79,18,61,14.49,0.1449,0.122,0.079
"9178","193292",2004,311,231,80,105,17,88,38.1,0.381,0.338,0.212
"9179","193353",2004,419,314,105,180,45,135,42.99,0.4299,0.43,0.429
"9180","193399",2004,355,229,126,166,53,113,49.34,0.4934,0.468,0.421
"9181","193584",2004,449,335,114,285,60,225,67.16,0.6716,0.635,0.526
"9182","193645",2004,952,815,137,152,11,141,17.3,0.173,0.16,0.08
"9183","193654",2004,815,612,203,371,86,285,46.57,0.4657,0.455,0.424
"9184","193900",2004,4568,2792,1776,2860,1121,1739,62.29,0.6229,0.626,0.631
"9185","193973",2004,725,467,258,443,141,302,64.67,0.6467,0.611,0.547
"9186","194161",2004,260,162,98,78,29,49,30.25,0.3025,0.3,0.296
"9187","194310",2004,1437,900,537,577,194,383,42.56,0.4256,0.402,0.361
"9188","194824",2004,1079,259,820,696,521,175,67.57,0.6757,0.645,0.635
"9189","195003",2004,2233,562,1671,577,316,261,46.44,0.4644,0.258,0.189
"9190","195030",2004,1083,496,587,808,409,399,80.44,0.8044,0.746,0.697
"9191","195164",2004,574,304,270,305,134,171,56.25,0.5625,0.531,0.496
"9192","195173",2004,473,228,245,148,67,81,35.53,0.3553,0.313,0.273
"9193","195216",2004,566,298,268,444,203,241,80.87,0.8087,0.784,0.757
"9194","195234",2004,563,408,155,387,91,296,72.55,0.7255,0.687,0.587
"9195","195243",2004,349,168,181,112,56,56,33.33,0.3333,0.321,0.309
"9196","195304",2004,329,253,76,233,50,183,72.33,0.7233,0.708,0.658
"9197","195474",2004,715,412,303,532,212,320,77.67,0.7767,0.744,0.7
"9198","195526",2004,676,383,293,539,229,310,80.94,0.8094,0.797,0.782
"9199","195544",2004,593,420,173,311,68,243,57.86,0.5786,0.524,0.393
"9200","195809",2004,2996,1696,1300,1035,384,651,38.38,0.3838,0.345,0.295
"9201","196413",2004,2662,1505,1157,1907,766,1141,75.81,0.7581,0.716,0.662
"9202","196592",2004,1863,1278,585,246,86,160,12.52,0.1252,0.132,0.147
"9203","197045",2004,484,248,236,143,68,75,30.24,0.3024,0.295,0.288
"9204","197133",2004,654,419,235,586,198,388,92.6,0.926,0.896,0.843
"9205","197869",2004,2507,1247,1260,941,357,584,46.83,0.4683,0.375,0.283
"9206","197984",2004,174,96,78,47,20,27,28.12,0.2812,0.27,0.256
"9207","198385",2004,462,238,224,410,192,218,91.6,0.916,0.887,0.857
"9208","198464",2004,3451,2143,1308,1009,294,715,33.36,0.3336,0.292,0.225
"9209","198507",2004,554,295,259,107,30,77,26.1,0.261,0.193,0.116
"9210","198516",2004,1230,775,455,918,319,599,77.29,0.7729,0.746,0.701
"9211","198835",2004,322,196,126,123,35,88,44.9,0.449,0.382,0.278
"9212","198969",2004,435,143,292,71,25,46,32.17,0.3217,0.163,0.086
"9213","199102",2004,2212,1147,1065,335,86,249,21.71,0.2171,0.151,0.081
"9214","199111",2004,694,418,276,208,59,149,35.65,0.3565,0.3,0.214
"9215","199120",2004,3584,2099,1485,2685,1027,1658,78.99,0.7899,0.749,0.692
"9216","199139",2004,2599,1416,1183,707,249,458,32.34,0.3234,0.272,0.21
"9217","199148",2004,2159,1525,634,625,124,501,32.85,0.3285,0.289,0.196
"9218","199157",2004,1138,732,406,205,51,154,21.04,0.2104,0.18,0.126
"9219","199193",2004,3935,1702,2233,1585,682,903,53.06,0.5306,0.403,0.305
"9220","199218",2004,1891,1154,737,841,272,569,49.31,0.4931,0.445,0.369
"9221","199281",2004,741,393,348,113,44,69,17.56,0.1756,0.152,0.126
"9222","199306",2004,191,88,103,54,17,37,42.05,0.4205,0.283,0.165
"9223","199412",2004,223,154,69,98,28,70,45.45,0.4545,0.439,0.406
"9224","199582",2004,324,140,184,45,15,30,21.43,0.2143,0.139,0.082
"9225","199643",2004,417,227,190,61,16,45,19.82,0.1982,0.146,0.084
"9226","199847",2004,1109,552,557,921,438,483,87.5,0.875,0.83,0.786
"9227","199962",2004,358,174,184,155,66,89,51.15,0.5115,0.433,0.359
"9228","199999",2004,891,619,272,117,35,82,13.25,0.1325,0.131,0.129
"9229","200004",2004,1571,805,766,447,154,293,36.4,0.364,0.285,0.201
"9230","200059",2004,332,170,162,37,15,22,12.94,0.1294,0.111,0.093
"9231","200156",2004,229,135,94,63,33,30,22.22,0.2222,0.275,0.351
"9232","200217",2004,430,251,179,156,46,110,43.82,0.4382,0.363,0.257
"9233","200226",2004,162,72,90,25,5,20,27.78,0.2778,0.154,0.056
"9234","200253",2004,431,254,177,72,20,52,20.47,0.2047,0.167,0.113
"9235","200280",2004,2178,1016,1162,459,216,243,23.92,0.2392,0.211,0.186
"9236","200332",2004,2089,949,1140,481,220,261,27.5,0.275,0.23,0.193
"9237","200572",2004,167,71,96,39,16,23,32.39,0.3239,0.234,0.167
"9238","201104",2004,571,340,231,245,70,175,51.47,0.5147,0.429,0.303
"9239","201371",2004,266,130,136,136,61,75,57.69,0.5769,0.511,0.449
"9240","201548",2004,517,298,219,253,96,157,52.68,0.5268,0.489,0.438
"9241","201645",2004,782,306,476,508,282,226,73.86,0.7386,0.65,0.592
"9242","201690",2004,583,270,313,46,11,35,12.96,0.1296,0.079,0.035
"9243","202134",2004,922,463,459,79,31,48,10.37,0.1037,0.086,0.068
"9244","202480",2004,1805,905,900,1048,437,611,67.51,0.6751,0.581,0.486
"9245","202523",2004,616,362,254,501,200,301,83.15,0.8315,0.813,0.787
"9246","202763",2004,580,387,193,248,60,188,48.58,0.4858,0.428,0.311
"9247","203085",2004,354,159,195,132,47,85,53.46,0.5346,0.373,0.241
"9248","203128",2004,220,106,114,137,62,75,70.75,0.7075,0.623,0.544
"9249","203368",2004,734,383,351,466,207,259,67.62,0.6762,0.635,0.59
"9250","203517",2004,3841,2428,1413,969,271,698,28.75,0.2875,0.252,0.192
"9251","203535",2004,467,237,230,396,189,207,87.34,0.8734,0.848,0.822
"9252","203580",2004,141,104,37,48,10,38,36.54,0.3654,0.34,0.27
"9253","203775",2004,400,239,161,181,53,128,53.56,0.5356,0.452,0.329
"9254","203845",2004,439,215,224,200,78,122,56.74,0.5674,0.456,0.348
"9255","204024",2004,3475,1950,1525,2354,961,1393,71.44,0.7144,0.677,0.63
"9256","204185",2004,547,256,291,292,128,164,64.06,0.6406,0.534,0.44
"9257","204194",2004,303,184,119,130,44,86,46.74,0.4674,0.429,0.37
"9258","204617",2004,415,202,213,143,57,86,42.57,0.4257,0.345,0.268
"9259","204796",2004,6031,2891,3140,2930,1241,1689,58.42,0.5842,0.486,0.395
"9260","204857",2004,3734,2050,1684,1703,616,1087,53.02,0.5302,0.456,0.366
"9261","206330",2004,177,70,107,38,18,20,28.57,0.2857,0.215,0.168
"9262","206589",2004,478,239,239,334,147,187,78.24,0.7824,0.699,0.615
"9263","206604",2004,2289,1302,987,418,156,262,20.12,0.2012,0.183,0.158
"9264","206622",2004,878,470,408,611,268,343,72.98,0.7298,0.696,0.657
"9265","206695",2004,2025,1081,944,247,91,156,14.43,0.1443,0.122,0.096
"9266","206914",2004,762,409,353,31,10,21,5.13,0.0513,0.041,0.028
"9267","207209",2004,530,245,285,16,6,10,4.08,0.0408,0.03,0.021
"9268","207306",2004,292,156,136,40,12,28,17.95,0.1795,0.137,0.088
"9269","207324",2004,545,291,254,117,50,67,23.02,0.2302,0.215,0.197
"9270","207388",2004,3126,1601,1525,991,360,631,39.41,0.3941,0.317,0.236
"9271","207500",2004,3537,1876,1661,1122,397,725,38.65,0.3865,0.317,0.239
"9272","207722",2004,244,148,96,45,13,32,21.62,0.2162,0.184,0.135
"9273","207847",2004,609,310,299,59,29,30,9.68,0.0968,0.097,0.097
"9274","207865",2004,941,493,448,130,41,89,18.05,0.1805,0.138,0.092
"9275","208822",2004,397,259,138,235,79,156,60.23,0.6023,0.592,0.572
"9276","209056",2004,537,329,208,366,143,223,67.78,0.6778,0.682,0.688
"9277","209065",2004,432,222,210,249,106,143,64.41,0.6441,0.576,0.505
"9278","209542",2004,2803,1367,1436,860,320,540,39.5,0.395,0.307,0.223
"9279","209551",2004,3138,1734,1404,1377,539,838,48.33,0.4833,0.439,0.384
"9280","209612",2004,294,181,113,164,62,102,56.35,0.5635,0.558,0.549
"9281","209807",2004,1173,627,546,167,51,116,18.5,0.185,0.142,0.093
"9282","209922",2004,333,186,147,199,78,121,65.05,0.6505,0.598,0.531
"9283","210146",2004,744,409,335,100,30,70,17.11,0.1711,0.134,0.09
"9284","210401",2004,510,284,226,361,155,206,72.54,0.7254,0.708,0.686
"9285","210429",2004,795,447,348,138,55,83,18.57,0.1857,0.174,0.158
"9286","210571",2004,505,319,186,268,86,182,57.05,0.5705,0.531,0.462
"9287","210669",2004,647,341,306,465,206,259,75.95,0.7595,0.719,0.673
"9288","210775",2004,310,197,113,123,29,94,47.72,0.4772,0.397,0.257
"9289","211088",2004,476,343,133,247,67,180,52.48,0.5248,0.519,0.504
"9290","211158",2004,1533,947,586,631,198,433,45.72,0.4572,0.412,0.338
"9291","211291",2004,906,447,459,813,397,416,93.06,0.9306,0.897,0.865
"9292","211352",2004,390,257,133,155,45,110,42.8,0.428,0.397,0.338
"9293","211361",2004,1038,519,519,293,127,166,31.98,0.3198,0.282,0.245
"9294","211431",2004,231,226,5,87,1,86,38.05,0.3805,0.377,0.2
"9295","211440",2004,1359,510,849,940,579,361,70.78,0.7078,0.692,0.682
"9296","211468",2004,237,237,0,114,0,114,48.1,0.481,0.481,NA
"9297","211556",2004,90,90,0,50,0,50,55.56,0.5556,0.556,NA
"9298","211583",2004,197,115,82,62,24,38,33.04,0.3304,0.315,0.293
"9299","211608",2004,422,225,197,56,20,36,16,0.16,0.133,0.102
"9300","211644",2004,1203,683,520,296,103,193,28.26,0.2826,0.246,0.198
"9301","211981",2004,450,257,193,186,48,138,53.7,0.537,0.413,0.249
"9302","212009",2004,605,329,276,472,197,275,83.59,0.8359,0.78,0.714
"9303","212054",2004,2069,732,1337,477,193,284,38.8,0.388,0.231,0.144
"9304","212106",2004,1208,700,508,656,251,405,57.86,0.5786,0.543,0.494
"9305","212115",2004,1165,709,456,420,122,298,42.03,0.4203,0.361,0.268
"9306","212133",2004,450,294,156,243,82,161,54.76,0.5476,0.54,0.526
"9307","212160",2004,1232,712,520,272,81,191,26.83,0.2683,0.221,0.156
"9308","212197",2004,535,344,191,385,125,260,75.58,0.7558,0.72,0.654
"9309","212577",2004,529,241,288,424,219,205,85.06,0.8506,0.802,0.76
"9310","212601",2004,522,317,205,248,84,164,51.74,0.5174,0.475,0.41
"9311","212832",2004,280,218,62,87,23,64,29.36,0.2936,0.311,0.371
"9312","212911",2004,330,179,151,291,130,161,89.94,0.8994,0.882,0.861
"9313","213020",2004,2645,1567,1078,768,234,534,34.08,0.3408,0.29,0.217
"9314","213251",2004,390,213,177,273,129,144,67.61,0.6761,0.7,0.729
"9315","213321",2004,449,178,271,268,139,129,72.47,0.7247,0.597,0.513
"9316","213349",2004,2049,1217,832,680,191,489,40.18,0.4018,0.332,0.23
"9317","213358",2004,214,141,73,46,10,36,25.53,0.2553,0.215,0.137
"9318","213367",2004,829,419,410,441,195,246,58.71,0.5871,0.532,0.476
"9319","213385",2004,609,315,294,529,249,280,88.89,0.8889,0.869,0.847
"9320","213507",2004,416,221,195,287,121,166,75.11,0.7511,0.69,0.621
"9321","213543",2004,1054,463,591,814,417,397,85.75,0.8575,0.772,0.706
"9322","213613",2004,1191,702,489,348,129,219,31.2,0.312,0.292,0.264
"9323","213668",2004,399,217,182,249,109,140,64.52,0.6452,0.624,0.599
"9324","213783",2004,689,402,287,168,54,114,28.36,0.2836,0.244,0.188
"9325","213826",2004,332,262,70,149,24,125,47.71,0.4771,0.449,0.343
"9326","213996",2004,690,453,237,484,159,325,71.74,0.7174,0.701,0.671
"9327","214041",2004,1396,791,605,512,177,335,42.35,0.4235,0.367,0.293
"9328","214069",2004,317,225,92,171,41,130,57.78,0.5778,0.539,0.446
"9329","214157",2004,382,215,167,261,103,158,73.49,0.7349,0.683,0.617
"9330","214175",2004,559,337,222,456,178,278,82.49,0.8249,0.816,0.802
"9331","214272",2004,462,304,158,135,41,94,30.92,0.3092,0.292,0.259
"9332","214777",2004,5905,2884,3021,3681,1674,2007,69.59,0.6959,0.623,0.554
"9333","215062",2004,2359,1191,1168,2090,999,1091,91.6,0.916,0.886,0.855
"9334","215743",2004,321,198,123,175,48,127,64.14,0.6414,0.545,0.39
"9335","215798",2004,331,186,145,226,93,133,71.51,0.7151,0.683,0.641
"9336","215929",2004,965,559,406,658,248,410,73.35,0.7335,0.682,0.611
"9337","216010",2004,1458,748,710,629,251,378,50.53,0.5053,0.431,0.354
"9338","216038",2004,1530,890,640,551,196,355,39.89,0.3989,0.36,0.306
"9339","216287",2004,365,189,176,324,153,171,90.48,0.9048,0.888,0.869
"9340","216339",2004,3788,2184,1604,1216,468,748,34.25,0.3425,0.321,0.292
"9341","216524",2004,393,200,193,303,142,161,80.5,0.805,0.771,0.736
"9342","216694",2004,367,189,178,175,70,105,55.56,0.5556,0.477,0.393
"9343","216764",2004,1870,1214,656,734,177,557,45.88,0.4588,0.393,0.27
"9344","216807",2004,378,235,143,225,72,153,65.11,0.6511,0.595,0.503
"9345","216852",2004,736,342,394,247,97,150,43.86,0.4386,0.336,0.246
"9346","216931",2004,550,296,254,287,128,159,53.72,0.5372,0.522,0.504
"9347","217059",2004,1037,612,425,423,151,272,44.44,0.4444,0.408,0.355
"9348","217156",2004,1429,744,685,1224,580,644,86.56,0.8656,0.857,0.847
"9349","217402",2004,1036,549,487,859,406,453,82.51,0.8251,0.829,0.834
"9350","217536",2004,558,397,161,358,99,259,65.24,0.6524,0.642,0.615
"9351","217776",2004,161,98,63,40,15,25,25.51,0.2551,0.248,0.238
"9352","217819",2004,1940,1323,617,1039,268,771,58.28,0.5828,0.536,0.434
"9353","217882",2004,2994,1369,1625,1488,597,891,65.08,0.6508,0.497,0.367
"9354","217998",2004,179,106,73,97,39,58,54.72,0.5472,0.542,0.534
"9355","218061",2004,745,463,282,139,34,105,22.68,0.2268,0.187,0.121
"9356","218229",2004,647,440,207,140,32,108,24.55,0.2455,0.216,0.155
"9357","218238",2004,203,95,108,41,15,26,27.37,0.2737,0.202,0.139
"9358","218399",2004,232,141,91,19,3,16,11.35,0.1135,0.082,0.033
"9359","218414",2004,231,90,141,73,28,45,50,0.5,0.316,0.199
"9360","218663",2004,3330,1841,1489,1524,593,931,50.57,0.5057,0.458,0.398
"9361","218724",2004,1320,669,651,288,104,184,27.5,0.275,0.218,0.16
"9362","218733",2004,945,523,422,164,41,123,23.52,0.2352,0.174,0.097
"9363","218742",2004,643,398,245,145,51,94,23.62,0.2362,0.226,0.208
"9364","218973",2004,323,144,179,253,129,124,86.11,0.8611,0.783,0.721
"9365","219000",2004,392,231,161,197,70,127,54.98,0.5498,0.503,0.435
"9366","219046",2004,581,350,231,46,11,35,10,0.1,0.079,0.048
"9367","219082",2004,249,114,135,44,18,26,22.81,0.2281,0.177,0.133
"9368","219198",2004,150,111,39,51,13,38,34.23,0.3423,0.34,0.333
"9369","219259",2004,384,238,146,53,12,41,17.23,0.1723,0.138,0.082
"9370","219356",2004,1993,1011,982,485,194,291,28.78,0.2878,0.243,0.198
"9371","219471",2004,945,538,407,220,80,140,26.02,0.2602,0.233,0.197
"9372","219602",2004,1196,714,482,173,64,109,15.27,0.1527,0.145,0.133
"9373","219709",2004,727,442,285,429,168,261,59.05,0.5905,0.59,0.589
"9374","219718",2004,252,97,155,40,15,25,25.77,0.2577,0.159,0.097
"9375","219949",2004,203,104,99,37,15,22,21.15,0.2115,0.182,0.152
"9376","220075",2004,1479,846,633,259,76,183,21.63,0.2163,0.175,0.12
"9377","220215",2004,371,205,166,145,54,91,44.39,0.4439,0.391,0.325
"9378","220613",2004,723,430,293,223,67,156,36.28,0.3628,0.308,0.229
"9379","220631",2004,201,138,63,50,18,32,23.19,0.2319,0.249,0.286
"9380","220710",2004,317,169,148,155,56,99,58.58,0.5858,0.489,0.378
"9381","221351",2004,474,269,205,360,144,216,80.3,0.803,0.759,0.702
"9382","221519",2004,397,207,190,309,142,167,80.68,0.8068,0.778,0.747
"9383","221731",2004,163,102,61,49,11,38,37.25,0.3725,0.301,0.18
"9384","221847",2004,1476,611,865,312,122,190,31.1,0.311,0.211,0.141
"9385","221892",2004,237,119,118,84,38,46,38.66,0.3866,0.354,0.322
"9386","222178",2004,1018,553,465,377,127,250,45.21,0.4521,0.37,0.273
"9387","222983",2004,370,193,177,274,121,153,79.27,0.7927,0.741,0.684
"9388","223232",2004,2772,1674,1098,1398,488,910,54.36,0.5436,0.504,0.444
"9389","224004",2004,149,84,65,21,10,11,13.1,0.131,0.141,0.154
"9390","224323",2004,243,126,117,153,65,88,69.84,0.6984,0.63,0.556
"9391","225432",2004,964,541,423,10,5,5,0.92,0.0092,0.01,0.012
"9392","225548",2004,285,126,159,62,29,33,26.19,0.2619,0.218,0.182
"9393","225627",2004,474,331,143,61,12,49,14.8,0.148,0.129,0.084
"9394","226231",2004,327,92,235,98,58,40,43.48,0.4348,0.3,0.247
"9395","226833",2004,611,301,310,35,13,22,7.31,0.0731,0.057,0.042
"9396","227216",2004,3216,1872,1344,611,180,431,23.02,0.2302,0.19,0.134
"9397","227331",2004,216,171,45,30,3,27,15.79,0.1579,0.139,0.067
"9398","227526",2004,1573,823,750,156,56,100,12.15,0.1215,0.099,0.075
"9399","227757",2004,725,380,345,574,259,315,82.89,0.8289,0.792,0.751
"9400","227845",2004,600,371,229,291,97,194,52.29,0.5229,0.485,0.424
"9401","227863",2004,297,189,108,80,24,56,29.63,0.2963,0.269,0.222
"9402","228042",2004,204,122,82,53,20,33,27.05,0.2705,0.26,0.244
"9403","228149",2004,463,277,186,159,51,108,38.99,0.3899,0.343,0.274
"9404","228246",2004,1313,717,596,789,310,479,66.81,0.6681,0.601,0.52
"9405","228343",2004,366,221,145,228,68,160,72.4,0.724,0.623,0.469
"9406","228431",2004,1736,1091,645,381,95,286,26.21,0.2621,0.219,0.147
"9407","228459",2004,2783,1616,1167,691,187,504,31.19,0.3119,0.248,0.16
"9408","228501",2004,275,113,162,25,11,14,12.39,0.1239,0.091,0.068
"9409","228529",2004,1178,655,523,200,59,141,21.53,0.2153,0.17,0.113
"9410","228705",2004,741,328,413,80,29,51,15.55,0.1555,0.108,0.07
"9411","228723",2004,6645,3465,3180,3071,1049,2022,58.35,0.5835,0.462,0.33
"9412","228769",2004,2009,1068,941,325,115,210,19.66,0.1966,0.162,0.122
"9413","228778",2004,6741,3693,3048,3540,1426,2114,57.24,0.5724,0.525,0.468
"9414","228787",2004,1129,429,700,473,255,218,50.82,0.5082,0.419,0.364
"9415","228796",2004,2296,1205,1091,174,58,116,9.63,0.0963,0.076,0.053
"9416","228875",2004,1605,988,617,866,276,590,59.72,0.5972,0.54,0.447
"9417","228981",2004,399,202,197,105,40,65,32.18,0.3218,0.263,0.203
"9418","229018",2004,258,136,122,39,16,23,16.91,0.1691,0.151,0.131
"9419","229027",2004,4193,2129,2064,315,103,212,9.96,0.0996,0.075,0.05
"9420","229115",2004,3833,1894,1939,1419,554,865,45.67,0.4567,0.37,0.286
"9421","229780",2004,212,109,103,59,26,33,30.28,0.3028,0.278,0.252
"9422","229814",2004,790,424,366,151,42,109,25.71,0.2571,0.191,0.115
"9423","230603",2004,656,445,211,130,18,112,25.17,0.2517,0.198,0.085
"9424","230728",2004,1591,1048,543,433,70,363,34.64,0.3464,0.272,0.129
"9425","230764",2004,1997,1133,864,453,152,301,26.57,0.2657,0.227,0.176
"9426","230782",2004,1559,882,677,94,28,66,7.48,0.0748,0.06,0.041
"9427","231059",2004,518,280,238,378,165,213,76.07,0.7607,0.73,0.693
"9428","231174",2004,1953,1079,874,1188,476,712,65.99,0.6599,0.608,0.545
"9429","231420",2004,191,68,123,53,25,28,41.18,0.4118,0.277,0.203
"9430","231554",2004,135,82,53,38,14,24,29.27,0.2927,0.281,0.264
"9431","231624",2004,1335,683,652,1097,494,603,88.29,0.8829,0.822,0.758
"9432","231712",2004,1174,638,536,498,151,347,54.39,0.5439,0.424,0.282
"9433","232025",2004,260,142,118,125,48,77,54.23,0.5423,0.481,0.407
"9434","232043",2004,207,134,73,91,33,58,43.28,0.4328,0.44,0.452
"9435","232089",2004,287,114,173,53,21,32,28.07,0.2807,0.185,0.121
"9436","232186",2004,2210,1203,1007,869,311,558,46.38,0.4638,0.393,0.309
"9437","232265",2004,1345,863,482,514,131,383,44.38,0.4438,0.382,0.272
"9438","232423",2004,3281,2112,1169,2216,690,1526,72.25,0.7225,0.675,0.59
"9439","232557",2004,2173,1178,995,647,251,396,33.62,0.3362,0.298,0.252
"9440","232566",2004,972,631,341,386,111,275,43.58,0.4358,0.397,0.326
"9441","232609",2004,568,328,240,275,87,188,57.32,0.5732,0.484,0.362
"9442","232681",2004,869,569,300,590,183,407,71.53,0.7153,0.679,0.61
"9443","232706",2004,414,310,104,180,45,135,43.55,0.4355,0.435,0.433
"9444","232937",2004,970,580,390,103,20,83,14.31,0.1431,0.106,0.051
"9445","232982",2004,1917,1053,864,474,136,338,32.1,0.321,0.247,0.157
"9446","233277",2004,1828,1135,693,708,209,499,43.96,0.4396,0.387,0.302
"9447","233374",2004,763,391,372,620,298,322,82.35,0.8235,0.813,0.801
"9448","233426",2004,483,288,195,314,114,200,69.44,0.6944,0.65,0.585
"9449","233541",2004,325,160,165,98,39,59,36.88,0.3688,0.302,0.236
"9450","233897",2004,373,180,193,130,61,69,38.33,0.3833,0.349,0.316
"9451","233921",2004,4923,2042,2881,2599,1252,1347,65.96,0.6596,0.528,0.435
"9452","234030",2004,3271,1960,1311,749,220,529,26.99,0.2699,0.229,0.168
"9453","234085",2004,363,24,339,216,205,11,45.83,0.4583,0.595,0.605
"9454","234155",2004,1025,656,369,250,54,196,29.88,0.2988,0.244,0.146
"9455","234164",2004,431,247,184,78,17,61,24.7,0.247,0.181,0.092
"9456","235097",2004,1403,813,590,297,102,195,23.99,0.2399,0.212,0.173
"9457","235167",2004,479,250,229,185,87,98,39.2,0.392,0.386,0.38
"9458","236230",2004,697,462,235,327,96,231,50,0.5,0.469,0.409
"9459","236328",2004,671,390,281,471,190,281,72.05,0.7205,0.702,0.676
"9460","236577",2004,633,414,219,341,115,226,54.59,0.5459,0.539,0.525
"9461","236595",2004,719,447,272,407,138,269,60.18,0.6018,0.566,0.507
"9462","236896",2004,352,173,179,83,33,50,28.9,0.289,0.236,0.184
"9463","236939",2004,3089,1622,1467,1251,495,756,46.61,0.4661,0.405,0.337
"9464","236948",2004,4867,2639,2228,2625,1075,1550,58.73,0.5873,0.539,0.482
"9465","237011",2004,2425,1405,1020,876,287,589,41.92,0.4192,0.361,0.281
"9466","237057",2004,385,222,163,308,124,184,82.88,0.8288,0.8,0.761
"9467","237066",2004,469,266,203,308,127,181,68.05,0.6805,0.657,0.626
"9468","237215",2004,244,138,106,14,8,6,4.35,0.0435,0.057,0.075
"9469","237330",2004,488,262,226,75,30,45,17.18,0.1718,0.154,0.133
"9470","237358",2004,142,77,65,57,26,31,40.26,0.4026,0.401,0.4
"9471","237367",2004,602,321,281,90,27,63,19.63,0.1963,0.15,0.096
"9472","237792",2004,774,427,347,119,44,75,17.56,0.1756,0.154,0.127
"9473","237899",2004,331,175,156,18,8,10,5.71,0.0571,0.054,0.051
"9474","237932",2004,459,238,221,92,35,57,23.95,0.2395,0.2,0.158
"9475","237969",2004,348,181,167,148,59,89,49.17,0.4917,0.425,0.353
"9476","238032",2004,4308,2032,2276,1416,571,845,41.58,0.4158,0.329,0.251
"9477","238333",2004,323,176,147,218,97,121,68.75,0.6875,0.675,0.66
"9478","238430",2004,157,120,37,63,8,55,45.83,0.4583,0.401,0.216
"9479","238458",2004,616,405,211,234,61,173,42.72,0.4272,0.38,0.289
"9480","238476",2004,579,344,235,277,101,176,51.16,0.5116,0.478,0.43
"9481","238616",2004,363,198,165,145,57,88,44.44,0.4444,0.399,0.345
"9482","238661",2004,298,214,84,95,20,75,35.05,0.3505,0.319,0.238
"9483","239080",2004,270,191,79,84,16,68,35.6,0.356,0.311,0.203
"9484","239105",2004,1802,979,823,1118,454,664,67.82,0.6782,0.62,0.552
"9485","239628",2004,202,114,88,115,53,62,54.39,0.5439,0.569,0.602
"9486","239716",2004,520,298,222,364,138,226,75.84,0.7584,0.7,0.622
"9487","240107",2004,308,210,98,82,19,63,30,0.3,0.266,0.194
"9488","240189",2004,1745,836,909,427,193,234,27.99,0.2799,0.245,0.212
"9489","240277",2004,989,636,353,228,71,157,24.69,0.2469,0.231,0.201
"9490","240329",2004,1539,958,581,498,157,341,35.59,0.3559,0.324,0.27
"9491","240338",2004,186,112,74,79,28,51,45.54,0.4554,0.425,0.378
"9492","240365",2004,1708,1033,675,250,78,172,16.65,0.1665,0.146,0.116
"9493","240374",2004,890,491,399,87,34,53,10.79,0.1079,0.098,0.085
"9494","240417",2004,1277,649,628,254,67,187,28.81,0.2881,0.199,0.107
"9495","240426",2004,329,190,139,54,20,34,17.89,0.1789,0.164,0.144
"9496","240444",2004,5617,3124,2493,2792,1096,1696,54.29,0.5429,0.497,0.44
"9497","240453",2004,3714,2000,1714,555,216,339,16.95,0.1695,0.149,0.126
"9498","240462",2004,1164,398,766,205,90,115,28.89,0.2889,0.176,0.117
"9499","240471",2004,1197,722,475,311,109,202,27.98,0.2798,0.26,0.229
"9500","240480",2004,1525,857,668,322,118,204,23.8,0.238,0.211,0.177
"9501","240727",2004,1496,754,742,336,133,203,26.92,0.2692,0.225,0.179
"9502","243443",2004,519,340,179,50,11,39,11.47,0.1147,0.096,0.061
"9503","243780",2004,6766,2781,3985,2419,1066,1353,48.65,0.4865,0.358,0.268
"9504","100654",2005,1088,572,516,116,27,89,15.56,0.1556,0.107,0.052
"9505","100663",2005,1515,895,620,350,110,240,26.82,0.2682,0.231,0.177
"9506","100751",2005,3642,2038,1604,1373,491,882,43.28,0.4328,0.377,0.306
"9507","100858",2005,4179,2180,1999,1491,511,980,44.95,0.4495,0.357,0.256
"9508","101435",2005,185,90,95,78,34,44,48.89,0.4889,0.422,0.358
"9509","101480",2005,1120,595,525,120,37,83,13.95,0.1395,0.107,0.07
"9510","101675",2005,389,177,212,25,4,21,11.86,0.1186,0.064,0.019
"9511","101879",2005,982,526,456,2,1,1,0.19,0.0019,0.002,0.002
"9512","102049",2005,699,457,242,358,93,265,57.99,0.5799,0.512,0.384
"9513","102094",2005,1198,689,509,199,62,137,19.88,0.1988,0.166,0.122
"9514","102234",2005,274,173,101,139,49,90,52.02,0.5202,0.507,0.485
"9515","102368",2005,1434,789,645,201,64,137,17.36,0.1736,0.14,0.099
"9516","102377",2005,730,385,345,112,30,82,21.3,0.213,0.153,0.087
"9517","104151",2005,7927,4267,3660,2561,996,1565,36.68,0.3668,0.323,0.272
"9518","104179",2005,5785,3115,2670,2104,820,1284,41.22,0.4122,0.364,0.307
"9519","105330",2005,2101,1268,833,645,174,471,37.15,0.3715,0.307,0.209
"9520","106245",2005,762,445,317,64,24,40,8.99,0.0899,0.084,0.076
"9521","106342",2005,111,61,50,45,20,25,40.98,0.4098,0.405,0.4
"9522","106397",2005,2662,1324,1338,913,375,538,40.63,0.4063,0.343,0.28
"9523","106412",2005,714,349,365,74,24,50,14.33,0.1433,0.104,0.066
"9524","106458",2005,1483,826,657,288,108,180,21.79,0.2179,0.194,0.164
"9525","106467",2005,1457,714,743,253,104,149,20.87,0.2087,0.174,0.14
"9526","106485",2005,625,337,288,55,20,35,10.39,0.1039,0.088,0.069
"9527","106704",2005,2429,1376,1053,467,136,331,24.06,0.2406,0.192,0.129
"9528","107044",2005,955,527,428,396,132,264,50.09,0.5009,0.415,0.308
"9529","107080",2005,280,156,124,179,73,106,67.95,0.6795,0.639,0.589
"9530","107141",2005,262,132,130,143,71,72,54.55,0.5455,0.546,0.546
"9531","107512",2005,365,213,152,181,66,115,53.99,0.5399,0.496,0.434
"9532","107558",2005,168,89,79,48,19,29,32.58,0.3258,0.286,0.241
"9533","110097",2005,670,416,254,337,111,226,54.33,0.5433,0.503,0.437
"9534","110404",2005,233,69,164,178,127,51,73.91,0.7391,0.764,0.774
"9535","110422",2005,3318,1599,1719,1021,345,676,42.28,0.4228,0.308,0.201
"9536","110486",2005,766,503,263,114,21,93,18.49,0.1849,0.149,0.08
"9537","110495",2005,741,511,230,151,31,120,23.48,0.2348,0.204,0.135
"9538","110510",2005,1645,1092,553,212,75,137,12.55,0.1255,0.129,0.136
"9539","110529",2005,3089,1296,1793,380,157,223,17.21,0.1721,0.123,0.088
"9540","110538",2005,2300,1237,1063,439,118,321,25.95,0.2595,0.191,0.111
"9541","110547",2005,705,476,229,42,9,33,6.93,0.0693,0.06,0.039
"9542","110556",2005,2356,1403,953,323,106,217,15.47,0.1547,0.137,0.111
"9543","110565",2005,3816,2241,1575,524,134,390,17.4,0.174,0.137,0.085
"9544","110574",2005,686,414,272,110,39,71,17.15,0.1715,0.16,0.143
"9545","110583",2005,4241,2666,1575,524,153,371,13.92,0.1392,0.124,0.097
"9546","110592",2005,1253,823,430,111,31,80,9.72,0.0972,0.089,0.072
"9547","110617",2005,2436,1483,953,256,73,183,12.34,0.1234,0.105,0.077
"9548","113698",2005,227,168,59,98,22,76,45.24,0.4524,0.432,0.373
"9549","115755",2005,813,461,352,99,32,67,14.53,0.1453,0.122,0.091
"9550","119173",2005,393,378,15,68,3,65,17.2,0.172,0.173,0.2
"9551","120184",2005,144,95,49,59,14,45,47.37,0.4737,0.41,0.286
"9552","121309",2005,562,339,223,348,125,223,65.78,0.6578,0.619,0.561
"9553","121345",2005,382,193,189,347,169,178,92.23,0.9223,0.908,0.894
"9554","122409",2005,3439,2039,1400,1011,323,688,33.74,0.3374,0.294,0.231
"9555","122436",2005,1131,710,421,726,238,488,68.73,0.6873,0.642,0.565
"9556","122597",2005,2999,1942,1057,360,105,255,13.13,0.1313,0.12,0.099
"9557","122612",2005,932,665,267,542,131,411,61.8,0.618,0.582,0.491
"9558","122931",2005,1197,667,530,917,384,533,79.91,0.7991,0.766,0.725
"9559","123554",2005,659,399,260,313,107,206,51.63,0.5163,0.475,0.412
"9560","123572",2005,1043,697,346,309,69,240,34.43,0.3443,0.296,0.199
"9561","126562",2005,744,414,330,108,30,78,18.84,0.1884,0.145,0.091
"9562","126580",2005,947,595,352,210,50,160,26.89,0.2689,0.222,0.142
"9563","126614",2005,5007,2364,2643,2007,900,1107,46.83,0.4683,0.401,0.341
"9564","126818",2005,3622,2036,1586,1278,406,872,42.83,0.4283,0.353,0.256
"9565","127060",2005,1089,608,481,655,251,404,66.45,0.6645,0.601,0.522
"9566","127185",2005,860,386,474,161,70,91,23.58,0.2358,0.187,0.148
"9567","127565",2005,1840,939,901,79,32,47,5.01,0.0501,0.043,0.036
"9568","127741",2005,2483,1479,1004,620,173,447,30.22,0.3022,0.25,0.172
"9569","128106",2005,665,361,304,125,54,71,19.67,0.1967,0.188,0.178
"9570","128744",2005,352,212,140,64,20,44,20.75,0.2075,0.182,0.143
"9571","128771",2005,1333,663,670,188,82,106,15.99,0.1599,0.141,0.122
"9572","129020",2005,3239,1789,1450,2176,881,1295,72.39,0.7239,0.672,0.608
"9573","129242",2005,940,551,389,744,297,447,81.13,0.8113,0.791,0.763
"9574","129941",2005,653,322,331,256,117,139,43.17,0.4317,0.392,0.353
"9575","130253",2005,886,542,344,544,186,358,66.05,0.6605,0.614,0.541
"9576","130314",2005,206,206,0,88,0,88,42.72,0.4272,0.427,NA
"9577","130493",2005,1313,866,447,192,43,149,17.21,0.1721,0.146,0.096
"9578","130590",2005,573,289,284,469,221,248,85.81,0.8581,0.818,0.778
"9579","130697",2005,705,360,345,614,305,309,85.83,0.8583,0.871,0.884
"9580","130776",2005,773,396,377,124,52,72,18.18,0.1818,0.16,0.138
"9581","130794",2005,1320,651,669,1172,574,598,91.86,0.9186,0.888,0.858
"9582","130934",2005,885,514,371,164,40,124,24.12,0.2412,0.185,0.108
"9583","130943",2005,3830,2252,1578,2250,803,1447,64.25,0.6425,0.587,0.509
"9584","131159",2005,1216,778,438,898,319,579,74.42,0.7442,0.738,0.728
"9585","131283",2005,786,455,331,482,187,295,64.84,0.6484,0.613,0.565
"9586","131450",2005,280,151,129,28,7,21,13.91,0.1391,0.1,0.054
"9587","131469",2005,2408,1375,1033,1823,732,1091,79.35,0.7935,0.757,0.709
"9588","131496",2005,1530,774,756,1378,669,709,91.6,0.916,0.901,0.885
"9589","131520",2005,1410,944,466,635,166,469,49.68,0.4968,0.45,0.356
"9590","132471",2005,563,356,207,117,35,82,23.03,0.2303,0.208,0.169
"9591","132602",2005,913,525,388,140,52,88,16.76,0.1676,0.153,0.134
"9592","132903",2005,6041,3216,2825,2025,720,1305,40.58,0.4058,0.335,0.255
"9593","133492",2005,501,297,204,275,102,173,58.25,0.5825,0.549,0.5
"9594","133553",2005,975,152,823,307,246,61,40.13,0.4013,0.315,0.299
"9595","133650",2005,1636,925,711,183,61,122,13.19,0.1319,0.112,0.086
"9596","133669",2005,2080,1111,969,363,126,237,21.33,0.2133,0.175,0.13
"9597","133711",2005,459,283,176,216,77,139,49.12,0.4912,0.471,0.438
"9598","133881",2005,603,154,449,242,172,70,45.45,0.4545,0.401,0.383
"9599","133951",2005,3967,2261,1706,634,188,446,19.73,0.1973,0.16,0.11
"9600","134079",2005,462,274,188,190,60,130,47.45,0.4745,0.411,0.319
"9601","134097",2005,6052,3554,2498,2995,1066,1929,54.28,0.5428,0.495,0.427
"9602","134130",2005,7217,4080,3137,4230,1533,2697,66.1,0.661,0.586,0.489
"9603","134945",2005,544,252,292,127,59,68,26.98,0.2698,0.233,0.202
"9604","135726",2005,2258,1168,1090,1480,670,810,69.35,0.6935,0.655,0.615
"9605","136172",2005,2288,1296,992,518,179,339,26.16,0.2616,0.226,0.18
"9606","136950",2005,463,275,188,284,105,179,65.09,0.6509,0.613,0.559
"9607","137546",2005,547,312,235,308,135,173,55.45,0.5545,0.563,0.574
"9608","138354",2005,830,490,340,194,65,129,26.33,0.2633,0.234,0.191
"9609","138716",2005,596,388,208,93,16,77,19.85,0.1985,0.156,0.077
"9610","138789",2005,700,453,247,70,14,56,12.36,0.1236,0.1,0.057
"9611","139144",2005,513,316,197,226,65,161,50.95,0.5095,0.441,0.33
"9612","139366",2005,1067,641,426,129,33,96,14.98,0.1498,0.121,0.077
"9613","139393",2005,270,138,132,122,48,74,53.62,0.5362,0.452,0.364
"9614","139658",2005,1631,933,698,1032,450,582,62.38,0.6238,0.633,0.645
"9615","139719",2005,317,169,148,48,11,37,21.89,0.2189,0.151,0.074
"9616","139755",2005,2415,714,1701,756,431,325,45.52,0.4552,0.313,0.253
"9617","139764",2005,358,200,158,36,9,27,13.5,0.135,0.101,0.057
"9618","139861",2005,1032,631,401,342,101,241,38.19,0.3819,0.331,0.252
"9619","139931",2005,3123,1472,1651,623,195,428,29.08,0.2908,0.199,0.118
"9620","139940",2005,2325,1322,1003,408,164,244,18.46,0.1846,0.175,0.164
"9621","139959",2005,4654,2812,1842,2505,845,1660,59.03,0.5903,0.538,0.459
"9622","140447",2005,666,408,258,267,86,181,44.36,0.4436,0.401,0.333
"9623","140960",2005,806,427,379,73,16,57,13.35,0.1335,0.091,0.042
"9624","140988",2005,291,133,158,101,40,61,45.86,0.4586,0.347,0.253
"9625","141185",2005,223,135,88,84,27,57,42.22,0.4222,0.377,0.307
"9626","141264",2005,1775,1072,703,299,69,230,21.46,0.2146,0.168,0.098
"9627","141334",2005,1640,966,674,212,47,165,17.08,0.1708,0.129,0.07
"9628","141486",2005,260,182,78,57,12,45,24.73,0.2473,0.219,0.154
"9629","141565",2005,409,215,194,50,15,35,16.28,0.1628,0.122,0.077
"9630","141574",2005,1923,1060,863,354,128,226,21.32,0.2132,0.184,0.148
"9631","142276",2005,909,519,390,74,22,52,10.02,0.1002,0.081,0.056
"9632","142285",2005,1673,823,850,386,156,230,27.95,0.2795,0.231,0.184
"9633","142461",2005,249,168,81,88,24,64,38.1,0.381,0.353,0.296
"9634","143084",2005,679,383,296,474,193,281,73.37,0.7337,0.698,0.652
"9635","143288",2005,183,92,91,66,30,36,39.13,0.3913,0.361,0.33
"9636","144005",2005,405,268,137,15,4,11,4.1,0.041,0.037,0.029
"9637","144281",2005,1795,933,862,504,219,285,30.55,0.3055,0.281,0.254
"9638","144740",2005,2392,1411,981,1168,450,718,50.89,0.5089,0.488,0.459
"9639","144892",2005,1645,967,678,521,168,353,36.5,0.365,0.317,0.248
"9640","144962",2005,466,282,184,252,84,168,59.57,0.5957,0.541,0.457
"9641","144971",2005,138,74,64,66,29,37,50,0.5,0.478,0.453
"9642","145600",2005,2759,1534,1225,742,294,448,29.2,0.292,0.269,0.24
"9643","145619",2005,308,163,145,97,42,55,33.74,0.3374,0.315,0.29
"9644","145637",2005,7565,3511,4054,4966,2375,2591,73.8,0.738,0.656,0.586
"9645","145691",2005,256,117,139,124,60,64,54.7,0.547,0.484,0.432
"9646","145813",2005,3167,1970,1197,1388,419,969,49.19,0.4919,0.438,0.35
"9647","146481",2005,358,202,156,213,78,135,66.83,0.6683,0.595,0.5
"9648","146612",2005,557,321,236,232,92,140,43.61,0.4361,0.417,0.39
"9649","146719",2005,2080,1365,715,1053,346,707,51.79,0.5179,0.506,0.484
"9650","146825",2005,159,77,82,35,10,25,32.47,0.3247,0.22,0.122
"9651","147013",2005,273,126,147,94,39,55,43.65,0.4365,0.344,0.265
"9652","147244",2005,572,313,259,311,119,192,61.34,0.6134,0.544,0.459
"9653","147341",2005,367,180,187,140,50,90,50,0.5,0.381,0.267
"9654","147703",2005,3171,1637,1534,826,360,466,28.47,0.2847,0.26,0.235
"9655","147767",2005,1952,1018,934,1669,756,913,89.69,0.8969,0.855,0.809
"9656","147776",2005,960,570,390,51,16,35,6.14,0.0614,0.053,0.041
"9657","147828",2005,669,404,265,294,94,200,49.5,0.495,0.439,0.355
"9658","148131",2005,202,99,103,69,28,41,41.41,0.4141,0.342,0.272
"9659","148496",2005,266,178,88,147,46,101,56.74,0.5674,0.553,0.523
"9660","148584",2005,190,116,74,85,27,58,50,0.5,0.447,0.365
"9661","148627",2005,410,236,174,133,50,83,35.17,0.3517,0.324,0.287
"9662","149222",2005,2382,1034,1348,560,261,299,28.92,0.2892,0.235,0.194
"9663","149231",2005,1721,994,727,487,166,321,32.29,0.3229,0.283,0.228
"9664","149772",2005,1802,885,917,549,265,284,32.09,0.3209,0.305,0.289
"9665","149781",2005,578,287,291,458,220,238,82.93,0.8293,0.792,0.756
"9666","150066",2005,565,348,217,272,93,179,51.44,0.5144,0.481,0.429
"9667","150136",2005,3660,1892,1768,1063,367,696,36.79,0.3679,0.29,0.208
"9668","150145",2005,310,207,103,122,41,81,39.13,0.3913,0.394,0.398
"9669","150163",2005,864,536,328,391,119,272,50.75,0.5075,0.453,0.363
"9670","150400",2005,586,337,249,470,197,273,81.01,0.8101,0.802,0.791
"9671","150534",2005,670,416,254,337,105,232,55.77,0.5577,0.503,0.413
"9672","150668",2005,194,108,86,113,44,69,63.89,0.6389,0.582,0.512
"9673","150941",2005,232,133,99,113,45,68,51.13,0.5113,0.487,0.455
"9674","151102",2005,1534,850,684,82,31,51,6,0.06,0.053,0.045
"9675","151111",2005,2396,1414,982,234,88,146,10.33,0.1033,0.098,0.09
"9676","151306",2005,2042,1195,847,306,90,216,18.08,0.1808,0.15,0.106
"9677","151324",2005,1622,810,812,311,122,189,23.33,0.2333,0.192,0.15
"9678","151333",2005,382,251,131,31,6,25,9.96,0.0996,0.081,0.046
"9679","151342",2005,805,466,339,34,16,18,3.86,0.0386,0.042,0.047
"9680","151351",2005,6903,3785,3118,3425,1383,2042,53.95,0.5395,0.496,0.444
"9681","151360",2005,471,280,191,33,19,14,5,0.05,0.07,0.099
"9682","151379",2005,664,409,255,53,12,41,10.02,0.1002,0.08,0.047
"9683","151388",2005,284,179,105,13,2,11,6.15,0.0615,0.046,0.019
"9684","151777",2005,329,170,159,140,50,90,52.94,0.5294,0.426,0.314
"9685","151786",2005,189,127,62,64,17,47,37.01,0.3701,0.339,0.274
"9686","152080",2005,1990,935,1055,1800,942,858,91.76,0.9176,0.905,0.893
"9687","152248",2005,1093,599,494,57,23,34,5.68,0.0568,0.052,0.047
"9688","152363",2005,266,145,121,128,41,87,60,0.6,0.481,0.339
"9689","152530",2005,459,271,188,342,142,200,73.8,0.738,0.745,0.755
"9690","152600",2005,672,332,340,421,183,238,71.69,0.7169,0.626,0.538
"9691","153001",2005,286,143,143,121,50,71,49.65,0.4965,0.423,0.35
"9692","153108",2005,366,203,163,213,93,120,59.11,0.5911,0.582,0.571
"9693","153269",2005,809,465,344,438,173,265,56.99,0.5699,0.541,0.503
"9694","153384",2005,385,206,179,320,148,172,83.5,0.835,0.831,0.827
"9695","153603",2005,3737,1629,2108,1248,535,713,43.77,0.4377,0.334,0.254
"9696","153834",2005,629,354,275,367,140,227,64.12,0.6412,0.583,0.509
"9697","154095",2005,1693,1062,631,618,184,434,40.87,0.4087,0.365,0.292
"9698","155089",2005,151,72,79,16,7,9,12.5,0.125,0.106,0.089
"9699","155317",2005,4106,2115,1991,1332,518,814,38.49,0.3849,0.324,0.26
"9700","155335",2005,181,84,97,31,12,19,22.62,0.2262,0.171,0.124
"9701","155399",2005,3105,1561,1544,697,255,442,28.32,0.2832,0.224,0.165
"9702","155520",2005,216,109,107,61,21,40,36.7,0.367,0.282,0.196
"9703","155627",2005,113,47,66,36,19,17,36.17,0.3617,0.319,0.288
"9704","155937",2005,126,57,69,38,16,22,38.6,0.386,0.302,0.232
"9705","156213",2005,276,173,103,168,64,104,60.12,0.6012,0.609,0.621
"9706","156286",2005,435,282,153,224,69,155,54.96,0.5496,0.515,0.451
"9707","156295",2005,378,219,159,161,67,94,42.92,0.4292,0.426,0.421
"9708","156365",2005,345,174,171,83,29,54,31.03,0.3103,0.241,0.17
"9709","156541",2005,424,192,232,111,48,63,32.81,0.3281,0.262,0.207
"9710","156745",2005,416,216,200,209,83,126,58.33,0.5833,0.502,0.415
"9711","157058",2005,408,223,185,17,4,13,5.83,0.0583,0.042,0.022
"9712","157076",2005,209,100,109,67,22,45,45,0.45,0.321,0.202
"9713","157085",2005,3824,2045,1779,1291,502,789,38.58,0.3858,0.338,0.282
"9714","157289",2005,2255,1144,1111,497,205,292,25.52,0.2552,0.22,0.185
"9715","157386",2005,1310,745,565,162,55,107,14.36,0.1436,0.124,0.097
"9716","157401",2005,1442,841,601,532,180,352,41.85,0.4185,0.369,0.3
"9717","157447",2005,1759,1000,759,185,50,135,13.5,0.135,0.105,0.066
"9718","157535",2005,206,98,108,31,8,23,23.47,0.2347,0.15,0.074
"9719","157951",2005,3002,1680,1322,539,189,350,20.83,0.2083,0.18,0.143
"9720","158477",2005,232,145,87,104,33,71,48.97,0.4897,0.448,0.379
"9721","159009",2005,1129,568,561,82,22,60,10.56,0.1056,0.073,0.039
"9722","159391",2005,4966,2653,2313,1440,576,864,32.57,0.3257,0.29,0.249
"9723","159647",2005,1653,762,891,446,177,269,35.3,0.353,0.27,0.199
"9724","159717",2005,1311,743,568,177,52,125,16.82,0.1682,0.135,0.092
"9725","159966",2005,1171,703,468,163,62,101,14.37,0.1437,0.139,0.132
"9726","160038",2005,1417,869,548,218,71,147,16.92,0.1692,0.154,0.13
"9727","160612",2005,2228,1388,840,252,74,178,12.82,0.1282,0.113,0.088
"9728","160621",2005,1434,797,637,290,93,197,24.72,0.2472,0.202,0.146
"9729","160658",2005,2730,1538,1192,329,102,227,14.76,0.1476,0.121,0.086
"9730","161004",2005,477,257,220,420,189,231,89.88,0.8988,0.881,0.859
"9731","161226",2005,559,387,172,229,60,169,43.67,0.4367,0.41,0.349
"9732","161235",2005,129,69,60,22,9,13,18.84,0.1884,0.171,0.15
"9733","161244",2005,106,71,35,17,5,12,16.9,0.169,0.16,0.143
"9734","161253",2005,1703,842,861,615,262,353,41.92,0.4192,0.361,0.304
"9735","161554",2005,911,518,393,88,31,57,11,0.11,0.097,0.079
"9736","162007",2005,923,567,356,203,53,150,26.46,0.2646,0.22,0.149
"9737","162210",2005,172,113,59,23,9,14,12.39,0.1239,0.134,0.153
"9738","162283",2005,661,502,159,24,4,20,3.98,0.0398,0.036,0.025
"9739","162584",2005,928,448,480,181,60,121,27.01,0.2701,0.195,0.125
"9740","162654",2005,340,217,123,210,68,142,65.44,0.6544,0.618,0.553
"9741","162760",2005,236,156,80,142,44,98,62.82,0.6282,0.602,0.55
"9742","162928",2005,1228,587,641,1036,523,513,87.39,0.8739,0.844,0.816
"9743","163046",2005,898,526,372,711,291,420,79.85,0.7985,0.792,0.782
"9744","163268",2005,1414,584,830,466,237,229,39.21,0.3921,0.33,0.286
"9745","163286",2005,4192,2081,2111,2769,1273,1496,71.89,0.7189,0.661,0.603
"9746","163453",2005,764,408,356,89,22,67,16.42,0.1642,0.116,0.062
"9747","163462",2005,437,267,170,315,127,188,70.41,0.7041,0.721,0.747
"9748","163851",2005,952,525,427,442,146,296,56.38,0.5638,0.464,0.342
"9749","163912",2005,488,295,193,341,130,211,71.53,0.7153,0.699,0.674
"9750","164076",2005,2314,1455,859,910,270,640,43.99,0.4399,0.393,0.314
"9751","164173",2005,537,373,164,236,61,175,46.92,0.4692,0.439,0.372
"9752","164216",2005,345,201,144,247,90,157,78.11,0.7811,0.716,0.625
"9753","164270",2005,447,246,201,314,136,178,72.36,0.7236,0.702,0.677
"9754","164447",2005,328,160,168,65,32,33,20.62,0.2062,0.198,0.19
"9755","164492",2005,156,79,77,58,27,31,39.24,0.3924,0.372,0.351
"9756","164562",2005,565,328,237,369,132,237,72.26,0.7226,0.653,0.557
"9757","165015",2005,737,397,340,647,287,360,90.68,0.9068,0.878,0.844
"9758","165024",2005,1314,746,568,339,113,226,30.29,0.3029,0.258,0.199
"9759","165334",2005,557,338,219,422,161,261,77.22,0.7722,0.758,0.735
"9760","165662",2005,715,417,298,571,243,328,78.66,0.7866,0.799,0.815
"9761","165671",2005,438,327,111,237,63,174,53.21,0.5321,0.541,0.568
"9762","165820",2005,599,297,302,125,54,71,23.91,0.2391,0.209,0.179
"9763","165866",2005,666,461,205,210,44,166,36.01,0.3601,0.315,0.215
"9764","165936",2005,414,259,155,254,79,175,67.57,0.6757,0.614,0.51
"9765","166027",2005,1637,819,818,1421,698,723,88.28,0.8828,0.868,0.853
"9766","166124",2005,723,399,324,645,281,364,91.23,0.9123,0.892,0.867
"9767","166513",2005,1062,390,672,318,160,158,40.51,0.4051,0.299,0.238
"9768","166629",2005,4510,2316,2194,2268,970,1298,56.04,0.5604,0.503,0.442
"9769","166638",2005,723,419,304,100,34,66,15.75,0.1575,0.138,0.112
"9770","166683",2005,995,465,530,847,436,411,88.39,0.8839,0.851,0.823
"9771","167288",2005,271,177,94,104,36,68,38.42,0.3842,0.384,0.383
"9772","167987",2005,1703,816,887,505,212,293,35.91,0.3591,0.297,0.239
"9773","167996",2005,616,354,262,478,190,288,81.36,0.8136,0.776,0.725
"9774","168005",2005,1127,682,445,416,143,273,40.03,0.4003,0.369,0.321
"9775","168148",2005,1364,682,682,1159,559,600,87.98,0.8798,0.85,0.82
"9776","168254",2005,662,244,418,341,188,153,62.7,0.627,0.515,0.45
"9777","168281",2005,467,301,166,341,119,222,73.75,0.7375,0.73,0.717
"9778","168342",2005,536,280,256,477,226,251,89.64,0.8964,0.89,0.883
"9779","168546",2005,571,315,256,372,160,212,67.3,0.673,0.651,0.625
"9780","168786",2005,364,240,124,160,49,111,46.25,0.4625,0.44,0.395
"9781","169080",2005,1000,564,436,598,232,366,64.89,0.6489,0.598,0.532
"9782","169798",2005,2301,1416,885,297,89,208,14.69,0.1469,0.129,0.101
"9783","169910",2005,2189,1003,1186,140,59,81,8.08,0.0808,0.064,0.05
"9784","170082",2005,3407,2220,1187,1011,308,703,31.67,0.3167,0.297,0.259
"9785","170301",2005,774,463,311,531,194,337,72.79,0.7279,0.686,0.624
"9786","170532",2005,377,196,181,286,134,152,77.55,0.7755,0.759,0.74
"9787","170639",2005,474,216,258,62,31,31,14.35,0.1435,0.131,0.12
"9788","170976",2005,6080,3071,3009,4431,2061,2370,77.17,0.7717,0.729,0.685
"9789","171100",2005,7303,4147,3156,3470,1232,2238,53.97,0.5397,0.475,0.39
"9790","171128",2005,1321,236,1085,327,243,84,35.59,0.3559,0.248,0.224
"9791","171137",2005,798,381,417,128,47,81,21.26,0.2126,0.16,0.113
"9792","171146",2005,509,293,216,48,18,30,10.24,0.1024,0.094,0.083
"9793","171599",2005,257,103,154,77,33,44,42.72,0.4272,0.3,0.214
"9794","172051",2005,1233,742,491,102,26,76,10.24,0.1024,0.083,0.053
"9795","172699",2005,3702,1917,1785,919,374,545,28.43,0.2843,0.248,0.21
"9796","173160",2005,683,425,258,436,149,287,67.53,0.6753,0.638,0.578
"9797","173258",2005,542,278,264,478,226,252,90.65,0.9065,0.882,0.856
"9798","173328",2005,163,84,79,53,21,32,38.1,0.381,0.325,0.266
"9799","173647",2005,739,439,300,588,208,380,86.56,0.8656,0.796,0.693
"9800","173902",2005,491,287,204,405,158,247,86.06,0.8606,0.825,0.775
"9801","174066",2005,5274,2856,2418,2488,1023,1465,51.3,0.513,0.472,0.423
"9802","174233",2005,2111,1025,1086,565,243,322,31.41,0.3141,0.268,0.224
"9803","174251",2005,353,207,146,171,63,108,52.17,0.5217,0.484,0.432
"9804","174491",2005,476,295,181,221,76,145,49.15,0.4915,0.464,0.42
"9805","174792",2005,447,0,447,325,325,0,NA,NA,0.727,0.727
"9806","174844",2005,764,426,338,617,270,347,81.46,0.8146,0.808,0.799
"9807","174899",2005,490,350,140,265,70,195,55.71,0.5571,0.541,0.5
"9808","174914",2005,1325,706,619,812,342,470,66.57,0.6657,0.613,0.553
"9809","175342",2005,526,274,252,100,44,56,20.44,0.2044,0.19,0.175
"9810","175421",2005,201,105,96,68,16,52,49.52,0.4952,0.338,0.167
"9811","175616",2005,393,222,171,67,25,42,18.92,0.1892,0.17,0.146
"9812","175856",2005,1131,690,441,221,64,157,22.75,0.2275,0.195,0.145
"9813","175980",2005,258,118,140,158,76,82,69.49,0.6949,0.612,0.543
"9814","176017",2005,2131,1139,992,800,280,520,45.65,0.4565,0.375,0.282
"9815","176035",2005,238,204,34,53,5,48,23.53,0.2353,0.223,0.147
"9816","176044",2005,398,197,201,43,13,30,15.23,0.1523,0.108,0.065
"9817","176080",2005,1951,1010,941,585,215,370,36.63,0.3663,0.3,0.228
"9818","176406",2005,207,146,61,61,15,46,31.51,0.3151,0.295,0.246
"9819","176628",2005,154,95,59,38,11,27,28.42,0.2842,0.247,0.186
"9820","176947",2005,223,96,127,73,29,44,45.83,0.4583,0.327,0.228
"9821","176965",2005,1484,810,674,410,164,246,30.37,0.3037,0.276,0.243
"9822","177418",2005,187,136,51,44,9,35,25.74,0.2574,0.235,0.176
"9823","178059",2005,322,232,90,182,42,140,60.34,0.6034,0.565,0.467
"9824","178341",2005,836,466,370,106,32,74,15.88,0.1588,0.127,0.086
"9825","178387",2005,1005,557,448,111,42,69,12.39,0.1239,0.11,0.094
"9826","178396",2005,4662,2513,2149,2087,810,1277,50.82,0.5082,0.448,0.377
"9827","178402",2005,1007,574,433,173,61,112,19.51,0.1951,0.172,0.141
"9828","178411",2005,877,168,709,224,154,70,41.67,0.4167,0.255,0.217
"9829","178420",2005,497,288,209,124,41,83,28.82,0.2882,0.249,0.196
"9830","178615",2005,1441,830,611,626,232,394,47.47,0.4747,0.434,0.38
"9831","179043",2005,370,203,167,237,110,127,62.56,0.6256,0.641,0.659
"9832","179159",2005,1521,859,662,925,377,548,63.8,0.638,0.608,0.569
"9833","179557",2005,1538,918,620,369,102,267,29.08,0.2908,0.24,0.165
"9834","179566",2005,2575,1490,1085,822,273,549,36.85,0.3685,0.319,0.252
"9835","179867",2005,1372,715,657,1186,544,642,89.79,0.8979,0.864,0.828
"9836","179894",2005,394,224,170,175,76,99,44.2,0.442,0.444,0.447
"9837","179946",2005,287,125,162,143,65,78,62.4,0.624,0.498,0.401
"9838","180179",2005,796,463,333,79,26,53,11.45,0.1145,0.099,0.078
"9839","180461",2005,1980,843,1137,412,198,214,25.39,0.2539,0.208,0.174
"9840","180522",2005,192,55,137,15,10,5,9.09,0.0909,0.078,0.073
"9841","180984",2005,289,146,143,113,33,80,54.79,0.5479,0.391,0.231
"9842","181002",2005,970,562,408,640,257,383,68.15,0.6815,0.66,0.63
"9843","181020",2005,256,146,110,153,56,97,66.44,0.6644,0.598,0.509
"9844","181127",2005,312,133,179,143,69,74,55.64,0.5564,0.458,0.385
"9845","181215",2005,1013,584,429,228,71,157,26.88,0.2688,0.225,0.166
"9846","181394",2005,1690,911,779,259,105,154,16.9,0.169,0.153,0.135
"9847","181446",2005,406,237,169,236,82,154,64.98,0.6498,0.581,0.485
"9848","181464",2005,3533,1671,1862,1118,505,613,36.68,0.3668,0.316,0.271
"9849","181534",2005,213,112,101,26,7,19,16.96,0.1696,0.122,0.069
"9850","181783",2005,587,320,267,162,71,91,28.44,0.2844,0.276,0.266
"9851","182281",2005,2964,1694,1270,402,134,268,15.82,0.1582,0.136,0.106
"9852","182290",2005,2362,1300,1062,383,136,247,19,0.19,0.162,0.128
"9853","182634",2005,280,179,101,130,42,88,49.16,0.4916,0.464,0.416
"9854","182795",2005,532,270,262,2,0,2,0.74,0.0074,0.004,0
"9855","183062",2005,1001,565,436,434,172,262,46.37,0.4637,0.434,0.394
"9856","183080",2005,999,473,526,401,193,208,43.97,0.4397,0.401,0.367
"9857","183239",2005,519,296,223,372,145,227,76.69,0.7669,0.717,0.65
"9858","183822",2005,367,210,157,37,15,22,10.48,0.1048,0.101,0.096
"9859","183974",2005,240,160,80,115,35,80,50,0.5,0.479,0.438
"9860","184348",2005,391,218,173,240,103,137,62.84,0.6284,0.614,0.595
"9861","184603",2005,425,269,156,100,31,69,25.65,0.2565,0.235,0.199
"9862","184612",2005,236,163,73,38,13,25,15.34,0.1534,0.161,0.178
"9863","184782",2005,1239,607,632,554,270,284,46.79,0.4679,0.447,0.427
"9864","185129",2005,601,334,267,39,17,22,6.59,0.0659,0.065,0.064
"9865","185572",2005,942,503,439,436,176,260,51.69,0.5169,0.463,0.401
"9866","185590",2005,1868,1065,803,635,188,447,41.97,0.4197,0.34,0.234
"9867","185828",2005,746,129,617,126,101,25,19.38,0.1938,0.169,0.164
"9868","186131",2005,1224,558,666,1066,562,504,90.32,0.9032,0.871,0.844
"9869","186201",2005,746,460,286,445,137,308,66.96,0.6696,0.597,0.479
"9870","186283",2005,934,526,408,482,183,299,56.84,0.5684,0.516,0.449
"9871","186584",2005,1115,582,533,576,236,340,58.42,0.5842,0.517,0.443
"9872","186876",2005,808,460,348,346,104,242,52.61,0.5261,0.428,0.299
"9873","187134",2005,1236,685,551,914,383,531,77.52,0.7752,0.739,0.695
"9874","187444",2005,1296,652,644,235,89,146,22.39,0.2239,0.181,0.138
"9875","187985",2005,3010,1717,1293,372,130,242,14.09,0.1409,0.124,0.101
"9876","188030",2005,1945,1092,853,289,96,193,17.67,0.1767,0.149,0.113
"9877","188429",2005,754,505,249,416,121,295,58.42,0.5842,0.552,0.486
"9878","188641",2005,429,188,241,186,85,101,53.72,0.5372,0.434,0.353
"9879","190044",2005,630,173,457,380,274,106,61.27,0.6127,0.603,0.6
"9880","190099",2005,729,368,361,640,311,329,89.4,0.894,0.878,0.861
"9881","190150",2005,1403,660,743,1189,621,568,86.06,0.8606,0.847,0.836
"9882","190248",2005,140,83,57,49,12,37,44.58,0.4458,0.35,0.211
"9883","190415",2005,3071,1541,1530,2664,1286,1378,89.42,0.8942,0.867,0.841
"9884","190512",2005,1625,784,841,577,266,311,39.67,0.3967,0.355,0.316
"9885","190549",2005,1372,757,615,294,109,185,24.44,0.2444,0.214,0.177
"9886","190558",2005,1888,1048,840,62,31,31,2.96,0.0296,0.033,0.037
"9887","190567",2005,1278,592,686,78,39,39,6.59,0.0659,0.061,0.057
"9888","190594",2005,1776,1199,577,356,97,259,21.6,0.216,0.2,0.168
"9889","190637",2005,788,551,237,110,33,77,13.97,0.1397,0.14,0.139
"9890","190664",2005,1470,884,586,381,101,280,31.67,0.3167,0.259,0.172
"9891","190691",2005,746,481,265,27,5,22,4.57,0.0457,0.036,0.019
"9892","190725",2005,366,288,78,91,12,79,27.43,0.2743,0.249,0.154
"9893","191241",2005,1734,983,751,1282,548,734,74.67,0.7467,0.739,0.73
"9894","191515",2005,496,248,248,417,198,219,88.31,0.8831,0.841,0.798
"9895","191533",2005,405,212,193,182,77,105,49.53,0.4953,0.449,0.399
"9896","191630",2005,545,283,262,377,159,218,77.03,0.7703,0.692,0.607
"9897","191649",2005,1759,961,798,763,281,482,50.16,0.5016,0.434,0.352
"9898","191676",2005,321,211,110,180,57,123,58.29,0.5829,0.561,0.518
"9899","191931",2005,776,419,357,375,150,225,53.7,0.537,0.483,0.42
"9900","191968",2005,1679,885,794,1117,521,596,67.34,0.6734,0.665,0.656
"9901","192192",2005,268,179,89,111,31,80,44.69,0.4469,0.414,0.348
"9902","192323",2005,519,308,211,320,123,197,63.96,0.6396,0.617,0.583
"9903","192439",2005,959,643,316,51,10,41,6.38,0.0638,0.053,0.032
"9904","192703",2005,700,368,332,456,198,258,70.11,0.7011,0.651,0.596
"9905","192749",2005,506,327,179,264,73,191,58.41,0.5841,0.522,0.408
"9906","192819",2005,1017,585,432,697,258,439,75.04,0.7504,0.685,0.597
"9907","192925",2005,203,126,77,62,27,35,27.78,0.2778,0.305,0.351
"9908","193016",2005,485,324,161,53,11,42,12.96,0.1296,0.109,0.068
"9909","193292",2005,274,190,84,109,31,78,41.05,0.4105,0.398,0.369
"9910","193353",2005,356,247,109,154,45,109,44.13,0.4413,0.433,0.413
"9911","193399",2005,343,247,96,136,32,104,42.11,0.4211,0.397,0.333
"9912","193584",2005,451,342,109,303,56,247,72.22,0.7222,0.672,0.514
"9913","193645",2005,943,883,60,168,1,167,18.91,0.1891,0.178,0.017
"9914","193654",2005,789,558,231,355,86,269,48.21,0.4821,0.45,0.372
"9915","193900",2005,4639,2853,1786,2941,1168,1773,62.15,0.6215,0.634,0.654
"9916","193973",2005,730,444,286,435,160,275,61.94,0.6194,0.596,0.559
"9917","194161",2005,256,137,119,60,21,39,28.47,0.2847,0.234,0.176
"9918","194310",2005,1474,954,520,584,186,398,41.72,0.4172,0.396,0.358
"9919","194824",2005,1236,283,953,745,550,195,68.9,0.689,0.603,0.577
"9920","195003",2005,2184,656,1528,587,289,298,45.43,0.4543,0.269,0.189
"9921","195030",2005,1106,563,543,808,376,432,76.73,0.7673,0.731,0.692
"9922","195164",2005,477,225,252,239,112,127,56.44,0.5644,0.501,0.444
"9923","195173",2005,497,224,273,140,68,72,32.14,0.3214,0.282,0.249
"9924","195216",2005,534,268,266,407,190,217,80.97,0.8097,0.762,0.714
"9925","195234",2005,595,411,184,330,75,255,62.04,0.6204,0.555,0.408
"9926","195243",2005,327,188,139,119,43,76,40.43,0.4043,0.364,0.309
"9927","195304",2005,376,285,91,237,50,187,65.61,0.6561,0.63,0.549
"9928","195474",2005,763,443,320,531,225,306,69.07,0.6907,0.696,0.703
"9929","195526",2005,694,433,261,567,202,365,84.3,0.843,0.817,0.774
"9930","195544",2005,605,446,159,291,57,234,52.47,0.5247,0.481,0.358
"9931","195809",2005,3153,1742,1411,1098,435,663,38.06,0.3806,0.348,0.308
"9932","196413",2005,3243,1849,1394,2261,903,1358,73.45,0.7345,0.697,0.648
"9933","196592",2005,1839,1261,578,40,13,27,2.14,0.0214,0.022,0.022
"9934","197045",2005,468,264,204,139,52,87,32.95,0.3295,0.297,0.255
"9935","197133",2005,647,374,273,572,238,334,89.3,0.893,0.884,0.872
"9936","197869",2005,2536,1265,1271,974,391,583,46.09,0.4609,0.384,0.308
"9937","197984",2005,224,109,115,75,23,52,47.71,0.4771,0.335,0.2
"9938","198385",2005,459,234,225,400,182,218,93.16,0.9316,0.871,0.809
"9939","198464",2005,3220,1973,1247,1048,345,703,35.63,0.3563,0.325,0.277
"9940","198507",2005,556,328,228,99,28,71,21.65,0.2165,0.178,0.123
"9941","198516",2005,1237,748,489,959,370,589,78.74,0.7874,0.775,0.757
"9942","198835",2005,326,203,123,122,37,85,41.87,0.4187,0.374,0.301
"9943","198969",2005,387,143,244,59,22,37,25.87,0.2587,0.152,0.09
"9944","199102",2005,2237,1178,1059,369,116,253,21.48,0.2148,0.165,0.11
"9945","199111",2005,471,291,180,154,51,103,35.4,0.354,0.327,0.283
"9946","199120",2005,3747,2270,1477,2819,1050,1769,77.93,0.7793,0.752,0.711
"9947","199139",2005,2859,1498,1361,741,273,468,31.24,0.3124,0.259,0.201
"9948","199148",2005,2399,1690,709,670,125,545,32.25,0.3225,0.279,0.176
"9949","199157",2005,1195,800,395,181,45,136,17,0.17,0.151,0.114
"9950","199193",2005,4364,1918,2446,1732,716,1016,52.97,0.5297,0.397,0.293
"9951","199218",2005,1933,1133,800,842,302,540,47.66,0.4766,0.436,0.378
"9952","199281",2005,961,528,433,142,50,92,17.42,0.1742,0.148,0.115
"9953","199306",2005,198,90,108,74,28,46,51.11,0.5111,0.374,0.259
"9954","199412",2005,238,171,67,116,30,86,50.29,0.5029,0.487,0.448
"9955","199582",2005,261,129,132,34,16,18,13.95,0.1395,0.13,0.121
"9956","199643",2005,573,307,266,75,29,46,14.98,0.1498,0.131,0.109
"9957","199847",2005,1114,565,549,918,431,487,86.19,0.8619,0.824,0.785
"9958","199962",2005,371,183,188,154,54,100,54.64,0.5464,0.415,0.287
"9959","199999",2005,1050,701,349,167,42,125,17.83,0.1783,0.159,0.12
"9960","200004",2005,1549,775,774,453,181,272,35.1,0.351,0.292,0.234
"9961","200059",2005,317,162,155,29,11,18,11.11,0.1111,0.091,0.071
"9962","200156",2005,270,139,131,67,24,43,30.94,0.3094,0.248,0.183
"9963","200217",2005,392,220,172,103,28,75,34.09,0.3409,0.263,0.163
"9964","200226",2005,144,63,81,28,10,18,28.57,0.2857,0.194,0.123
"9965","200253",2005,431,240,191,64,19,45,18.75,0.1875,0.148,0.099
"9966","200280",2005,1851,858,993,425,198,227,26.46,0.2646,0.23,0.199
"9967","200332",2005,1970,940,1030,457,191,266,28.3,0.283,0.232,0.185
"9968","200572",2005,171,73,98,40,16,24,32.88,0.3288,0.234,0.163
"9969","201104",2005,573,357,216,271,86,185,51.82,0.5182,0.473,0.398
"9970","201371",2005,228,141,87,123,45,78,55.32,0.5532,0.539,0.517
"9971","201548",2005,599,363,236,310,109,201,55.37,0.5537,0.518,0.462
"9972","201645",2005,1162,456,706,702,386,316,69.3,0.693,0.604,0.547
"9973","201690",2005,343,156,187,31,15,16,10.26,0.1026,0.09,0.08
"9974","202134",2005,955,507,448,87,31,56,11.05,0.1105,0.091,0.069
"9975","202480",2005,1970,1004,966,1149,475,674,67.13,0.6713,0.583,0.492
"9976","202523",2005,620,337,283,473,211,262,77.74,0.7774,0.763,0.746
"9977","202763",2005,584,399,185,240,64,176,44.11,0.4411,0.411,0.346
"9978","203085",2005,324,135,189,174,85,89,65.93,0.6593,0.537,0.45
"9979","203128",2005,208,101,107,125,57,68,67.33,0.6733,0.601,0.533
"9980","203368",2005,786,401,385,504,217,287,71.57,0.7157,0.641,0.564
"9981","203517",2005,3727,2325,1402,970,294,676,29.08,0.2908,0.26,0.21
"9982","203535",2005,439,239,200,364,165,199,83.26,0.8326,0.829,0.825
"9983","203580",2005,116,88,28,49,8,41,46.59,0.4659,0.422,0.286
"9984","203775",2005,357,199,158,165,61,104,52.26,0.5226,0.462,0.386
"9985","203845",2005,387,179,208,162,68,94,52.51,0.5251,0.419,0.327
"9986","204024",2005,3150,1708,1442,2198,902,1296,75.88,0.7588,0.698,0.626
"9987","204185",2005,503,260,243,274,104,170,65.38,0.6538,0.545,0.428
"9988","204194",2005,380,241,139,149,49,100,41.49,0.4149,0.392,0.353
"9989","204617",2005,372,172,200,129,65,64,37.21,0.3721,0.347,0.325
"9990","204796",2005,5929,3005,2924,3032,1219,1813,60.33,0.6033,0.511,0.417
"9991","204857",2005,4078,2148,1930,1788,697,1091,50.79,0.5079,0.438,0.361
"9992","206330",2005,240,74,166,51,27,24,32.43,0.3243,0.212,0.163
"9993","206589",2005,536,267,269,362,158,204,76.4,0.764,0.675,0.587
"9994","206604",2005,2302,1331,971,413,141,272,20.44,0.2044,0.179,0.145
"9995","206622",2005,765,430,335,523,206,317,73.72,0.7372,0.684,0.615
"9996","206695",2005,2012,1029,983,177,61,116,11.27,0.1127,0.088,0.062
"9997","206914",2005,714,430,284,37,22,15,3.49,0.0349,0.052,0.077
"9998","207209",2005,670,316,354,31,3,28,8.86,0.0886,0.046,0.008
"9999","207306",2005,279,150,129,37,10,27,18,0.18,0.133,0.078
"10000","207324",2005,523,270,253,144,57,87,32.22,0.3222,0.275,0.225
"10001","207388",2005,3221,1662,1559,1106,436,670,40.31,0.4031,0.343,0.28
"10002","207500",2005,3189,1695,1494,1107,418,689,40.65,0.4065,0.347,0.28
"10003","207722",2005,233,122,111,61,30,31,25.41,0.2541,0.262,0.27
"10004","207847",2005,587,298,289,62,22,40,13.42,0.1342,0.106,0.076
"10005","207865",2005,766,403,363,127,43,84,20.84,0.2084,0.166,0.118
"10006","208822",2005,460,287,173,241,86,155,54.01,0.5401,0.524,0.497
"10007","209056",2005,490,294,196,324,125,199,67.69,0.6769,0.661,0.638
"10008","209065",2005,481,260,221,293,113,180,69.23,0.6923,0.609,0.511
"10009","209542",2005,2817,1385,1432,819,306,513,37.04,0.3704,0.291,0.214
"10010","209551",2005,3138,1721,1417,1282,506,776,45.09,0.4509,0.409,0.357
"10011","209612",2005,324,204,120,165,52,113,55.39,0.5539,0.509,0.433
"10012","209807",2005,1200,636,564,172,66,106,16.67,0.1667,0.143,0.117
"10013","209922",2005,348,197,151,204,80,124,62.94,0.6294,0.586,0.53
"10014","210146",2005,707,417,290,110,30,80,19.18,0.1918,0.156,0.103
"10015","210401",2005,440,240,200,307,130,177,73.75,0.7375,0.698,0.65
"10016","210429",2005,849,511,338,132,36,96,18.79,0.1879,0.155,0.107
"10017","210571",2005,450,254,196,234,85,149,58.66,0.5866,0.52,0.434
"10018","210669",2005,561,311,250,424,181,243,78.14,0.7814,0.756,0.724
"10019","210775",2005,262,149,113,100,35,65,43.62,0.4362,0.382,0.31
"10020","211088",2005,432,315,117,232,59,173,54.92,0.5492,0.537,0.504
"10021","211158",2005,1690,1050,640,693,207,486,46.29,0.4629,0.41,0.323
"10022","211291",2005,920,504,416,804,352,452,89.68,0.8968,0.874,0.846
"10023","211352",2005,526,385,141,257,60,197,51.17,0.5117,0.489,0.426
"10024","211361",2005,1247,640,607,298,119,179,27.97,0.2797,0.239,0.196
"10025","211431",2005,273,264,9,102,3,99,37.5,0.375,0.374,0.333
"10026","211440",2005,1408,533,875,1000,611,389,72.98,0.7298,0.71,0.698
"10027","211468",2005,203,202,1,82,1,81,40.1,0.401,0.404,1
"10028","211556",2005,116,116,0,57,0,57,49.14,0.4914,0.491,NA
"10029","211583",2005,219,150,69,73,23,50,33.33,0.3333,0.333,0.333
"10030","211608",2005,397,219,178,51,21,30,13.7,0.137,0.128,0.118
"10031","211644",2005,1173,731,442,288,92,196,26.81,0.2681,0.246,0.208
"10032","211981",2005,448,271,177,206,54,152,56.09,0.5609,0.46,0.305
"10033","212009",2005,647,359,288,530,227,303,84.4,0.844,0.819,0.788
"10034","212054",2005,2346,916,1430,663,274,389,42.47,0.4247,0.283,0.192
"10035","212106",2005,1325,811,514,711,244,467,57.58,0.5758,0.537,0.475
"10036","212115",2005,1087,634,453,392,110,282,44.48,0.4448,0.361,0.243
"10037","212133",2005,445,300,145,239,70,169,56.33,0.5633,0.537,0.483
"10038","212160",2005,1268,719,549,297,82,215,29.9,0.299,0.234,0.149
"10039","212197",2005,500,337,163,356,104,252,74.78,0.7478,0.712,0.638
"10040","212577",2005,581,298,283,468,211,257,86.24,0.8624,0.806,0.746
"10041","212601",2005,619,375,244,292,104,188,50.13,0.5013,0.472,0.426
"10042","212832",2005,280,210,70,21,15,6,2.86,0.0286,0.075,0.214
"10043","212911",2005,316,168,148,287,131,156,92.86,0.9286,0.908,0.885
"10044","213020",2005,2462,1335,1127,713,245,468,35.06,0.3506,0.29,0.217
"10045","213251",2005,387,212,175,279,120,159,75,0.75,0.721,0.686
"10046","213321",2005,479,198,281,282,149,133,67.17,0.6717,0.589,0.53
"10047","213349",2005,1905,1105,800,621,190,431,39,0.39,0.326,0.238
"10048","213358",2005,302,203,99,103,32,71,34.98,0.3498,0.341,0.323
"10049","213367",2005,803,440,363,400,160,240,54.55,0.5455,0.498,0.441
"10050","213385",2005,596,275,321,508,268,240,87.27,0.8727,0.852,0.835
"10051","213507",2005,454,223,231,304,138,166,74.44,0.7444,0.67,0.597
"10052","213543",2005,1223,512,711,956,521,435,84.96,0.8496,0.782,0.733
"10053","213613",2005,1215,695,520,314,110,204,29.35,0.2935,0.258,0.212
"10054","213668",2005,357,219,138,216,74,142,64.84,0.6484,0.605,0.536
"10055","213783",2005,662,406,256,216,62,154,37.93,0.3793,0.326,0.242
"10056","213826",2005,301,230,71,153,30,123,53.48,0.5348,0.508,0.423
"10057","213996",2005,707,439,268,500,177,323,73.58,0.7358,0.707,0.66
"10058","214041",2005,1306,774,532,501,172,329,42.51,0.4251,0.384,0.323
"10059","214069",2005,324,222,102,181,52,129,58.11,0.5811,0.559,0.51
"10060","214157",2005,382,204,178,280,123,157,76.96,0.7696,0.733,0.691
"10061","214175",2005,576,322,254,454,180,274,85.09,0.8509,0.788,0.709
"10062","214272",2005,522,334,188,163,46,117,35.03,0.3503,0.312,0.245
"10063","214777",2005,6499,2976,3523,4096,1969,2127,71.47,0.7147,0.63,0.559
"10064","215062",2005,2479,1260,1219,2162,1033,1129,89.6,0.896,0.872,0.847
"10065","215743",2005,364,220,144,190,59,131,59.55,0.5955,0.522,0.41
"10066","215798",2005,481,254,227,308,141,167,65.75,0.6575,0.64,0.621
"10067","215929",2005,943,551,392,629,248,381,69.15,0.6915,0.667,0.633
"10068","216010",2005,1495,775,720,622,233,389,50.19,0.5019,0.416,0.324
"10069","216038",2005,1457,800,657,556,216,340,42.5,0.425,0.382,0.329
"10070","216287",2005,389,198,191,355,171,184,92.93,0.9293,0.913,0.895
"10071","216339",2005,3841,2175,1666,1247,483,764,35.13,0.3513,0.325,0.29
"10072","216524",2005,411,222,189,309,136,173,77.93,0.7793,0.752,0.72
"10073","216694",2005,340,208,132,171,58,113,54.33,0.5433,0.503,0.439
"10074","216764",2005,1898,1219,679,812,216,596,48.89,0.4889,0.428,0.318
"10075","216807",2005,360,231,129,223,75,148,64.07,0.6407,0.619,0.581
"10076","216852",2005,646,332,314,258,98,160,48.19,0.4819,0.399,0.312
"10077","216931",2005,562,297,265,270,114,156,52.53,0.5253,0.48,0.43
"10078","217059",2005,1078,591,487,442,175,267,45.18,0.4518,0.41,0.359
"10079","217156",2005,1439,735,704,1197,577,620,84.35,0.8435,0.832,0.82
"10080","217402",2005,1064,593,471,857,367,490,82.63,0.8263,0.805,0.779
"10081","217536",2005,562,418,144,382,82,300,71.77,0.7177,0.68,0.569
"10082","217776",2005,176,110,66,46,18,28,25.45,0.2545,0.261,0.273
"10083","217819",2005,1984,1342,642,1031,291,740,55.14,0.5514,0.52,0.453
"10084","217882",2005,2893,1426,1467,1565,611,954,66.9,0.669,0.541,0.416
"10085","217998",2005,181,90,91,82,33,49,54.44,0.5444,0.453,0.363
"10086","218061",2005,797,517,280,158,40,118,22.82,0.2282,0.198,0.143
"10087","218229",2005,555,369,186,110,34,76,20.6,0.206,0.198,0.183
"10088","218238",2005,201,99,102,40,10,30,30.3,0.303,0.199,0.098
"10089","218399",2005,207,130,77,30,9,21,16.15,0.1615,0.145,0.117
"10090","218414",2005,275,96,179,67,34,33,34.38,0.3438,0.244,0.19
"10091","218663",2005,3677,2087,1590,1881,682,1199,57.45,0.5745,0.512,0.429
"10092","218724",2005,1493,775,718,375,130,245,31.61,0.3161,0.251,0.181
"10093","218733",2005,1002,544,458,140,50,90,16.54,0.1654,0.14,0.109
"10094","218742",2005,718,469,249,153,41,112,23.88,0.2388,0.213,0.165
"10095","218973",2005,320,144,176,241,123,118,81.94,0.8194,0.753,0.699
"10096","219000",2005,390,256,134,192,54,138,53.91,0.5391,0.492,0.403
"10097","219046",2005,584,353,231,74,22,52,14.73,0.1473,0.127,0.095
"10098","219082",2005,280,135,145,29,14,15,11.11,0.1111,0.104,0.097
"10099","219198",2005,139,91,48,54,15,39,42.86,0.4286,0.388,0.312
"10100","219259",2005,368,197,171,47,13,34,17.26,0.1726,0.128,0.076
"10101","219356",2005,1784,893,891,528,213,315,35.27,0.3527,0.296,0.239
"10102","219471",2005,1030,621,409,236,74,162,26.09,0.2609,0.229,0.181
"10103","219602",2005,1226,708,518,175,70,105,14.83,0.1483,0.143,0.135
"10104","219709",2005,791,488,303,483,180,303,62.09,0.6209,0.611,0.594
"10105","219718",2005,234,108,126,29,9,20,18.52,0.1852,0.124,0.071
"10106","219949",2005,217,107,110,44,17,27,25.23,0.2523,0.203,0.155
"10107","220075",2005,1565,897,668,308,102,206,22.97,0.2297,0.197,0.153
"10108","220215",2005,373,203,170,139,61,78,38.42,0.3842,0.373,0.359
"10109","220613",2005,755,454,301,297,99,198,43.61,0.4361,0.393,0.329
"10110","220631",2005,139,90,49,25,6,19,21.11,0.2111,0.18,0.122
"10111","220710",2005,333,163,170,158,67,91,55.83,0.5583,0.474,0.394
"10112","221351",2005,440,255,185,313,131,182,71.37,0.7137,0.711,0.708
"10113","221519",2005,420,241,179,337,144,193,80.08,0.8008,0.802,0.804
"10114","221731",2005,167,100,67,52,14,38,38,0.38,0.311,0.209
"10115","221847",2005,1409,623,786,321,121,200,32.1,0.321,0.228,0.154
"10116","221892",2005,239,124,115,95,40,55,44.35,0.4435,0.397,0.348
"10117","222178",2005,1030,560,470,393,150,243,43.39,0.4339,0.382,0.319
"10118","222983",2005,347,171,176,239,103,136,79.53,0.7953,0.689,0.585
"10119","223232",2005,3158,1867,1291,1641,582,1059,56.72,0.5672,0.52,0.451
"10120","224004",2005,196,96,100,40,12,28,29.17,0.2917,0.204,0.12
"10121","224323",2005,256,165,91,160,53,107,64.85,0.6485,0.625,0.582
"10122","225432",2005,889,487,402,20,8,12,2.46,0.0246,0.022,0.02
"10123","225548",2005,281,146,135,104,41,63,43.15,0.4315,0.37,0.304
"10124","225627",2005,571,394,177,114,23,91,23.1,0.231,0.2,0.13
"10125","226231",2005,317,74,243,95,66,29,39.19,0.3919,0.3,0.272
"10126","226833",2005,818,447,371,100,27,73,16.33,0.1633,0.122,0.073
"10127","227216",2005,3557,2008,1549,760,214,546,27.19,0.2719,0.214,0.138
"10128","227331",2005,269,204,65,1,1,0,0,0,0.004,0.015
"10129","227526",2005,1155,668,487,126,39,87,13.02,0.1302,0.109,0.08
"10130","227757",2005,722,337,385,571,279,292,86.65,0.8665,0.791,0.725
"10131","227845",2005,646,401,245,333,109,224,55.86,0.5586,0.515,0.445
"10132","227863",2005,289,185,104,75,27,48,25.95,0.2595,0.26,0.26
"10133","228042",2005,167,92,75,50,19,31,33.7,0.337,0.299,0.253
"10134","228149",2005,494,314,180,147,38,109,34.71,0.3471,0.298,0.211
"10135","228246",2005,1401,754,647,846,345,501,66.45,0.6645,0.604,0.533
"10136","228343",2005,327,192,135,223,87,136,70.83,0.7083,0.682,0.644
"10137","228431",2005,1967,1199,768,441,125,316,26.36,0.2636,0.224,0.163
"10138","228459",2005,3053,1786,1267,825,235,590,33.03,0.3303,0.27,0.185
"10139","228501",2005,329,127,202,31,19,12,9.45,0.0945,0.094,0.094
"10140","228529",2005,1188,678,510,212,65,147,21.68,0.2168,0.178,0.127
"10141","228705",2005,606,244,362,83,40,43,17.62,0.1762,0.137,0.11
"10142","228723",2005,6713,3406,3307,3352,1259,2093,61.45,0.6145,0.499,0.381
"10143","228769",2005,2075,1069,1006,347,130,217,20.3,0.203,0.167,0.129
"10144","228778",2005,6783,3630,3153,3572,1419,2153,59.31,0.5931,0.527,0.45
"10145","228787",2005,1058,403,655,433,235,198,49.13,0.4913,0.409,0.359
"10146","228796",2005,2154,1085,1069,210,74,136,12.53,0.1253,0.097,0.069
"10147","228875",2005,1610,977,633,875,284,591,60.49,0.6049,0.543,0.449
"10148","228981",2005,379,182,197,106,35,71,39.01,0.3901,0.28,0.178
"10149","229018",2005,300,173,127,53,18,35,20.23,0.2023,0.177,0.142
"10150","229027",2005,4360,2240,2120,348,127,221,9.87,0.0987,0.08,0.06
"10151","229115",2005,3743,1829,1914,1323,530,793,43.36,0.4336,0.353,0.277
"10152","229780",2005,222,124,98,44,11,33,26.61,0.2661,0.198,0.112
"10153","229814",2005,768,409,359,171,66,105,25.67,0.2567,0.223,0.184
"10154","230603",2005,784,527,257,137,30,107,20.3,0.203,0.175,0.117
"10155","230728",2005,1618,1065,553,415,75,340,31.92,0.3192,0.256,0.136
"10156","230764",2005,1997,1106,891,415,138,277,25.05,0.2505,0.208,0.155
"10157","230782",2005,1626,879,747,68,23,45,5.12,0.0512,0.042,0.031
"10158","231059",2005,592,331,261,454,188,266,80.36,0.8036,0.767,0.72
"10159","231174",2005,2378,1287,1091,1367,568,799,62.08,0.6208,0.575,0.521
"10160","231420",2005,229,84,145,59,33,26,30.95,0.3095,0.258,0.228
"10161","231554",2005,103,57,46,32,15,17,29.82,0.2982,0.311,0.326
"10162","231624",2005,1339,714,625,1134,489,645,90.34,0.9034,0.847,0.782
"10163","231712",2005,1245,667,578,578,203,375,56.22,0.5622,0.464,0.351
"10164","232025",2005,338,155,183,177,80,97,62.58,0.6258,0.524,0.437
"10165","232043",2005,202,123,79,116,40,76,61.79,0.6179,0.574,0.506
"10166","232089",2005,330,110,220,53,18,35,31.82,0.3182,0.161,0.082
"10167","232186",2005,2454,1339,1115,999,348,651,48.62,0.4862,0.407,0.312
"10168","232265",2005,1099,701,398,445,114,331,47.22,0.4722,0.405,0.286
"10169","232423",2005,3796,2421,1375,2465,803,1662,68.65,0.6865,0.649,0.584
"10170","232557",2005,1915,982,933,488,204,284,28.92,0.2892,0.255,0.219
"10171","232566",2005,938,632,306,379,88,291,46.04,0.4604,0.404,0.288
"10172","232609",2005,553,321,232,246,84,162,50.47,0.5047,0.445,0.362
"10173","232681",2005,877,581,296,552,159,393,67.64,0.6764,0.629,0.537
"10174","232706",2005,422,310,112,152,34,118,38.06,0.3806,0.36,0.304
"10175","232937",2005,957,551,406,138,39,99,17.97,0.1797,0.144,0.096
"10176","232982",2005,2054,1160,894,474,145,329,28.36,0.2836,0.231,0.162
"10177","233277",2005,1890,1101,789,725,254,471,42.78,0.4278,0.384,0.322
"10178","233374",2005,775,401,374,593,268,325,81.05,0.8105,0.765,0.717
"10179","233426",2005,534,310,224,316,120,196,63.23,0.6323,0.592,0.536
"10180","233541",2005,369,211,158,123,44,79,37.44,0.3744,0.333,0.278
"10181","233897",2005,366,186,180,94,27,67,36.02,0.3602,0.257,0.15
"10182","233921",2005,5026,2190,2836,2797,1296,1501,68.54,0.6854,0.557,0.457
"10183","234030",2005,3432,2052,1380,904,306,598,29.14,0.2914,0.263,0.222
"10184","234085",2005,363,40,323,209,187,22,55,0.55,0.576,0.579
"10185","234155",2005,1176,775,401,234,48,186,24,0.24,0.199,0.12
"10186","234164",2005,356,197,159,57,14,43,21.83,0.2183,0.16,0.088
"10187","235097",2005,1610,992,618,340,120,220,22.18,0.2218,0.211,0.194
"10188","235167",2005,590,296,294,243,114,129,43.58,0.4358,0.412,0.388
"10189","236230",2005,687,432,255,340,106,234,54.17,0.5417,0.495,0.416
"10190","236328",2005,669,385,284,446,180,266,69.09,0.6909,0.667,0.634
"10191","236577",2005,710,490,220,425,123,302,61.63,0.6163,0.599,0.559
"10192","236595",2005,739,454,285,422,156,266,58.59,0.5859,0.571,0.547
"10193","236896",2005,292,132,160,62,34,28,21.21,0.2121,0.212,0.212
"10194","236939",2005,2855,1418,1437,1072,413,659,46.47,0.4647,0.375,0.287
"10195","236948",2005,4892,2622,2270,2883,1209,1674,63.84,0.6384,0.589,0.533
"10196","237011",2005,2365,1364,1001,943,302,641,46.99,0.4699,0.399,0.302
"10197","237057",2005,360,180,180,288,140,148,82.22,0.8222,0.8,0.778
"10198","237066",2005,451,266,185,304,125,179,67.29,0.6729,0.674,0.676
"10199","237215",2005,246,133,113,5,3,2,1.5,0.015,0.02,0.027
"10200","237330",2005,639,352,287,104,35,69,19.6,0.196,0.163,0.122
"10201","237358",2005,109,67,42,25,5,20,29.85,0.2985,0.229,0.119
"10202","237367",2005,653,367,286,97,35,62,16.89,0.1689,0.149,0.122
"10203","237792",2005,657,352,305,134,52,82,23.3,0.233,0.204,0.17
"10204","237899",2005,306,152,154,21,11,10,6.58,0.0658,0.069,0.071
"10205","237932",2005,416,234,182,94,25,69,29.49,0.2949,0.226,0.137
"10206","237969",2005,307,161,146,129,38,91,56.52,0.5652,0.42,0.26
"10207","238032",2005,4524,2126,2398,1457,639,818,38.48,0.3848,0.322,0.266
"10208","238333",2005,326,198,128,216,71,145,73.23,0.7323,0.663,0.555
"10209","238430",2005,182,139,43,19,4,15,10.79,0.1079,0.104,0.093
"10210","238458",2005,598,383,215,231,63,168,43.86,0.4386,0.386,0.293
"10211","238476",2005,593,315,278,281,120,161,51.11,0.5111,0.474,0.432
"10212","238616",2005,386,207,179,134,52,82,39.61,0.3961,0.347,0.291
"10213","238661",2005,281,210,71,77,21,56,26.67,0.2667,0.274,0.296
"10214","239080",2005,262,190,72,78,17,61,32.11,0.3211,0.298,0.236
"10215","239105",2005,1775,967,808,1083,448,635,65.67,0.6567,0.61,0.554
"10216","239628",2005,261,119,142,148,70,78,65.55,0.6555,0.567,0.493
"10217","239716",2005,504,282,222,328,147,181,64.18,0.6418,0.651,0.662
"10218","240107",2005,289,207,82,82,11,71,34.3,0.343,0.284,0.134
"10219","240189",2005,1701,823,878,437,196,241,29.28,0.2928,0.257,0.223
"10220","240277",2005,904,587,317,198,45,153,26.06,0.2606,0.219,0.142
"10221","240329",2005,1755,1056,699,579,176,403,38.16,0.3816,0.33,0.252
"10222","240338",2005,180,110,70,81,33,48,43.64,0.4364,0.45,0.471
"10223","240365",2005,1617,982,635,234,81,153,15.58,0.1558,0.145,0.128
"10224","240374",2005,783,442,341,61,27,34,7.69,0.0769,0.078,0.079
"10225","240417",2005,1699,863,836,322,103,219,25.38,0.2538,0.19,0.123
"10226","240426",2005,336,208,128,61,11,50,24.04,0.2404,0.182,0.086
"10227","240444",2005,6118,3434,2684,3174,1255,1919,55.88,0.5588,0.519,0.468
"10228","240453",2005,4218,2233,1985,604,258,346,15.49,0.1549,0.143,0.13
"10229","240462",2005,1218,426,792,187,83,104,24.41,0.2441,0.154,0.105
"10230","240471",2005,1192,734,458,268,80,188,25.61,0.2561,0.225,0.175
"10231","240480",2005,1521,832,689,365,136,229,27.52,0.2752,0.24,0.197
"10232","240727",2005,1399,739,660,320,107,213,28.82,0.2882,0.229,0.162
"10233","243443",2005,796,500,296,66,8,58,11.6,0.116,0.083,0.027
"10234","243780",2005,7167,2860,4307,2547,1189,1358,47.48,0.4748,0.355,0.276
"10235","100654",2006,1133,584,549,110,29,81,13.87,0.1387,0.097,0.053
"10236","100663",2006,1485,895,590,378,124,254,28.38,0.2838,0.255,0.21
"10237","100751",2006,4275,2377,1898,1757,660,1097,46.15,0.4615,0.411,0.348
"10238","100858",2006,4072,2168,1904,1556,549,1007,46.45,0.4645,0.382,0.288
"10239","101435",2006,214,85,129,72,36,36,42.35,0.4235,0.336,0.279
"10240","101480",2006,1106,626,480,106,23,83,13.26,0.1326,0.096,0.048
"10241","101675",2006,352,159,193,15,3,12,7.55,0.0755,0.043,0.016
"10242","101879",2006,1019,575,444,112,26,86,14.96,0.1496,0.11,0.059
"10243","102049",2006,644,392,252,326,99,227,57.91,0.5791,0.506,0.393
"10244","102094",2006,1355,777,578,190,55,135,17.37,0.1737,0.14,0.095
"10245","102234",2006,345,226,119,189,62,127,56.19,0.5619,0.548,0.521
"10246","102368",2006,1666,964,702,238,77,161,16.7,0.167,0.143,0.11
"10247","102377",2006,688,395,293,151,33,118,29.87,0.2987,0.219,0.113
"10248","104151",2006,8533,4556,3977,2837,1145,1692,37.14,0.3714,0.332,0.288
"10249","104179",2006,5788,3092,2696,2085,813,1272,41.14,0.4114,0.36,0.302
"10250","105330",2006,2527,1488,1039,756,224,532,35.75,0.3575,0.299,0.216
"10251","106245",2006,603,317,286,40,19,21,6.62,0.0662,0.066,0.066
"10252","106342",2006,128,61,67,56,27,29,47.54,0.4754,0.438,0.403
"10253","106397",2006,2719,1346,1373,945,398,547,40.64,0.4064,0.348,0.29
"10254","106412",2006,688,340,348,55,18,37,10.88,0.1088,0.08,0.052
"10255","106458",2006,1659,946,713,345,124,221,23.36,0.2336,0.208,0.174
"10256","106467",2006,1426,711,715,234,83,151,21.24,0.2124,0.164,0.116
"10257","106485",2006,630,335,295,71,28,43,12.84,0.1284,0.113,0.095
"10258","106704",2006,2352,1340,1012,538,187,351,26.19,0.2619,0.229,0.185
"10259","107044",2006,901,477,424,365,134,231,48.43,0.4843,0.405,0.316
"10260","107080",2006,396,222,174,251,99,152,68.47,0.6847,0.634,0.569
"10261","107141",2006,326,168,158,190,78,112,66.67,0.6667,0.583,0.494
"10262","107512",2006,367,190,177,185,73,112,58.95,0.5895,0.504,0.412
"10263","107558",2006,164,80,84,59,29,30,37.5,0.375,0.36,0.345
"10264","110097",2006,799,521,278,364,102,262,50.29,0.5029,0.456,0.367
"10265","110404",2006,210,60,150,166,113,53,88.33,0.8833,0.79,0.753
"10266","110422",2006,3761,1648,2113,1044,362,682,41.38,0.4138,0.278,0.171
"10267","110486",2006,854,553,301,120,29,91,16.46,0.1646,0.141,0.096
"10268","110495",2006,846,570,276,148,37,111,19.47,0.1947,0.175,0.134
"10269","110510",2006,1774,1157,617,201,55,146,12.62,0.1262,0.113,0.089
"10270","110529",2006,3138,1357,1781,341,128,213,15.7,0.157,0.109,0.072
"10271","110538",2006,2430,1326,1104,420,103,317,23.91,0.2391,0.173,0.093
"10272","110547",2006,984,716,268,41,8,33,4.61,0.0461,0.042,0.03
"10273","110556",2006,2528,1501,1027,344,108,236,15.72,0.1572,0.136,0.105
"10274","110565",2006,3736,2262,1474,500,122,378,16.71,0.1671,0.134,0.083
"10275","110574",2006,881,506,375,131,48,83,16.4,0.164,0.149,0.128
"10276","110583",2006,4334,2757,1577,550,175,375,13.6,0.136,0.127,0.111
"10277","110592",2006,1542,961,581,113,36,77,8.01,0.0801,0.073,0.062
"10278","110617",2006,2590,1570,1020,263,79,184,11.72,0.1172,0.102,0.077
"10279","113698",2006,263,193,70,100,18,82,42.49,0.4249,0.38,0.257
"10280","115755",2006,966,550,416,132,46,86,15.64,0.1564,0.137,0.111
"10281","119173",2006,345,336,9,76,1,75,22.32,0.2232,0.22,0.111
"10282","120184",2006,134,93,41,51,15,36,38.71,0.3871,0.381,0.366
"10283","121309",2006,537,342,195,352,118,234,68.42,0.6842,0.655,0.605
"10284","121345",2006,378,190,188,337,162,175,92.11,0.9211,0.892,0.862
"10285","122409",2006,4109,2458,1651,1309,382,927,37.71,0.3771,0.319,0.231
"10286","122436",2006,1103,703,400,714,214,500,71.12,0.7112,0.647,0.535
"10287","122597",2006,3117,2017,1100,418,128,290,14.38,0.1438,0.134,0.116
"10288","122612",2006,1073,733,340,582,166,416,56.75,0.5675,0.542,0.488
"10289","122931",2006,1340,740,600,1055,448,607,82.03,0.8203,0.787,0.747
"10290","123554",2006,600,384,216,292,105,187,48.7,0.487,0.487,0.486
"10291","123572",2006,1513,1033,480,410,104,306,29.62,0.2962,0.271,0.217
"10292","126562",2006,885,510,375,155,52,103,20.2,0.202,0.175,0.139
"10293","126580",2006,914,531,383,216,75,141,26.55,0.2655,0.236,0.196
"10294","126614",2006,5606,2688,2918,2336,1016,1320,49.11,0.4911,0.417,0.348
"10295","126818",2006,3825,2166,1659,1448,441,1007,46.49,0.4649,0.379,0.266
"10296","127060",2006,1135,615,520,692,290,402,65.37,0.6537,0.61,0.558
"10297","127185",2006,821,367,454,161,59,102,27.79,0.2779,0.196,0.13
"10298","127565",2006,1711,925,786,102,33,69,7.46,0.0746,0.06,0.042
"10299","127741",2006,2491,1442,1049,659,204,455,31.55,0.3155,0.265,0.194
"10300","128106",2006,628,350,278,112,42,70,20,0.2,0.178,0.151
"10301","128744",2006,303,176,127,70,20,50,28.41,0.2841,0.231,0.157
"10302","128771",2006,1282,603,679,272,117,155,25.7,0.257,0.212,0.172
"10303","129020",2006,3222,1631,1591,2148,962,1186,72.72,0.7272,0.667,0.605
"10304","129242",2006,896,534,362,696,269,427,79.96,0.7996,0.777,0.743
"10305","129941",2006,690,325,365,305,157,148,45.54,0.4554,0.442,0.43
"10306","130253",2006,931,603,328,536,172,364,60.36,0.6036,0.576,0.524
"10307","130314",2006,133,133,0,50,0,50,37.59,0.3759,0.376,NA
"10308","130493",2006,1516,987,529,262,54,208,21.07,0.2107,0.173,0.102
"10309","130590",2006,608,294,314,466,229,237,80.61,0.8061,0.766,0.729
"10310","130697",2006,716,352,364,624,316,308,87.5,0.875,0.872,0.868
"10311","130776",2006,843,413,430,167,64,103,24.94,0.2494,0.198,0.149
"10312","130794",2006,1313,654,659,1169,578,591,90.37,0.9037,0.89,0.877
"10313","130934",2006,818,463,355,126,37,89,19.22,0.1922,0.154,0.104
"10314","130943",2006,3563,2127,1436,2175,777,1398,65.73,0.6573,0.61,0.541
"10315","131159",2006,1385,923,462,1007,321,686,74.32,0.7432,0.727,0.695
"10316","131283",2006,856,459,397,527,219,308,67.1,0.671,0.616,0.552
"10317","131450",2006,209,96,113,15,5,10,10.42,0.1042,0.072,0.044
"10318","131469",2006,2440,1348,1092,1804,756,1048,77.74,0.7774,0.739,0.692
"10319","131496",2006,1588,877,711,1419,630,789,89.97,0.8997,0.894,0.886
"10320","131520",2006,1512,1022,490,629,155,474,46.38,0.4638,0.416,0.316
"10321","132471",2006,387,255,132,82,24,58,22.75,0.2275,0.212,0.182
"10322","132602",2006,901,497,404,142,64,78,15.69,0.1569,0.158,0.158
"10323","132903",2006,6389,3389,3000,2257,754,1503,44.35,0.4435,0.353,0.251
"10324","133492",2006,544,315,229,308,113,195,61.9,0.619,0.566,0.493
"10325","133553",2006,1101,161,940,363,290,73,45.34,0.4534,0.33,0.309
"10326","133650",2006,1614,925,689,156,36,120,12.97,0.1297,0.097,0.052
"10327","133669",2006,2193,1208,985,339,115,224,18.54,0.1854,0.155,0.117
"10328","133711",2006,463,284,179,235,77,158,55.63,0.5563,0.508,0.43
"10329","133881",2006,597,160,437,222,144,78,48.75,0.4875,0.372,0.33
"10330","133951",2006,3889,2099,1790,736,243,493,23.49,0.2349,0.189,0.136
"10331","134079",2006,420,267,153,198,59,139,52.06,0.5206,0.471,0.386
"10332","134097",2006,6191,3597,2594,3310,1201,2109,58.63,0.5863,0.535,0.463
"10333","134130",2006,6674,3783,2891,4294,1572,2722,71.95,0.7195,0.643,0.544
"10334","134945",2006,493,213,280,134,62,72,33.8,0.338,0.272,0.221
"10335","135726",2006,2046,1055,991,1421,644,777,73.65,0.7365,0.695,0.65
"10336","136172",2006,2304,1301,1003,462,131,331,25.44,0.2544,0.201,0.131
"10337","136950",2006,501,287,214,312,119,193,67.25,0.6725,0.623,0.556
"10338","137546",2006,565,338,227,317,113,204,60.36,0.6036,0.561,0.498
"10339","138354",2006,861,495,366,209,65,144,29.09,0.2909,0.243,0.178
"10340","138716",2006,702,467,235,74,14,60,12.85,0.1285,0.105,0.06
"10341","138789",2006,757,472,285,63,14,49,10.38,0.1038,0.083,0.049
"10342","139144",2006,427,302,125,221,56,165,54.64,0.5464,0.518,0.448
"10343","139366",2006,1054,640,414,139,37,102,15.94,0.1594,0.132,0.089
"10344","139393",2006,297,166,131,163,62,101,60.84,0.6084,0.549,0.473
"10345","139658",2006,1648,938,710,1108,477,631,67.27,0.6727,0.672,0.672
"10346","139719",2006,486,253,233,51,9,42,16.6,0.166,0.105,0.039
"10347","139755",2006,2838,890,1948,953,548,405,45.51,0.4551,0.336,0.281
"10348","139764",2006,399,236,163,52,11,41,17.37,0.1737,0.13,0.067
"10349","139861",2006,1137,707,430,403,101,302,42.72,0.4272,0.354,0.235
"10350","139931",2006,2731,1294,1437,617,214,403,31.14,0.3114,0.226,0.149
"10351","139940",2006,2174,1313,861,439,135,304,23.15,0.2315,0.202,0.157
"10352","139959",2006,5059,3161,1898,2732,900,1832,57.96,0.5796,0.54,0.474
"10353","140447",2006,582,300,282,253,98,155,51.67,0.5167,0.435,0.348
"10354","140960",2006,697,377,320,60,12,48,12.73,0.1273,0.086,0.038
"10355","140988",2006,311,138,173,104,42,62,44.93,0.4493,0.334,0.243
"10356","141185",2006,190,104,86,62,18,44,42.31,0.4231,0.326,0.209
"10357","141264",2006,2015,1195,820,300,78,222,18.58,0.1858,0.149,0.095
"10358","141334",2006,1694,1002,692,254,67,187,18.66,0.1866,0.15,0.097
"10359","141486",2006,264,185,79,54,17,37,20,0.2,0.205,0.215
"10360","141565",2006,448,267,181,48,9,39,14.61,0.1461,0.107,0.05
"10361","141574",2006,1679,922,757,293,107,186,20.17,0.2017,0.175,0.141
"10362","142276",2006,994,525,469,85,23,62,11.81,0.1181,0.086,0.049
"10363","142285",2006,1582,749,833,369,150,219,29.24,0.2924,0.233,0.18
"10364","142461",2006,247,128,119,86,37,49,38.28,0.3828,0.348,0.311
"10365","143084",2006,692,392,300,505,216,289,73.72,0.7372,0.73,0.72
"10366","143288",2006,177,111,66,63,17,46,41.44,0.4144,0.356,0.258
"10367","144005",2006,359,254,105,16,2,14,5.51,0.0551,0.045,0.019
"10368","144281",2006,1972,1025,947,547,247,300,29.27,0.2927,0.277,0.261
"10369","144740",2006,2531,1428,1103,1280,482,798,55.88,0.5588,0.506,0.437
"10370","144892",2006,1760,1062,698,583,164,419,39.45,0.3945,0.331,0.235
"10371","144962",2006,484,296,188,275,100,175,59.12,0.5912,0.568,0.532
"10372","144971",2006,137,74,63,54,26,28,37.84,0.3784,0.394,0.413
"10373","145600",2006,2830,1554,1276,878,380,498,32.05,0.3205,0.31,0.298
"10374","145619",2006,379,189,190,139,57,82,43.39,0.4339,0.367,0.3
"10375","145637",2006,7152,3518,3634,4881,2256,2625,74.62,0.7462,0.682,0.621
"10376","145691",2006,293,154,139,148,49,99,64.29,0.6429,0.505,0.353
"10377","145813",2006,3188,1915,1273,1496,471,1025,53.52,0.5352,0.469,0.37
"10378","146481",2006,386,224,162,241,96,145,64.73,0.6473,0.624,0.593
"10379","146612",2006,568,323,245,223,94,129,39.94,0.3994,0.393,0.384
"10380","146719",2006,2134,1426,708,1104,357,747,52.38,0.5238,0.517,0.504
"10381","146825",2006,166,86,80,41,14,27,31.4,0.314,0.247,0.175
"10382","147013",2006,343,162,181,114,40,74,45.68,0.4568,0.332,0.221
"10383","147244",2006,475,261,214,214,89,125,47.89,0.4789,0.451,0.416
"10384","147341",2006,392,215,177,172,64,108,50.23,0.5023,0.439,0.362
"10385","147703",2006,3260,1641,1619,903,427,476,29.01,0.2901,0.277,0.264
"10386","147767",2006,2060,1089,971,1768,799,969,88.98,0.8898,0.858,0.823
"10387","147776",2006,1022,600,422,40,18,22,3.67,0.0367,0.039,0.043
"10388","147828",2006,751,414,337,332,126,206,49.76,0.4976,0.442,0.374
"10389","148131",2006,161,88,73,67,27,40,45.45,0.4545,0.416,0.37
"10390","148496",2006,362,256,106,203,52,151,58.98,0.5898,0.561,0.491
"10391","148584",2006,181,104,77,62,21,41,39.42,0.3942,0.343,0.273
"10392","148627",2006,525,370,155,172,47,125,33.78,0.3378,0.328,0.303
"10393","149222",2006,2278,1005,1273,586,266,320,31.84,0.3184,0.257,0.209
"10394","149231",2006,1770,1025,745,527,163,364,35.51,0.3551,0.298,0.219
"10395","149772",2006,1907,909,998,583,303,280,30.8,0.308,0.306,0.304
"10396","149781",2006,572,278,294,435,219,216,77.7,0.777,0.76,0.745
"10397","150066",2006,447,245,202,206,83,123,50.2,0.502,0.461,0.411
"10398","150136",2006,3947,2027,1920,1155,425,730,36.01,0.3601,0.293,0.221
"10399","150145",2006,303,190,113,136,41,95,50,0.5,0.449,0.363
"10400","150163",2006,965,604,361,479,150,329,54.47,0.5447,0.496,0.416
"10401","150400",2006,595,334,261,442,186,256,76.65,0.7665,0.743,0.713
"10402","150534",2006,643,379,264,359,139,220,58.05,0.5805,0.558,0.527
"10403","150668",2006,206,122,84,114,44,70,57.38,0.5738,0.553,0.524
"10404","150941",2006,250,140,110,126,52,74,52.86,0.5286,0.504,0.473
"10405","151102",2006,1608,859,749,61,20,41,4.77,0.0477,0.038,0.027
"10406","151111",2006,2516,1549,967,317,109,208,13.43,0.1343,0.126,0.113
"10407","151306",2006,2021,1253,768,321,70,251,20.03,0.2003,0.159,0.091
"10408","151324",2006,1657,827,830,335,125,210,25.39,0.2539,0.202,0.151
"10409","151333",2006,329,210,119,26,6,20,9.52,0.0952,0.079,0.05
"10410","151342",2006,772,427,345,31,16,15,3.51,0.0351,0.04,0.046
"10411","151351",2006,7208,3875,3333,3949,1681,2268,58.53,0.5853,0.548,0.504
"10412","151360",2006,561,352,209,31,8,23,6.53,0.0653,0.055,0.038
"10413","151379",2006,727,430,297,63,24,39,9.07,0.0907,0.087,0.081
"10414","151388",2006,225,135,90,9,3,6,4.44,0.0444,0.04,0.033
"10415","151777",2006,311,137,174,136,62,74,54.01,0.5401,0.437,0.356
"10416","151786",2006,277,148,129,108,32,76,51.35,0.5135,0.39,0.248
"10417","152080",2006,2029,928,1101,1800,962,838,90.3,0.903,0.887,0.874
"10418","152248",2006,1036,546,490,52,19,33,6.04,0.0604,0.05,0.039
"10419","152363",2006,251,111,140,100,49,51,45.95,0.4595,0.398,0.35
"10420","152530",2006,492,266,226,341,146,195,73.31,0.7331,0.693,0.646
"10421","152600",2006,760,394,366,469,206,263,66.75,0.6675,0.617,0.563
"10422","153001",2006,265,133,132,111,51,60,45.11,0.4511,0.419,0.386
"10423","153108",2006,413,218,195,256,103,153,70.18,0.7018,0.62,0.528
"10424","153269",2006,779,470,309,429,173,256,54.47,0.5447,0.551,0.56
"10425","153384",2006,405,206,199,348,166,182,88.35,0.8835,0.859,0.834
"10426","153603",2006,3933,1780,2153,1525,649,876,49.21,0.4921,0.388,0.301
"10427","153834",2006,610,350,260,417,180,237,67.71,0.6771,0.684,0.692
"10428","154095",2006,1684,1010,674,648,200,448,44.36,0.4436,0.385,0.297
"10429","155089",2006,139,64,75,12,8,4,6.25,0.0625,0.086,0.107
"10430","155317",2006,4092,2092,2000,1500,607,893,42.69,0.4269,0.367,0.304
"10431","155335",2006,167,96,71,48,18,30,31.25,0.3125,0.287,0.254
"10432","155399",2006,3140,1602,1538,832,288,544,33.96,0.3396,0.265,0.187
"10433","155520",2006,239,118,121,82,36,46,38.98,0.3898,0.343,0.298
"10434","155627",2006,90,38,52,19,6,13,34.21,0.3421,0.211,0.115
"10435","155937",2006,197,79,118,40,10,30,37.97,0.3797,0.203,0.085
"10436","156213",2006,276,161,115,178,67,111,68.94,0.6894,0.645,0.583
"10437","156286",2006,429,279,150,206,60,146,52.33,0.5233,0.48,0.4
"10438","156295",2006,388,220,168,185,78,107,48.64,0.4864,0.477,0.464
"10439","156365",2006,346,182,164,81,32,49,26.92,0.2692,0.234,0.195
"10440","156541",2006,349,177,172,99,34,65,36.72,0.3672,0.284,0.198
"10441","156745",2006,363,226,137,185,53,132,58.41,0.5841,0.51,0.387
"10442","157058",2006,569,277,292,21,6,15,5.42,0.0542,0.037,0.021
"10443","157076",2006,326,127,199,82,41,41,32.28,0.3228,0.252,0.206
"10444","157085",2006,4113,2201,1912,1253,443,810,36.8,0.368,0.305,0.232
"10445","157289",2006,2380,1230,1150,628,257,371,30.16,0.3016,0.264,0.223
"10446","157386",2006,1330,741,589,201,65,136,18.35,0.1835,0.151,0.11
"10447","157401",2006,1390,822,568,391,123,268,32.6,0.326,0.281,0.217
"10448","157447",2006,1908,1069,839,230,83,147,13.75,0.1375,0.121,0.099
"10449","157535",2006,220,105,115,26,4,22,20.95,0.2095,0.118,0.035
"10450","157951",2006,3118,1768,1350,649,217,432,24.43,0.2443,0.208,0.161
"10451","158477",2006,241,136,105,104,45,59,43.38,0.4338,0.432,0.429
"10452","159009",2006,1119,609,510,108,33,75,12.32,0.1232,0.097,0.065
"10453","159391",2006,4503,2449,2054,1530,584,946,38.63,0.3863,0.34,0.284
"10454","159647",2006,1625,753,872,426,185,241,32.01,0.3201,0.262,0.212
"10455","159717",2006,1272,741,531,195,60,135,18.22,0.1822,0.153,0.113
"10456","159966",2006,1069,650,419,170,44,126,19.38,0.1938,0.159,0.105
"10457","160038",2006,1324,854,470,214,62,152,17.8,0.178,0.162,0.132
"10458","160612",2006,2665,1604,1061,320,93,227,14.15,0.1415,0.12,0.088
"10459","160621",2006,1136,659,477,132,33,99,15.02,0.1502,0.116,0.069
"10460","160658",2006,2799,1604,1195,362,108,254,15.84,0.1584,0.129,0.09
"10461","161004",2006,474,253,221,430,193,237,93.68,0.9368,0.907,0.873
"10462","161226",2006,511,351,160,209,49,160,45.58,0.4558,0.409,0.306
"10463","161235",2006,116,67,49,2,1,1,1.49,0.0149,0.017,0.02
"10464","161244",2006,99,59,40,10,6,4,6.78,0.0678,0.101,0.15
"10465","161253",2006,1807,875,932,648,296,352,40.23,0.4023,0.359,0.318
"10466","161554",2006,888,511,377,84,25,59,11.55,0.1155,0.095,0.066
"10467","162007",2006,765,475,290,83,20,63,13.26,0.1326,0.108,0.069
"10468","162210",2006,144,84,60,18,5,13,15.48,0.1548,0.125,0.083
"10469","162283",2006,494,390,104,28,3,25,6.41,0.0641,0.057,0.029
"10470","162584",2006,1011,459,552,175,65,110,23.97,0.2397,0.173,0.118
"10471","162654",2006,450,303,147,255,70,185,61.06,0.6106,0.567,0.476
"10472","162760",2006,278,185,93,137,38,99,53.51,0.5351,0.493,0.409
"10473","162928",2006,1304,643,661,1127,563,564,87.71,0.8771,0.864,0.852
"10474","163046",2006,946,596,350,749,263,486,81.54,0.8154,0.792,0.751
"10475","163268",2006,1419,626,793,523,233,290,46.33,0.4633,0.369,0.294
"10476","163286",2006,3944,1896,2048,2493,1179,1314,69.3,0.693,0.632,0.576
"10477","163453",2006,1368,773,595,165,46,119,15.39,0.1539,0.121,0.077
"10478","163462",2006,426,244,182,265,97,168,68.85,0.6885,0.622,0.533
"10479","163851",2006,1028,588,440,502,171,331,56.29,0.5629,0.488,0.389
"10480","163912",2006,428,249,179,309,118,191,76.71,0.7671,0.722,0.659
"10481","164076",2006,2688,1697,991,1047,307,740,43.61,0.4361,0.39,0.31
"10482","164173",2006,643,454,189,315,85,230,50.66,0.5066,0.49,0.45
"10483","164216",2006,312,179,133,202,80,122,68.16,0.6816,0.647,0.602
"10484","164270",2006,476,260,216,324,126,198,76.15,0.7615,0.681,0.583
"10485","164447",2006,282,148,134,81,29,52,35.14,0.3514,0.287,0.216
"10486","164492",2006,181,105,76,71,24,47,44.76,0.4476,0.392,0.316
"10487","164562",2006,675,397,278,484,183,301,75.82,0.7582,0.717,0.658
"10488","165015",2006,764,416,348,656,291,365,87.74,0.8774,0.859,0.836
"10489","165024",2006,1321,737,584,368,135,233,31.61,0.3161,0.279,0.231
"10490","165334",2006,563,345,218,425,159,266,77.1,0.771,0.755,0.729
"10491","165662",2006,728,409,319,578,254,324,79.22,0.7922,0.794,0.796
"10492","165671",2006,467,344,123,233,55,178,51.74,0.5174,0.499,0.447
"10493","165820",2006,728,383,345,172,63,109,28.46,0.2846,0.236,0.183
"10494","165866",2006,714,496,218,242,57,185,37.3,0.373,0.339,0.261
"10495","165936",2006,380,250,130,225,71,154,61.6,0.616,0.592,0.546
"10496","166027",2006,1679,878,801,1448,664,784,89.29,0.8929,0.862,0.829
"10497","166124",2006,751,415,336,675,293,382,92.05,0.9205,0.899,0.872
"10498","166513",2006,1208,451,757,355,190,165,36.59,0.3659,0.294,0.251
"10499","166629",2006,4265,2174,2091,2259,1002,1257,57.82,0.5782,0.53,0.479
"10500","166638",2006,846,484,362,109,29,80,16.53,0.1653,0.129,0.08
"10501","166683",2006,1001,447,554,837,457,380,85.01,0.8501,0.836,0.825
"10502","167288",2006,299,175,124,94,33,61,34.86,0.3486,0.314,0.266
"10503","167987",2006,1763,866,897,559,248,311,35.91,0.3591,0.317,0.276
"10504","167996",2006,594,363,231,469,173,296,81.54,0.8154,0.79,0.749
"10505","168005",2006,1286,735,551,520,197,323,43.95,0.4395,0.404,0.358
"10506","168148",2006,1280,648,632,1120,543,577,89.04,0.8904,0.875,0.859
"10507","168254",2006,719,259,460,367,211,156,60.23,0.6023,0.51,0.459
"10508","168281",2006,410,239,171,317,125,192,80.33,0.8033,0.773,0.731
"10509","168342",2006,533,280,253,484,223,261,93.21,0.9321,0.908,0.881
"10510","168546",2006,480,260,220,297,118,179,68.85,0.6885,0.619,0.536
"10511","168786",2006,387,252,135,192,67,125,49.6,0.496,0.496,0.496
"10512","169080",2006,1020,551,469,615,268,347,62.98,0.6298,0.603,0.571
"10513","169798",2006,2272,1315,957,276,97,179,13.61,0.1361,0.121,0.101
"10514","169910",2006,1895,860,1035,167,82,85,9.88,0.0988,0.088,0.079
"10515","170082",2006,3556,2276,1280,1116,346,770,33.83,0.3383,0.314,0.27
"10516","170301",2006,778,461,317,524,189,335,72.67,0.7267,0.674,0.596
"10517","170532",2006,379,211,168,279,110,169,80.09,0.8009,0.736,0.655
"10518","170639",2006,454,232,222,58,23,35,15.09,0.1509,0.128,0.104
"10519","170976",2006,5356,2704,2652,4072,1880,2192,81.07,0.8107,0.76,0.709
"10520","171100",2006,7306,4103,3203,3800,1448,2352,57.32,0.5732,0.52,0.452
"10521","171128",2006,1163,283,880,328,221,107,37.81,0.3781,0.282,0.251
"10522","171137",2006,761,394,367,136,56,80,20.3,0.203,0.179,0.153
"10523","171146",2006,483,274,209,46,14,32,11.68,0.1168,0.095,0.067
"10524","171599",2006,195,73,122,52,28,24,32.88,0.3288,0.267,0.23
"10525","172051",2006,1434,840,594,123,36,87,10.36,0.1036,0.086,0.061
"10526","172699",2006,3531,1800,1731,852,359,493,27.39,0.2739,0.241,0.207
"10527","173160",2006,629,351,278,392,157,235,66.95,0.6695,0.623,0.565
"10528","173258",2006,504,272,232,458,209,249,91.54,0.9154,0.909,0.901
"10529","173328",2006,199,108,91,51,19,32,29.63,0.2963,0.256,0.209
"10530","173647",2006,684,396,288,553,226,327,82.58,0.8258,0.808,0.785
"10531","173902",2006,501,281,220,429,181,248,88.26,0.8826,0.856,0.823
"10532","174066",2006,5418,2970,2448,2734,1150,1584,53.33,0.5333,0.505,0.47
"10533","174233",2006,2283,1105,1178,629,270,359,32.49,0.3249,0.276,0.229
"10534","174251",2006,377,214,163,179,66,113,52.8,0.528,0.475,0.405
"10535","174491",2006,498,302,196,256,89,167,55.3,0.553,0.514,0.454
"10536","174792",2006,506,0,506,347,347,0,NA,NA,0.686,0.686
"10537","174844",2006,792,436,356,660,288,372,85.32,0.8532,0.833,0.809
"10538","174899",2006,493,331,162,283,79,204,61.63,0.6163,0.574,0.488
"10539","174914",2006,1298,644,654,816,392,424,65.84,0.6584,0.629,0.599
"10540","175342",2006,545,302,243,79,34,45,14.9,0.149,0.145,0.14
"10541","175421",2006,248,133,115,76,31,45,33.83,0.3383,0.306,0.27
"10542","175616",2006,468,288,180,85,33,52,18.06,0.1806,0.182,0.183
"10543","175856",2006,889,513,376,191,57,134,26.12,0.2612,0.215,0.152
"10544","175980",2006,225,122,103,149,63,86,70.49,0.7049,0.662,0.612
"10545","176017",2006,2521,1320,1201,920,352,568,43.03,0.4303,0.365,0.293
"10546","176035",2006,256,243,13,53,3,50,20.58,0.2058,0.207,0.231
"10547","176044",2006,443,216,227,55,14,41,18.98,0.1898,0.124,0.062
"10548","176080",2006,1897,947,950,575,233,342,36.11,0.3611,0.303,0.245
"10549","176406",2006,243,172,71,74,15,59,34.3,0.343,0.305,0.211
"10550","176628",2006,138,78,60,34,11,23,29.49,0.2949,0.246,0.183
"10551","176947",2006,207,111,96,81,28,53,47.75,0.4775,0.391,0.292
"10552","176965",2006,1505,871,634,416,134,282,32.38,0.3238,0.276,0.211
"10553","177418",2006,187,98,89,30,11,19,19.39,0.1939,0.16,0.124
"10554","178059",2006,290,237,53,152,26,126,53.16,0.5316,0.524,0.491
"10555","178341",2006,851,484,367,106,40,66,13.64,0.1364,0.125,0.109
"10556","178387",2006,936,516,420,102,39,63,12.21,0.1221,0.109,0.093
"10557","178396",2006,4783,2562,2221,2234,835,1399,54.61,0.5461,0.467,0.376
"10558","178402",2006,928,545,383,220,86,134,24.59,0.2459,0.237,0.225
"10559","178411",2006,929,216,713,258,176,82,37.96,0.3796,0.278,0.247
"10560","178420",2006,476,273,203,106,33,73,26.74,0.2674,0.223,0.163
"10561","178615",2006,1365,826,539,781,258,523,63.32,0.6332,0.572,0.479
"10562","179043",2006,396,260,136,237,73,164,63.08,0.6308,0.598,0.537
"10563","179159",2006,1567,940,627,946,358,588,62.55,0.6255,0.604,0.571
"10564","179557",2006,1383,853,530,318,92,226,26.49,0.2649,0.23,0.174
"10565","179566",2006,2732,1622,1110,854,306,548,33.79,0.3379,0.313,0.276
"10566","179867",2006,1456,714,742,1284,628,656,91.88,0.9188,0.882,0.846
"10567","179894",2006,418,240,178,198,69,129,53.75,0.5375,0.474,0.388
"10568","179946",2006,278,139,139,163,73,90,64.75,0.6475,0.586,0.525
"10569","180179",2006,646,339,307,59,17,42,12.39,0.1239,0.091,0.055
"10570","180461",2006,1940,814,1126,381,173,208,25.55,0.2555,0.196,0.154
"10571","180522",2006,193,66,127,12,5,7,10.61,0.1061,0.062,0.039
"10572","180984",2006,302,153,149,114,43,71,46.41,0.4641,0.377,0.289
"10573","181002",2006,965,591,374,653,257,396,67.01,0.6701,0.677,0.687
"10574","181020",2006,247,147,100,149,54,95,64.63,0.6463,0.603,0.54
"10575","181127",2006,262,111,151,122,57,65,58.56,0.5856,0.466,0.377
"10576","181215",2006,937,521,416,202,80,122,23.42,0.2342,0.216,0.192
"10577","181394",2006,1637,864,773,231,95,136,15.74,0.1574,0.141,0.123
"10578","181446",2006,413,212,201,212,94,118,55.66,0.5566,0.513,0.468
"10579","181464",2006,3828,1805,2023,1126,503,623,34.52,0.3452,0.294,0.249
"10580","181534",2006,204,95,109,37,17,20,21.05,0.2105,0.181,0.156
"10581","181783",2006,606,335,271,166,53,113,33.73,0.3373,0.274,0.196
"10582","182281",2006,2532,1410,1122,368,130,238,16.88,0.1688,0.145,0.116
"10583","182290",2006,2358,1300,1058,407,146,261,20.08,0.2008,0.173,0.138
"10584","182634",2006,220,151,69,95,22,73,48.34,0.4834,0.432,0.319
"10585","182795",2006,553,260,293,226,103,123,47.31,0.4731,0.409,0.352
"10586","183062",2006,1139,718,421,559,194,365,50.84,0.5084,0.491,0.461
"10587","183080",2006,1008,446,562,402,191,211,47.31,0.4731,0.399,0.34
"10588","183239",2006,568,343,225,410,151,259,75.51,0.7551,0.722,0.671
"10589","183822",2006,316,183,133,47,18,29,15.85,0.1585,0.149,0.135
"10590","183974",2006,303,211,92,147,41,106,50.24,0.5024,0.485,0.446
"10591","184348",2006,479,316,163,315,103,212,67.09,0.6709,0.658,0.632
"10592","184603",2006,452,254,198,119,37,82,32.28,0.3228,0.263,0.187
"10593","184612",2006,251,172,79,58,20,38,22.09,0.2209,0.231,0.253
"10594","184782",2006,1216,602,614,593,271,322,53.49,0.5349,0.488,0.441
"10595","185129",2006,646,379,267,45,13,32,8.44,0.0844,0.07,0.049
"10596","185572",2006,959,535,424,425,168,257,48.04,0.4804,0.443,0.396
"10597","185590",2006,2018,1197,821,702,214,488,40.77,0.4077,0.348,0.261
"10598","185828",2006,795,146,649,150,102,48,32.88,0.3288,0.189,0.157
"10599","186131",2006,1228,576,652,1078,561,517,89.76,0.8976,0.878,0.86
"10600","186201",2006,811,475,336,488,182,306,64.42,0.6442,0.602,0.542
"10601","186283",2006,1016,619,397,576,206,370,59.77,0.5977,0.567,0.519
"10602","186584",2006,1054,602,452,574,231,343,56.98,0.5698,0.545,0.511
"10603","186876",2006,791,425,366,319,123,196,46.12,0.4612,0.403,0.336
"10604","187134",2006,1270,756,514,919,339,580,76.72,0.7672,0.724,0.66
"10605","187444",2006,1218,669,549,170,62,108,16.14,0.1614,0.14,0.113
"10606","187985",2006,2955,1619,1336,356,124,232,14.33,0.1433,0.12,0.093
"10607","188030",2006,2073,1105,968,286,80,206,18.64,0.1864,0.138,0.083
"10608","188429",2006,826,587,239,446,108,338,57.58,0.5758,0.54,0.452
"10609","188641",2006,490,257,233,229,86,143,55.64,0.5564,0.467,0.369
"10610","190044",2006,646,176,470,354,246,108,61.36,0.6136,0.548,0.523
"10611","190099",2006,743,417,326,630,278,352,84.41,0.8441,0.848,0.853
"10612","190150",2006,1353,646,707,1191,604,587,90.87,0.9087,0.88,0.854
"10613","190248",2006,171,90,81,57,26,31,34.44,0.3444,0.333,0.321
"10614","190415",2006,3186,1538,1648,2779,1375,1404,91.29,0.9129,0.872,0.834
"10615","190512",2006,1493,650,843,497,248,249,38.31,0.3831,0.333,0.294
"10616","190549",2006,1354,766,588,355,120,235,30.68,0.3068,0.262,0.204
"10617","190558",2006,2072,1124,948,108,41,67,5.96,0.0596,0.052,0.043
"10618","190567",2006,1529,760,769,114,43,71,9.34,0.0934,0.075,0.056
"10619","190594",2006,1813,1202,611,349,86,263,21.88,0.2188,0.192,0.141
"10620","190637",2006,911,674,237,131,24,107,15.88,0.1588,0.144,0.101
"10621","190664",2006,1627,991,636,418,113,305,30.78,0.3078,0.257,0.178
"10622","190691",2006,668,428,240,27,10,17,3.97,0.0397,0.04,0.042
"10623","190725",2006,368,284,84,100,22,78,27.46,0.2746,0.272,0.262
"10624","191241",2006,1697,929,768,1300,578,722,77.72,0.7772,0.766,0.753
"10625","191515",2006,501,267,234,424,195,229,85.77,0.8577,0.846,0.833
"10626","191533",2006,464,270,194,235,88,147,54.44,0.5444,0.506,0.454
"10627","191630",2006,597,319,278,428,182,246,77.12,0.7712,0.717,0.655
"10628","191649",2006,1706,865,841,768,335,433,50.06,0.5006,0.45,0.398
"10629","191676",2006,306,195,111,177,58,119,61.03,0.6103,0.578,0.523
"10630","191931",2006,903,504,399,506,181,325,64.48,0.6448,0.56,0.454
"10631","191968",2006,1519,819,700,1059,466,593,72.41,0.7241,0.697,0.666
"10632","192192",2006,232,147,85,106,44,62,42.18,0.4218,0.457,0.518
"10633","192323",2006,544,330,214,329,120,209,63.33,0.6333,0.605,0.561
"10634","192439",2006,1079,730,349,56,14,42,5.75,0.0575,0.052,0.04
"10635","192703",2006,710,353,357,466,234,232,65.72,0.6572,0.656,0.655
"10636","192749",2006,507,329,178,274,91,183,55.62,0.5562,0.54,0.511
"10637","192819",2006,1038,573,465,737,309,428,74.69,0.7469,0.71,0.665
"10638","192925",2006,320,198,122,87,38,49,24.75,0.2475,0.272,0.311
"10639","193016",2006,614,390,224,79,22,57,14.62,0.1462,0.129,0.098
"10640","193292",2006,269,196,73,90,22,68,34.69,0.3469,0.335,0.301
"10641","193353",2006,400,295,105,162,41,121,41.02,0.4102,0.405,0.39
"10642","193399",2006,390,294,96,159,37,122,41.5,0.415,0.408,0.385
"10643","193584",2006,481,364,117,293,62,231,63.46,0.6346,0.609,0.53
"10644","193645",2006,821,757,64,133,6,127,16.78,0.1678,0.162,0.094
"10645","193654",2006,883,622,261,409,110,299,48.07,0.4807,0.463,0.421
"10646","193900",2006,4704,2895,1809,2879,1141,1738,60.03,0.6003,0.612,0.631
"10647","193973",2006,705,421,284,437,169,268,63.66,0.6366,0.62,0.595
"10648","194161",2006,308,178,130,85,30,55,30.9,0.309,0.276,0.231
"10649","194310",2006,1131,738,393,441,126,315,42.68,0.4268,0.39,0.321
"10650","194824",2006,1269,362,907,766,544,222,61.33,0.6133,0.604,0.6
"10651","195003",2006,2355,675,1680,589,315,274,40.59,0.4059,0.25,0.188
"10652","195030",2006,1219,561,658,906,467,439,78.25,0.7825,0.743,0.71
"10653","195164",2006,459,234,225,235,105,130,55.56,0.5556,0.512,0.467
"10654","195173",2006,474,253,221,137,61,76,30.04,0.3004,0.289,0.276
"10655","195216",2006,608,325,283,463,210,253,77.85,0.7785,0.762,0.742
"10656","195234",2006,630,423,207,328,88,240,56.74,0.5674,0.521,0.425
"10657","195243",2006,323,185,138,113,39,74,40,0.4,0.35,0.283
"10658","195304",2006,381,286,95,261,62,199,69.58,0.6958,0.685,0.653
"10659","195474",2006,688,393,295,478,190,288,73.28,0.7328,0.695,0.644
"10660","195526",2006,672,388,284,565,231,334,86.08,0.8608,0.841,0.813
"10661","195544",2006,597,424,173,309,68,241,56.84,0.5684,0.518,0.393
"10662","195809",2006,3260,1713,1547,1198,494,704,41.1,0.411,0.367,0.319
"10663","196413",2006,3045,1686,1359,2099,839,1260,74.73,0.7473,0.689,0.617
"10664","196592",2006,1479,988,491,60,25,35,3.54,0.0354,0.041,0.051
"10665","197045",2006,495,277,218,164,62,102,36.82,0.3682,0.331,0.284
"10666","197133",2006,668,412,256,534,173,361,87.62,0.8762,0.799,0.676
"10667","197869",2006,2707,1403,1304,1080,402,678,48.33,0.4833,0.399,0.308
"10668","197984",2006,279,142,137,94,34,60,42.25,0.4225,0.337,0.248
"10669","198385",2006,461,233,228,410,197,213,91.42,0.9142,0.889,0.864
"10670","198464",2006,3784,2331,1453,1240,347,893,38.31,0.3831,0.328,0.239
"10671","198507",2006,534,313,221,90,20,70,22.36,0.2236,0.169,0.09
"10672","198516",2006,1283,740,543,991,378,613,82.84,0.8284,0.772,0.696
"10673","198835",2006,347,195,152,117,40,77,39.49,0.3949,0.337,0.263
"10674","198969",2006,449,135,314,75,31,44,32.59,0.3259,0.167,0.099
"10675","199102",2006,2068,1102,966,340,81,259,23.5,0.235,0.164,0.084
"10676","199111",2006,567,328,239,180,57,123,37.5,0.375,0.317,0.238
"10677","199120",2006,3796,2276,1520,2893,1107,1786,78.47,0.7847,0.762,0.728
"10678","199139",2006,2764,1475,1289,728,280,448,30.37,0.3037,0.263,0.217
"10679","199148",2006,2400,1698,702,706,128,578,34.04,0.3404,0.294,0.182
"10680","199157",2006,975,631,344,145,30,115,18.23,0.1823,0.149,0.087
"10681","199193",2006,4667,2067,2600,1781,761,1020,49.35,0.4935,0.382,0.293
"10682","199218",2006,1980,1140,840,973,335,638,55.96,0.5596,0.491,0.399
"10683","199281",2006,929,475,454,148,54,94,19.79,0.1979,0.159,0.119
"10684","199306",2006,196,85,111,72,38,34,40,0.4,0.367,0.342
"10685","199412",2006,235,173,62,104,22,82,47.4,0.474,0.443,0.355
"10686","199582",2006,363,146,217,58,23,35,23.97,0.2397,0.16,0.106
"10687","199643",2006,674,423,251,82,23,59,13.95,0.1395,0.122,0.092
"10688","199847",2006,1119,576,543,927,432,495,85.94,0.8594,0.828,0.796
"10689","199962",2006,385,198,187,152,57,95,47.98,0.4798,0.395,0.305
"10690","199999",2006,976,692,284,144,36,108,15.61,0.1561,0.148,0.127
"10691","200004",2006,1558,784,774,434,163,271,34.57,0.3457,0.279,0.211
"10692","200059",2006,333,160,173,50,22,28,17.5,0.175,0.15,0.127
"10693","200156",2006,238,129,109,75,21,54,41.86,0.4186,0.315,0.193
"10694","200217",2006,343,187,156,19,10,9,4.81,0.0481,0.055,0.064
"10695","200226",2006,137,59,78,29,7,22,37.29,0.3729,0.212,0.09
"10696","200253",2006,461,263,198,58,13,45,17.11,0.1711,0.126,0.066
"10697","200280",2006,1868,869,999,438,199,239,27.5,0.275,0.234,0.199
"10698","200332",2006,2040,920,1120,486,221,265,28.8,0.288,0.238,0.197
"10699","200572",2006,177,70,107,44,20,24,34.29,0.3429,0.249,0.187
"10700","201104",2006,554,313,241,238,78,160,51.12,0.5112,0.43,0.324
"10701","201371",2006,241,122,119,119,50,69,56.56,0.5656,0.494,0.42
"10702","201548",2006,690,410,280,342,130,212,51.71,0.5171,0.496,0.464
"10703","201645",2006,1015,441,574,636,325,311,70.52,0.7052,0.627,0.566
"10704","201690",2006,535,266,269,65,21,44,16.54,0.1654,0.121,0.078
"10705","202134",2006,947,520,427,95,31,64,12.31,0.1231,0.1,0.073
"10706","202480",2006,1738,864,874,1041,450,591,68.4,0.684,0.599,0.515
"10707","202523",2006,573,335,238,481,190,291,86.87,0.8687,0.839,0.798
"10708","202763",2006,616,441,175,243,58,185,41.95,0.4195,0.394,0.331
"10709","203085",2006,267,131,136,105,38,67,51.15,0.5115,0.393,0.279
"10710","203128",2006,298,143,155,174,80,94,65.73,0.6573,0.584,0.516
"10711","203368",2006,712,385,327,469,205,264,68.57,0.6857,0.659,0.627
"10712","203517",2006,3610,2214,1396,977,295,682,30.8,0.308,0.271,0.211
"10713","203535",2006,457,226,231,397,190,207,91.59,0.9159,0.869,0.823
"10714","203580",2006,131,89,42,48,13,35,39.33,0.3933,0.366,0.31
"10715","203775",2006,341,208,133,159,58,101,48.56,0.4856,0.466,0.436
"10716","203845",2006,385,191,194,206,83,123,64.4,0.644,0.535,0.428
"10717","204024",2006,3630,2017,1613,2472,1010,1462,72.48,0.7248,0.681,0.626
"10718","204185",2006,636,284,352,343,149,194,68.31,0.6831,0.539,0.423
"10719","204194",2006,346,201,145,160,66,94,46.77,0.4677,0.462,0.455
"10720","204617",2006,354,177,177,107,51,56,31.64,0.3164,0.302,0.288
"10721","204796",2006,6262,3104,3158,3295,1373,1922,61.92,0.6192,0.526,0.435
"10722","204857",2006,4009,2063,1946,1766,693,1073,52.01,0.5201,0.441,0.356
"10723","206330",2006,238,91,147,61,19,42,46.15,0.4615,0.256,0.129
"10724","206589",2006,494,242,252,345,163,182,75.21,0.7521,0.698,0.647
"10725","206604",2006,2178,1211,967,422,155,267,22.05,0.2205,0.194,0.16
"10726","206622",2006,812,459,353,574,244,330,71.9,0.719,0.707,0.691
"10727","206695",2006,2169,1095,1074,187,74,113,10.32,0.1032,0.086,0.069
"10728","206914",2006,686,402,284,40,16,24,5.97,0.0597,0.058,0.056
"10729","207209",2006,533,271,262,32,8,24,8.86,0.0886,0.06,0.031
"10730","207306",2006,243,121,122,29,9,20,16.53,0.1653,0.119,0.074
"10731","207324",2006,512,260,252,166,76,90,34.62,0.3462,0.324,0.302
"10732","207388",2006,3132,1658,1474,1068,383,685,41.31,0.4131,0.341,0.26
"10733","207500",2006,3285,1732,1553,1190,457,733,42.32,0.4232,0.362,0.294
"10734","207722",2006,208,139,69,58,16,42,30.22,0.3022,0.279,0.232
"10735","207847",2006,586,313,273,67,26,41,13.1,0.131,0.114,0.095
"10736","207865",2006,844,485,359,129,31,98,20.21,0.2021,0.153,0.086
"10737","208822",2006,415,262,153,223,81,142,54.2,0.542,0.537,0.529
"10738","209056",2006,508,318,190,349,129,220,69.18,0.6918,0.687,0.679
"10739","209065",2006,445,243,202,265,104,161,66.26,0.6626,0.596,0.515
"10740","209542",2006,2898,1413,1485,872,341,531,37.58,0.3758,0.301,0.23
"10741","209551",2006,3349,1821,1528,1468,575,893,49.04,0.4904,0.438,0.376
"10742","209612",2006,360,206,154,194,72,122,59.22,0.5922,0.539,0.468
"10743","209807",2006,1283,695,588,200,67,133,19.14,0.1914,0.156,0.114
"10744","209922",2006,371,207,164,222,91,131,63.29,0.6329,0.598,0.555
"10745","210146",2006,707,401,306,110,31,79,19.7,0.197,0.156,0.101
"10746","210401",2006,482,260,222,333,139,194,74.62,0.7462,0.691,0.626
"10747","210429",2006,750,485,265,150,40,110,22.68,0.2268,0.2,0.151
"10748","210571",2006,458,233,225,210,87,123,52.79,0.5279,0.459,0.387
"10749","210669",2006,570,322,248,398,159,239,74.22,0.7422,0.698,0.641
"10750","210775",2006,300,188,112,114,43,71,37.77,0.3777,0.38,0.384
"10751","211088",2006,572,452,120,336,72,264,58.41,0.5841,0.587,0.6
"10752","211158",2006,1630,987,643,696,221,475,48.13,0.4813,0.427,0.344
"10753","211291",2006,921,458,463,792,383,409,89.3,0.893,0.86,0.827
"10754","211352",2006,529,337,192,232,63,169,50.15,0.5015,0.439,0.328
"10755","211361",2006,1260,685,575,313,124,189,27.59,0.2759,0.248,0.216
"10756","211431",2006,262,250,12,114,3,111,44.4,0.444,0.435,0.25
"10757","211440",2006,1421,552,869,1033,630,403,73.01,0.7301,0.727,0.725
"10758","211468",2006,254,251,3,124,1,123,49,0.49,0.488,0.333
"10759","211556",2006,147,147,0,75,0,75,51.02,0.5102,0.51,NA
"10760","211583",2006,214,155,59,78,22,56,36.13,0.3613,0.364,0.373
"10761","211608",2006,437,238,199,47,15,32,13.45,0.1345,0.108,0.075
"10762","211644",2006,1295,758,537,323,110,213,28.1,0.281,0.249,0.205
"10763","211981",2006,447,264,183,220,68,152,57.58,0.5758,0.492,0.372
"10764","212009",2006,617,360,257,499,199,300,83.33,0.8333,0.809,0.774
"10765","212054",2006,2256,930,1326,598,219,379,40.75,0.4075,0.265,0.165
"10766","212106",2006,1321,779,542,700,268,432,55.46,0.5546,0.53,0.494
"10767","212115",2006,1239,716,523,454,147,307,42.88,0.4288,0.366,0.281
"10768","212133",2006,494,336,158,230,70,160,47.62,0.4762,0.466,0.443
"10769","212160",2006,1212,671,541,230,63,167,24.89,0.2489,0.19,0.116
"10770","212197",2006,528,345,183,372,125,247,71.59,0.7159,0.705,0.683
"10771","212577",2006,523,274,249,413,196,217,79.2,0.792,0.79,0.787
"10772","212601",2006,600,352,248,280,97,183,51.99,0.5199,0.467,0.391
"10773","212832",2006,272,202,70,54,19,35,17.33,0.1733,0.199,0.271
"10774","212911",2006,314,174,140,281,123,158,90.8,0.908,0.895,0.879
"10775","213020",2006,2538,1400,1138,726,225,501,35.79,0.3579,0.286,0.198
"10776","213251",2006,362,195,167,257,111,146,74.87,0.7487,0.71,0.665
"10777","213321",2006,478,202,276,295,153,142,70.3,0.703,0.617,0.554
"10778","213349",2006,1930,1177,753,612,163,449,38.15,0.3815,0.317,0.216
"10779","213358",2006,259,164,95,92,32,60,36.59,0.3659,0.355,0.337
"10780","213367",2006,884,512,372,467,180,287,56.05,0.5605,0.528,0.484
"10781","213385",2006,629,290,339,561,299,262,90.34,0.9034,0.892,0.882
"10782","213507",2006,447,241,206,300,114,186,77.18,0.7718,0.671,0.553
"10783","213543",2006,1217,511,706,950,523,427,83.56,0.8356,0.781,0.741
"10784","213613",2006,1079,608,471,266,106,160,26.32,0.2632,0.247,0.225
"10785","213668",2006,375,193,182,213,87,126,65.28,0.6528,0.568,0.478
"10786","213783",2006,603,356,247,172,53,119,33.43,0.3343,0.285,0.215
"10787","213826",2006,383,278,105,197,42,155,55.76,0.5576,0.514,0.4
"10788","213996",2006,735,471,264,529,179,350,74.31,0.7431,0.72,0.678
"10789","214041",2006,1342,792,550,482,154,328,41.41,0.4141,0.359,0.28
"10790","214069",2006,308,192,116,165,57,108,56.25,0.5625,0.536,0.491
"10791","214157",2006,375,223,152,268,108,160,71.75,0.7175,0.715,0.711
"10792","214175",2006,615,376,239,503,185,318,84.57,0.8457,0.818,0.774
"10793","214272",2006,544,325,219,160,46,114,35.08,0.3508,0.294,0.21
"10794","214777",2006,8016,3790,4226,5243,2460,2783,73.43,0.7343,0.654,0.582
"10795","215062",2006,2334,1193,1141,2036,952,1084,90.86,0.9086,0.872,0.834
"10796","215743",2006,384,234,150,194,66,128,54.7,0.547,0.505,0.44
"10797","215798",2006,437,217,220,272,133,139,64.06,0.6406,0.622,0.605
"10798","215929",2006,980,585,395,740,289,451,77.09,0.7709,0.755,0.732
"10799","216010",2006,1496,778,718,601,215,386,49.61,0.4961,0.402,0.299
"10800","216038",2006,1416,832,584,545,185,360,43.27,0.4327,0.385,0.317
"10801","216287",2006,370,193,177,318,143,175,90.67,0.9067,0.859,0.808
"10802","216339",2006,3848,2105,1743,1377,578,799,37.96,0.3796,0.358,0.332
"10803","216524",2006,405,217,188,287,126,161,74.19,0.7419,0.709,0.67
"10804","216694",2006,322,172,150,174,69,105,61.05,0.6105,0.54,0.46
"10805","216764",2006,1883,1200,683,803,196,607,50.58,0.5058,0.426,0.287
"10806","216807",2006,311,180,131,225,87,138,76.67,0.7667,0.723,0.664
"10807","216852",2006,740,354,386,317,135,182,51.41,0.5141,0.428,0.35
"10808","216931",2006,570,285,285,279,133,146,51.23,0.5123,0.489,0.467
"10809","217059",2006,1092,536,556,452,207,245,45.71,0.4571,0.414,0.372
"10810","217156",2006,1464,740,724,1215,590,625,84.46,0.8446,0.83,0.815
"10811","217402",2006,1023,585,438,860,351,509,87.01,0.8701,0.841,0.801
"10812","217536",2006,568,394,174,390,113,277,70.3,0.703,0.687,0.649
"10813","217776",2006,150,86,64,61,28,33,38.37,0.3837,0.407,0.438
"10814","217819",2006,1959,1332,627,1132,315,817,61.34,0.6134,0.578,0.502
"10815","217882",2006,2755,1363,1392,1575,604,971,71.24,0.7124,0.572,0.434
"10816","217998",2006,178,100,78,101,34,67,67,0.67,0.567,0.436
"10817","218061",2006,795,519,276,142,34,108,20.81,0.2081,0.179,0.123
"10818","218229",2006,578,379,199,127,29,98,25.86,0.2586,0.22,0.146
"10819","218238",2006,206,87,119,39,17,22,25.29,0.2529,0.189,0.143
"10820","218399",2006,249,144,105,39,11,28,19.44,0.1944,0.157,0.105
"10821","218414",2006,264,116,148,65,24,41,35.34,0.3534,0.246,0.162
"10822","218663",2006,3646,2084,1562,1932,702,1230,59.02,0.5902,0.53,0.449
"10823","218724",2006,1466,810,656,420,144,276,34.07,0.3407,0.286,0.22
"10824","218733",2006,870,458,412,134,49,85,18.56,0.1856,0.154,0.119
"10825","218742",2006,781,497,284,166,42,124,24.95,0.2495,0.213,0.148
"10826","218973",2006,377,191,186,299,139,160,83.77,0.8377,0.793,0.747
"10827","219000",2006,442,282,160,228,64,164,58.16,0.5816,0.516,0.4
"10828","219046",2006,595,353,242,122,28,94,26.63,0.2663,0.205,0.116
"10829","219082",2006,295,137,158,41,23,18,13.14,0.1314,0.139,0.146
"10830","219198",2006,127,92,35,57,14,43,46.74,0.4674,0.449,0.4
"10831","219259",2006,367,178,189,50,14,36,20.22,0.2022,0.136,0.074
"10832","219356",2006,1833,922,911,484,173,311,33.73,0.3373,0.264,0.19
"10833","219471",2006,1109,674,435,237,88,149,22.11,0.2211,0.214,0.202
"10834","219602",2006,1210,731,479,188,56,132,18.06,0.1806,0.155,0.117
"10835","219709",2006,763,439,324,422,160,262,59.68,0.5968,0.553,0.494
"10836","219718",2006,243,94,149,26,13,13,13.83,0.1383,0.107,0.087
"10837","219949",2006,189,75,114,34,8,26,34.67,0.3467,0.18,0.07
"10838","220075",2006,1712,966,746,279,106,173,17.91,0.1791,0.163,0.142
"10839","220215",2006,358,206,152,145,48,97,47.09,0.4709,0.405,0.316
"10840","220613",2006,810,473,337,270,77,193,40.8,0.408,0.333,0.228
"10841","220631",2006,219,135,84,3,0,3,2.22,0.0222,0.014,0
"10842","220710",2006,298,163,135,123,49,74,45.4,0.454,0.413,0.363
"10843","221351",2006,451,272,179,363,141,222,81.62,0.8162,0.805,0.788
"10844","221519",2006,412,202,210,305,150,155,76.73,0.7673,0.74,0.714
"10845","221731",2006,160,88,72,42,10,32,36.36,0.3636,0.262,0.139
"10846","221847",2006,1515,653,862,301,127,174,26.65,0.2665,0.199,0.147
"10847","221892",2006,240,147,93,97,32,65,44.22,0.4422,0.404,0.344
"10848","222178",2006,961,526,435,394,147,247,46.96,0.4696,0.41,0.338
"10849","222983",2006,340,175,165,251,113,138,78.86,0.7886,0.738,0.685
"10850","223232",2006,2775,1713,1062,1550,494,1056,61.65,0.6165,0.559,0.465
"10851","224004",2006,191,89,102,37,16,21,23.6,0.236,0.194,0.157
"10852","224323",2006,315,169,146,189,82,107,63.31,0.6331,0.6,0.562
"10853","225432",2006,840,452,388,12,7,5,1.11,0.0111,0.014,0.018
"10854","225548",2006,318,130,188,109,46,63,48.46,0.4846,0.343,0.245
"10855","225627",2006,613,439,174,119,23,96,21.87,0.2187,0.194,0.132
"10856","226231",2006,309,88,221,130,75,55,62.5,0.625,0.421,0.339
"10857","226833",2006,657,355,302,108,33,75,21.13,0.2113,0.164,0.109
"10858","227216",2006,3599,2039,1560,784,252,532,26.09,0.2609,0.218,0.162
"10859","227331",2006,262,195,67,27,6,21,10.77,0.1077,0.103,0.09
"10860","227526",2006,1231,689,542,121,28,93,13.5,0.135,0.098,0.052
"10861","227757",2006,713,357,356,597,282,315,88.24,0.8824,0.837,0.792
"10862","227845",2006,698,423,275,372,144,228,53.9,0.539,0.533,0.524
"10863","227863",2006,291,187,104,93,26,67,35.83,0.3583,0.32,0.25
"10864","228042",2006,243,128,115,57,20,37,28.91,0.2891,0.235,0.174
"10865","228149",2006,548,347,201,187,39,148,42.65,0.4265,0.341,0.194
"10866","228246",2006,1369,753,616,937,377,560,74.37,0.7437,0.684,0.612
"10867","228343",2006,345,221,124,231,74,157,71.04,0.7104,0.67,0.597
"10868","228431",2006,2305,1420,885,538,132,406,28.59,0.2859,0.233,0.149
"10869","228459",2006,2975,1746,1229,815,250,565,32.36,0.3236,0.274,0.203
"10870","228501",2006,192,73,119,22,8,14,19.18,0.1918,0.115,0.067
"10871","228529",2006,1256,667,589,230,94,136,20.39,0.2039,0.183,0.16
"10872","228705",2006,731,297,434,95,32,63,21.21,0.2121,0.13,0.074
"10873","228723",2006,7472,3774,3698,3636,1358,2278,60.36,0.6036,0.487,0.367
"10874","228769",2006,1974,984,990,340,124,216,21.95,0.2195,0.172,0.125
"10875","228778",2006,7369,4008,3361,3731,1482,2249,56.11,0.5611,0.506,0.441
"10876","228787",2006,1053,394,659,470,252,218,55.33,0.5533,0.446,0.382
"10877","228796",2006,2446,1256,1190,269,95,174,13.85,0.1385,0.11,0.08
"10878","228875",2006,1654,985,669,950,328,622,63.15,0.6315,0.574,0.49
"10879","228981",2006,387,197,190,105,39,66,33.5,0.335,0.271,0.205
"10880","229018",2006,315,178,137,55,18,37,20.79,0.2079,0.175,0.131
"10881","229027",2006,4687,2389,2298,424,155,269,11.26,0.1126,0.09,0.067
"10882","229115",2006,3862,1844,2018,1427,601,826,44.79,0.4479,0.369,0.298
"10883","229780",2006,211,103,108,46,21,25,24.27,0.2427,0.218,0.194
"10884","229814",2006,920,489,431,223,73,150,30.67,0.3067,0.242,0.169
"10885","230603",2006,832,594,238,164,23,141,23.74,0.2374,0.197,0.097
"10886","230728",2006,2429,1574,855,498,102,396,25.16,0.2516,0.205,0.119
"10887","230764",2006,2037,1167,870,457,149,308,26.39,0.2639,0.224,0.171
"10888","230782",2006,1289,755,534,114,28,86,11.39,0.1139,0.088,0.052
"10889","231059",2006,576,333,243,446,192,254,76.28,0.7628,0.774,0.79
"10890","231174",2006,2175,1251,924,1417,551,866,69.22,0.6922,0.651,0.596
"10891","231420",2006,160,60,100,45,19,26,43.33,0.4333,0.281,0.19
"10892","231554",2006,106,59,47,19,5,14,23.73,0.2373,0.179,0.106
"10893","231624",2006,1341,693,648,1107,497,610,88.02,0.8802,0.826,0.767
"10894","231712",2006,1172,644,528,594,203,391,60.71,0.6071,0.507,0.384
"10895","232025",2006,267,115,152,84,36,48,41.74,0.4174,0.315,0.237
"10896","232043",2006,205,119,86,93,31,62,52.1,0.521,0.454,0.36
"10897","232089",2006,417,156,261,126,65,61,39.1,0.391,0.302,0.249
"10898","232186",2006,2390,1335,1055,992,355,637,47.72,0.4772,0.415,0.336
"10899","232265",2006,1098,700,398,447,119,328,46.86,0.4686,0.407,0.299
"10900","232423",2006,3745,2431,1314,2357,713,1644,67.63,0.6763,0.629,0.543
"10901","232557",2006,2028,1022,1006,489,209,280,27.4,0.274,0.241,0.208
"10902","232566",2006,985,627,358,411,111,300,47.85,0.4785,0.417,0.31
"10903","232609",2006,552,305,247,259,88,171,56.07,0.5607,0.469,0.356
"10904","232681",2006,909,614,295,625,180,445,72.48,0.7248,0.688,0.61
"10905","232706",2006,365,268,97,136,28,108,40.3,0.403,0.373,0.289
"10906","232937",2006,1023,638,385,130,34,96,15.05,0.1505,0.127,0.088
"10907","232982",2006,2059,1108,951,507,159,348,31.41,0.3141,0.246,0.167
"10908","233277",2006,1730,1045,685,730,252,478,45.74,0.4574,0.422,0.368
"10909","233374",2006,757,387,370,585,267,318,82.17,0.8217,0.773,0.722
"10910","233426",2006,503,296,207,285,104,181,61.15,0.6115,0.567,0.502
"10911","233541",2006,304,157,147,75,29,46,29.3,0.293,0.247,0.197
"10912","233897",2006,401,187,214,98,45,53,28.34,0.2834,0.244,0.21
"10913","233921",2006,5078,2273,2805,2953,1367,1586,69.78,0.6978,0.582,0.487
"10914","234030",2006,3445,1986,1459,1018,346,672,33.84,0.3384,0.296,0.237
"10915","234085",2006,387,34,353,216,200,16,47.06,0.4706,0.558,0.567
"10916","234155",2006,869,540,329,209,54,155,28.7,0.287,0.241,0.164
"10917","234164",2006,325,160,165,58,13,45,28.12,0.2812,0.178,0.079
"10918","235097",2006,1412,855,557,280,84,196,22.92,0.2292,0.198,0.151
"10919","235167",2006,577,300,277,227,103,124,41.33,0.4133,0.393,0.372
"10920","236230",2006,668,418,250,401,142,259,61.96,0.6196,0.6,0.568
"10921","236328",2006,677,406,271,464,173,291,71.67,0.7167,0.685,0.638
"10922","236577",2006,622,413,209,350,111,239,57.87,0.5787,0.563,0.531
"10923","236595",2006,731,463,268,455,165,290,62.63,0.6263,0.622,0.616
"10924","236896",2006,323,164,159,62,28,34,20.73,0.2073,0.192,0.176
"10925","236939",2006,2676,1349,1327,1040,417,623,46.18,0.4618,0.389,0.314
"10926","236948",2006,5284,2800,2484,2939,1245,1694,60.5,0.605,0.556,0.501
"10927","237011",2006,2425,1397,1028,850,293,557,39.87,0.3987,0.351,0.285
"10928","237057",2006,367,219,148,294,109,185,84.47,0.8447,0.801,0.736
"10929","237066",2006,469,285,184,303,115,188,65.96,0.6596,0.646,0.625
"10930","237215",2006,253,134,119,28,19,9,6.72,0.0672,0.111,0.16
"10931","237330",2006,593,306,287,102,37,65,21.24,0.2124,0.172,0.129
"10932","237358",2006,119,65,54,30,14,16,24.62,0.2462,0.252,0.259
"10933","237367",2006,642,345,297,84,35,49,14.2,0.142,0.131,0.118
"10934","237792",2006,688,395,293,135,40,95,24.05,0.2405,0.196,0.137
"10935","237899",2006,341,170,171,24,8,16,9.41,0.0941,0.07,0.047
"10936","237932",2006,476,269,207,84,28,56,20.82,0.2082,0.176,0.135
"10937","237969",2006,291,167,124,117,39,78,46.71,0.4671,0.402,0.315
"10938","238032",2006,4777,2151,2626,1596,746,850,39.52,0.3952,0.334,0.284
"10939","238333",2006,347,207,140,243,94,149,71.98,0.7198,0.7,0.671
"10940","238430",2006,245,168,77,19,6,13,7.74,0.0774,0.078,0.078
"10941","238458",2006,675,485,190,284,58,226,46.6,0.466,0.421,0.305
"10942","238476",2006,653,368,285,337,136,201,54.62,0.5462,0.516,0.477
"10943","238616",2006,391,214,177,135,53,82,38.32,0.3832,0.345,0.299
"10944","238661",2006,293,220,73,101,21,80,36.36,0.3636,0.345,0.288
"10945","239080",2006,245,172,73,61,15,46,26.74,0.2674,0.249,0.205
"10946","239105",2006,1842,1025,817,1096,445,651,63.51,0.6351,0.595,0.545
"10947","239628",2006,264,154,110,153,57,96,62.34,0.6234,0.58,0.518
"10948","239716",2006,551,305,246,356,140,216,70.82,0.7082,0.646,0.569
"10949","240107",2006,308,223,85,100,21,79,35.43,0.3543,0.325,0.247
"10950","240189",2006,1780,836,944,533,233,300,35.89,0.3589,0.299,0.247
"10951","240277",2006,1019,667,352,226,63,163,24.44,0.2444,0.222,0.179
"10952","240329",2006,1751,1098,653,633,190,443,40.35,0.4035,0.362,0.291
"10953","240338",2006,198,116,82,81,31,50,43.1,0.431,0.409,0.378
"10954","240365",2006,1726,1024,702,272,83,189,18.46,0.1846,0.158,0.118
"10955","240374",2006,814,442,372,60,18,42,9.5,0.095,0.074,0.048
"10956","240417",2006,1507,792,715,275,90,185,23.36,0.2336,0.182,0.126
"10957","240426",2006,293,143,150,53,26,27,18.88,0.1888,0.181,0.173
"10958","240444",2006,5633,3033,2600,2965,1202,1763,58.13,0.5813,0.526,0.462
"10959","240453",2006,3977,2064,1913,554,247,307,14.87,0.1487,0.139,0.129
"10960","240462",2006,1387,467,920,259,145,114,24.41,0.2441,0.187,0.158
"10961","240471",2006,1289,773,516,281,77,204,26.39,0.2639,0.218,0.149
"10962","240480",2006,1640,888,752,395,153,242,27.25,0.2725,0.241,0.203
"10963","240727",2006,1543,761,782,359,118,241,31.67,0.3167,0.233,0.151
"10964","243443",2006,764,532,232,66,13,53,9.96,0.0996,0.086,0.056
"10965","243780",2006,7430,3019,4411,2764,1350,1414,46.84,0.4684,0.372,0.306
"10966","100654",2007,882,475,407,88,21,67,14.11,0.1411,0.1,0.052
"10967","100663",2007,1378,807,571,404,137,267,33.09,0.3309,0.293,0.24
"10968","100751",2007,4438,2461,1977,1897,708,1189,48.31,0.4831,0.427,0.358
"10969","100858",2007,4165,2207,1958,1565,548,1017,46.08,0.4608,0.376,0.28
"10970","101435",2007,257,117,140,78,23,55,47.01,0.4701,0.304,0.164
"10971","101480",2007,1252,696,556,127,44,83,11.93,0.1193,0.101,0.079
"10972","101675",2007,486,246,240,29,7,22,8.94,0.0894,0.06,0.029
"10973","101879",2007,1023,558,465,126,31,95,17.03,0.1703,0.123,0.067
"10974","102049",2007,711,459,252,348,112,236,51.42,0.5142,0.489,0.444
"10975","102094",2007,1457,801,656,200,68,132,16.48,0.1648,0.137,0.104
"10976","102234",2007,380,243,137,179,65,114,46.91,0.4691,0.471,0.474
"10977","102368",2007,1763,1011,752,222,75,147,14.54,0.1454,0.126,0.1
"10978","102377",2007,796,444,352,133,31,102,22.97,0.2297,0.167,0.088
"10979","104151",2007,7308,3775,3533,2753,1126,1627,43.1,0.431,0.377,0.319
"10980","104179",2007,6231,3395,2836,2485,976,1509,44.45,0.4445,0.399,0.344
"10981","105330",2007,2880,1676,1204,868,261,607,36.22,0.3622,0.301,0.217
"10982","106245",2007,812,471,341,57,28,29,6.16,0.0616,0.07,0.082
"10983","106342",2007,143,84,59,62,19,43,51.19,0.5119,0.434,0.322
"10984","106397",2007,2877,1425,1452,1055,456,599,42.04,0.4204,0.367,0.314
"10985","106412",2007,786,411,375,44,10,34,8.27,0.0827,0.056,0.027
"10986","106458",2007,1655,962,693,309,102,207,21.52,0.2152,0.187,0.147
"10987","106467",2007,1548,762,786,278,131,147,19.29,0.1929,0.18,0.167
"10988","106485",2007,617,303,314,52,19,33,10.89,0.1089,0.084,0.061
"10989","106704",2007,1763,1054,709,362,118,244,23.15,0.2315,0.205,0.166
"10990","107044",2007,960,549,411,388,124,264,48.09,0.4809,0.404,0.302
"10991","107080",2007,365,194,171,231,99,132,68.04,0.6804,0.633,0.579
"10992","107141",2007,361,206,155,200,81,119,57.77,0.5777,0.554,0.523
"10993","107512",2007,372,202,170,179,60,119,58.91,0.5891,0.481,0.353
"10994","107558",2007,178,102,76,61,17,44,43.14,0.4314,0.343,0.224
"10995","110097",2007,789,514,275,385,118,267,51.95,0.5195,0.488,0.429
"10996","110404",2007,231,86,145,190,117,73,84.88,0.8488,0.823,0.807
"10997","110422",2007,4419,1885,2534,1282,460,822,43.61,0.4361,0.29,0.182
"10998","110486",2007,859,578,281,129,25,104,17.99,0.1799,0.15,0.089
"10999","110495",2007,910,592,318,166,34,132,22.3,0.223,0.182,0.107
"11000","110510",2007,1656,1098,558,156,43,113,10.29,0.1029,0.094,0.077
"11001","110529",2007,3414,1459,1955,343,118,225,15.42,0.1542,0.1,0.06
"11002","110538",2007,2710,1418,1292,458,138,320,22.57,0.2257,0.169,0.107
"11003","110547",2007,913,602,311,35,11,24,3.99,0.0399,0.038,0.035
"11004","110556",2007,2552,1526,1026,350,112,238,15.6,0.156,0.137,0.109
"11005","110565",2007,4040,2430,1610,550,135,415,17.08,0.1708,0.136,0.084
"11006","110574",2007,1032,602,430,111,49,62,10.3,0.103,0.108,0.114
"11007","110583",2007,4134,2620,1514,581,166,415,15.84,0.1584,0.141,0.11
"11008","110592",2007,1767,1106,661,119,40,79,7.14,0.0714,0.067,0.061
"11009","110617",2007,2357,1426,931,194,64,130,9.12,0.0912,0.082,0.069
"11010","113698",2007,297,225,72,107,23,84,37.33,0.3733,0.36,0.319
"11011","115755",2007,1039,551,488,112,39,73,13.25,0.1325,0.108,0.08
"11012","119173",2007,348,331,17,93,7,86,25.98,0.2598,0.267,0.412
"11013","120184",2007,96,57,39,35,12,23,40.35,0.4035,0.365,0.308
"11014","121309",2007,530,336,194,327,109,218,64.88,0.6488,0.617,0.562
"11015","121345",2007,375,188,187,348,172,176,93.62,0.9362,0.928,0.92
"11016","122409",2007,4506,2685,1821,1472,449,1023,38.1,0.381,0.327,0.247
"11017","122436",2007,1089,635,454,704,254,450,70.87,0.7087,0.646,0.559
"11018","122597",2007,3341,2123,1218,424,118,306,14.41,0.1441,0.127,0.097
"11019","122612",2007,1052,680,372,595,179,416,61.18,0.6118,0.566,0.481
"11020","122931",2007,1201,619,582,923,431,492,79.48,0.7948,0.769,0.741
"11021","123554",2007,600,366,234,283,102,181,49.45,0.4945,0.472,0.436
"11022","123572",2007,1673,1073,600,434,97,337,31.41,0.3141,0.259,0.162
"11023","126562",2007,1010,571,439,163,66,97,16.99,0.1699,0.161,0.15
"11024","126580",2007,933,511,422,247,89,158,30.92,0.3092,0.265,0.211
"11025","126614",2007,5540,2734,2806,2456,1059,1397,51.1,0.511,0.443,0.377
"11026","126818",2007,4352,2387,1965,1609,564,1045,43.78,0.4378,0.37,0.287
"11027","127060",2007,1130,619,511,752,321,431,69.63,0.6963,0.665,0.628
"11028","127185",2007,863,404,459,149,50,99,24.5,0.245,0.173,0.109
"11029","127565",2007,1910,1036,874,108,38,70,6.76,0.0676,0.057,0.043
"11030","127741",2007,2199,1328,871,583,149,434,32.68,0.3268,0.265,0.171
"11031","128106",2007,602,308,294,109,41,68,22.08,0.2208,0.181,0.139
"11032","128744",2007,331,209,122,62,17,45,21.53,0.2153,0.187,0.139
"11033","128771",2007,1466,676,790,294,133,161,23.82,0.2382,0.201,0.168
"11034","129020",2007,3160,1682,1478,2136,921,1215,72.24,0.7224,0.676,0.623
"11035","129242",2007,842,496,346,664,268,396,79.84,0.7984,0.789,0.775
"11036","129941",2007,700,331,369,296,138,158,47.73,0.4773,0.423,0.374
"11037","130253",2007,956,580,376,606,220,386,66.55,0.6655,0.634,0.585
"11038","130314",2007,165,165,0,61,0,61,36.97,0.3697,0.37,NA
"11039","130493",2007,1333,884,449,239,56,183,20.7,0.207,0.179,0.125
"11040","130590",2007,576,292,284,469,224,245,83.9,0.839,0.814,0.789
"11041","130697",2007,733,377,356,632,305,327,86.74,0.8674,0.862,0.857
"11042","130776",2007,913,494,419,190,77,113,22.87,0.2287,0.208,0.184
"11043","130794",2007,1313,661,652,1177,578,599,90.62,0.9062,0.896,0.887
"11044","130934",2007,799,495,304,145,37,108,21.82,0.2182,0.181,0.122
"11045","130943",2007,3912,2305,1607,2445,879,1566,67.94,0.6794,0.625,0.547
"11046","131159",2007,1288,840,448,975,334,641,76.31,0.7631,0.757,0.746
"11047","131283",2007,864,451,413,535,233,302,66.96,0.6696,0.619,0.564
"11048","131450",2007,174,97,77,27,9,18,18.56,0.1856,0.155,0.117
"11049","131469",2007,2123,1198,925,1604,668,936,78.13,0.7813,0.756,0.722
"11050","131496",2007,1577,864,713,1387,616,771,89.24,0.8924,0.88,0.864
"11051","131520",2007,1451,1028,423,574,129,445,43.29,0.4329,0.396,0.305
"11052","132471",2007,472,316,156,102,28,74,23.42,0.2342,0.216,0.179
"11053","132602",2007,821,511,310,136,44,92,18,0.18,0.166,0.142
"11054","132903",2007,6350,3310,3040,2277,827,1450,43.81,0.4381,0.359,0.272
"11055","133492",2007,535,319,216,315,127,188,58.93,0.5893,0.589,0.588
"11056","133553",2007,1014,158,856,341,277,64,40.51,0.4051,0.336,0.324
"11057","133650",2007,1853,1071,782,217,74,143,13.35,0.1335,0.117,0.095
"11058","133669",2007,2563,1326,1237,388,150,238,17.95,0.1795,0.151,0.121
"11059","133711",2007,531,333,198,246,85,161,48.35,0.4835,0.463,0.429
"11060","133881",2007,675,186,489,261,170,91,48.92,0.4892,0.387,0.348
"11061","133951",2007,3230,1707,1523,661,209,452,26.48,0.2648,0.205,0.137
"11062","134079",2007,423,259,164,199,77,122,47.1,0.471,0.47,0.47
"11063","134097",2007,6104,3436,2668,3458,1266,2192,63.8,0.638,0.567,0.475
"11064","134130",2007,6440,3792,2648,4197,1467,2730,71.99,0.7199,0.652,0.554
"11065","134945",2007,581,274,307,141,60,81,29.56,0.2956,0.243,0.195
"11066","135726",2007,1977,1049,928,1400,606,794,75.69,0.7569,0.708,0.653
"11067","136172",2007,2048,1185,863,435,151,284,23.97,0.2397,0.212,0.175
"11068","136950",2007,525,305,220,319,124,195,63.93,0.6393,0.608,0.564
"11069","137546",2007,557,322,235,314,121,193,59.94,0.5994,0.564,0.515
"11070","138354",2007,912,511,401,184,57,127,24.85,0.2485,0.202,0.142
"11071","138716",2007,626,401,225,100,17,83,20.7,0.207,0.16,0.076
"11072","138789",2007,793,477,316,77,16,61,12.79,0.1279,0.097,0.051
"11073","139144",2007,537,373,164,269,75,194,52.01,0.5201,0.501,0.457
"11074","139366",2007,996,568,428,117,29,88,15.49,0.1549,0.117,0.068
"11075","139393",2007,291,163,128,139,51,88,53.99,0.5399,0.478,0.398
"11076","139658",2007,1597,863,734,1027,477,550,63.73,0.6373,0.643,0.65
"11077","139719",2007,716,386,330,56,12,44,11.4,0.114,0.078,0.036
"11078","139755",2007,2622,854,1768,1072,645,427,50,0.5,0.409,0.365
"11079","139764",2007,388,252,136,59,16,43,17.06,0.1706,0.152,0.118
"11080","139861",2007,1197,778,419,464,124,340,43.7,0.437,0.388,0.296
"11081","139931",2007,3028,1402,1626,773,287,486,34.66,0.3466,0.255,0.177
"11082","139940",2007,2521,1486,1035,540,154,386,25.98,0.2598,0.214,0.149
"11083","139959",2007,4675,2942,1733,2655,853,1802,61.25,0.6125,0.568,0.492
"11084","140447",2007,602,337,265,265,87,178,52.82,0.5282,0.44,0.328
"11085","140960",2007,612,343,269,51,10,41,11.95,0.1195,0.083,0.037
"11086","140988",2007,276,131,145,91,35,56,42.75,0.4275,0.33,0.241
"11087","141185",2007,218,128,90,75,28,47,36.72,0.3672,0.344,0.311
"11088","141264",2007,2029,1233,796,316,86,230,18.65,0.1865,0.156,0.108
"11089","141334",2007,1803,1051,752,311,93,218,20.74,0.2074,0.172,0.124
"11090","141486",2007,242,156,86,65,18,47,30.13,0.3013,0.269,0.209
"11091","141565",2007,497,299,198,41,11,30,10.03,0.1003,0.082,0.056
"11092","141574",2007,1727,946,781,322,111,211,22.3,0.223,0.186,0.142
"11093","142276",2007,998,526,472,88,26,62,11.79,0.1179,0.088,0.055
"11094","142285",2007,1615,764,851,402,173,229,29.97,0.2997,0.249,0.203
"11095","142461",2007,220,139,81,70,22,48,34.53,0.3453,0.318,0.272
"11096","143084",2007,713,418,295,525,199,326,77.99,0.7799,0.736,0.675
"11097","143288",2007,175,93,82,59,23,36,38.71,0.3871,0.337,0.28
"11098","144005",2007,372,255,117,15,4,11,4.31,0.0431,0.04,0.034
"11099","144281",2007,2166,1148,1018,692,313,379,33.01,0.3301,0.319,0.307
"11100","144740",2007,2513,1458,1055,1363,522,841,57.68,0.5768,0.542,0.495
"11101","144892",2007,1641,988,653,551,171,380,38.46,0.3846,0.336,0.262
"11102","144962",2007,508,304,204,300,99,201,66.12,0.6612,0.591,0.485
"11103","144971",2007,122,73,49,53,15,38,52.05,0.5205,0.434,0.306
"11104","145600",2007,3272,1813,1459,978,390,588,32.43,0.3243,0.299,0.267
"11105","145619",2007,385,185,200,146,68,78,42.16,0.4216,0.379,0.34
"11106","145637",2007,6930,3295,3635,4722,2281,2441,74.08,0.7408,0.681,0.628
"11107","145691",2007,258,125,133,144,58,86,68.8,0.688,0.558,0.436
"11108","145813",2007,3140,1887,1253,1457,455,1002,53.1,0.531,0.464,0.363
"11109","146481",2007,356,214,142,208,75,133,62.15,0.6215,0.584,0.528
"11110","146612",2007,634,365,269,283,131,152,41.64,0.4164,0.446,0.487
"11111","146719",2007,2035,1377,658,1215,371,844,61.29,0.6129,0.597,0.564
"11112","146825",2007,125,73,52,35,3,32,43.84,0.4384,0.28,0.058
"11113","147013",2007,298,131,167,94,42,52,39.69,0.3969,0.315,0.251
"11114","147244",2007,475,268,207,228,91,137,51.12,0.5112,0.48,0.44
"11115","147341",2007,393,213,180,223,90,133,62.44,0.6244,0.567,0.5
"11116","147703",2007,2997,1584,1413,793,353,440,27.78,0.2778,0.265,0.25
"11117","147767",2007,1979,1057,922,1705,770,935,88.46,0.8846,0.862,0.835
"11118","147776",2007,870,506,364,36,9,27,5.34,0.0534,0.041,0.025
"11119","147828",2007,704,384,320,343,135,208,54.17,0.5417,0.487,0.422
"11120","148131",2007,234,104,130,92,42,50,48.08,0.4808,0.393,0.323
"11121","148496",2007,366,265,101,184,43,141,53.21,0.5321,0.503,0.426
"11122","148584",2007,198,124,74,63,18,45,36.29,0.3629,0.318,0.243
"11123","148627",2007,507,342,165,152,50,102,29.82,0.2982,0.3,0.303
"11124","149222",2007,2541,1127,1414,582,268,314,27.86,0.2786,0.229,0.19
"11125","149231",2007,1833,1026,807,509,179,330,32.16,0.3216,0.278,0.222
"11126","149772",2007,1943,952,991,572,258,314,32.98,0.3298,0.294,0.26
"11127","149781",2007,580,292,288,432,216,216,73.97,0.7397,0.745,0.75
"11128","150066",2007,479,239,240,216,90,126,52.72,0.5272,0.451,0.375
"11129","150136",2007,3747,2033,1714,1223,432,791,38.91,0.3891,0.326,0.252
"11130","150145",2007,249,159,90,106,33,73,45.91,0.4591,0.426,0.367
"11131","150163",2007,987,613,374,502,157,345,56.28,0.5628,0.509,0.42
"11132","150400",2007,664,369,295,493,211,282,76.42,0.7642,0.742,0.715
"11133","150534",2007,651,375,276,344,129,215,57.33,0.5733,0.528,0.467
"11134","150668",2007,202,114,88,110,44,66,57.89,0.5789,0.545,0.5
"11135","150941",2007,244,138,106,138,63,75,54.35,0.5435,0.566,0.594
"11136","151102",2007,1804,942,862,91,33,58,6.16,0.0616,0.05,0.038
"11137","151111",2007,2737,1659,1078,392,144,248,14.95,0.1495,0.143,0.134
"11138","151306",2007,2074,1209,865,299,74,225,18.61,0.1861,0.144,0.086
"11139","151324",2007,1820,924,896,375,138,237,25.65,0.2565,0.206,0.154
"11140","151333",2007,381,234,147,27,6,21,8.97,0.0897,0.071,0.041
"11141","151342",2007,876,524,352,44,26,18,3.44,0.0344,0.05,0.074
"11142","151351",2007,7167,3707,3460,4169,1874,2295,61.91,0.6191,0.582,0.542
"11143","151360",2007,556,356,200,38,13,25,7.02,0.0702,0.068,0.065
"11144","151379",2007,783,449,334,69,21,48,10.69,0.1069,0.088,0.063
"11145","151388",2007,264,157,107,22,4,18,11.46,0.1146,0.083,0.037
"11146","151777",2007,316,147,169,126,55,71,48.3,0.483,0.399,0.325
"11147","151786",2007,271,142,129,76,23,53,37.32,0.3732,0.28,0.178
"11148","152080",2007,1984,948,1036,1782,913,869,91.67,0.9167,0.898,0.881
"11149","152248",2007,1220,630,590,104,40,64,10.16,0.1016,0.085,0.068
"11150","152363",2007,300,138,162,107,50,57,41.3,0.413,0.357,0.309
"11151","152530",2007,472,272,200,306,129,177,65.07,0.6507,0.648,0.645
"11152","152600",2007,713,370,343,413,193,220,59.46,0.5946,0.579,0.563
"11153","153001",2007,226,122,104,97,35,62,50.82,0.5082,0.429,0.337
"11154","153108",2007,422,219,203,260,111,149,68.04,0.6804,0.616,0.547
"11155","153269",2007,923,557,366,484,170,314,56.37,0.5637,0.524,0.464
"11156","153384",2007,426,233,193,344,152,192,82.4,0.824,0.808,0.788
"11157","153603",2007,4307,1920,2387,1622,682,940,48.96,0.4896,0.377,0.286
"11158","153834",2007,659,374,285,439,177,262,70.05,0.7005,0.666,0.621
"11159","154095",2007,1922,1177,745,708,237,471,40.02,0.4002,0.368,0.318
"11160","155089",2007,139,72,67,14,7,7,9.72,0.0972,0.101,0.104
"11161","155317",2007,4028,2084,1944,1444,582,862,41.36,0.4136,0.358,0.299
"11162","155335",2007,133,72,61,44,13,31,43.06,0.4306,0.331,0.213
"11163","155399",2007,3301,1629,1672,843,290,553,33.95,0.3395,0.255,0.173
"11164","155520",2007,217,109,108,89,33,56,51.38,0.5138,0.41,0.306
"11165","155627",2007,161,79,82,35,11,24,30.38,0.3038,0.217,0.134
"11166","155937",2007,165,70,95,50,25,25,35.71,0.3571,0.303,0.263
"11167","156213",2007,311,173,138,175,65,110,63.58,0.6358,0.563,0.471
"11168","156286",2007,567,351,216,304,97,207,58.97,0.5897,0.536,0.449
"11169","156295",2007,420,252,168,197,72,125,49.6,0.496,0.469,0.429
"11170","156365",2007,377,168,209,98,47,51,30.36,0.3036,0.26,0.225
"11171","156541",2007,481,217,264,115,45,70,32.26,0.3226,0.239,0.17
"11172","156745",2007,366,206,160,180,59,121,58.74,0.5874,0.492,0.369
"11173","157058",2007,602,343,259,39,5,34,9.91,0.0991,0.065,0.019
"11174","157076",2007,280,120,160,69,27,42,35,0.35,0.246,0.169
"11175","157085",2007,3826,2006,1820,1276,498,778,38.78,0.3878,0.334,0.274
"11176","157289",2007,2525,1314,1211,634,262,372,28.31,0.2831,0.251,0.216
"11177","157386",2007,1445,803,642,257,87,170,21.17,0.2117,0.178,0.136
"11178","157401",2007,1393,835,558,397,128,269,32.22,0.3222,0.285,0.229
"11179","157447",2007,1896,1068,828,253,84,169,15.82,0.1582,0.133,0.101
"11180","157535",2007,233,103,130,35,15,20,19.42,0.1942,0.15,0.115
"11181","157951",2007,3013,1716,1297,610,197,413,24.07,0.2407,0.202,0.152
"11182","158477",2007,200,114,86,97,35,62,54.39,0.5439,0.485,0.407
"11183","159009",2007,1184,610,574,83,24,59,9.67,0.0967,0.07,0.042
"11184","159391",2007,4585,2415,2170,1737,658,1079,44.68,0.4468,0.379,0.303
"11185","159647",2007,1522,704,818,432,180,252,35.8,0.358,0.284,0.22
"11186","159717",2007,1247,717,530,163,55,108,15.06,0.1506,0.131,0.104
"11187","159966",2007,1156,696,460,196,59,137,19.68,0.1968,0.17,0.128
"11188","160038",2007,1281,812,469,223,69,154,18.97,0.1897,0.174,0.147
"11189","160612",2007,2524,1458,1066,336,102,234,16.05,0.1605,0.133,0.096
"11190","160621",2007,1178,658,520,95,18,77,11.7,0.117,0.081,0.035
"11191","160658",2007,2691,1554,1137,361,111,250,16.09,0.1609,0.134,0.098
"11192","161004",2007,475,250,225,416,196,220,88,0.88,0.876,0.871
"11193","161226",2007,479,327,152,181,45,136,41.59,0.4159,0.378,0.296
"11194","161235",2007,110,60,50,36,18,18,30,0.3,0.327,0.36
"11195","161244",2007,110,72,38,15,6,9,12.5,0.125,0.136,0.158
"11196","161253",2007,1816,863,953,648,301,347,40.21,0.4021,0.357,0.316
"11197","161554",2007,900,499,401,87,32,55,11.02,0.1102,0.097,0.08
"11198","162007",2007,820,506,314,106,19,87,17.19,0.1719,0.129,0.061
"11199","162210",2007,126,83,43,22,5,17,20.48,0.2048,0.175,0.116
"11200","162283",2007,555,421,134,23,9,14,3.33,0.0333,0.041,0.067
"11201","162584",2007,1057,520,537,233,92,141,27.12,0.2712,0.22,0.171
"11202","162654",2007,399,277,122,236,67,169,61.01,0.6101,0.591,0.549
"11203","162760",2007,295,193,102,163,48,115,59.59,0.5959,0.553,0.471
"11204","162928",2007,1260,607,653,1095,545,550,90.61,0.9061,0.869,0.835
"11205","163046",2007,979,545,434,777,320,457,83.85,0.8385,0.794,0.737
"11206","163268",2007,1423,655,768,523,230,293,44.73,0.4473,0.368,0.299
"11207","163286",2007,4229,2028,2201,2772,1300,1472,72.58,0.7258,0.655,0.591
"11208","163453",2007,1286,698,588,143,42,101,14.47,0.1447,0.111,0.071
"11209","163462",2007,448,256,192,275,114,161,62.89,0.6289,0.614,0.594
"11210","163851",2007,1142,646,496,533,172,361,55.88,0.5588,0.467,0.347
"11211","163912",2007,464,256,208,331,134,197,76.95,0.7695,0.713,0.644
"11212","164076",2007,2649,1670,979,1069,314,755,45.21,0.4521,0.404,0.321
"11213","164173",2007,604,436,168,254,61,193,44.27,0.4427,0.421,0.363
"11214","164216",2007,324,197,127,210,69,141,71.57,0.7157,0.648,0.543
"11215","164270",2007,439,226,213,279,118,161,71.24,0.7124,0.636,0.554
"11216","164447",2007,390,202,188,111,55,56,27.72,0.2772,0.285,0.293
"11217","164492",2007,258,137,121,112,45,67,48.91,0.4891,0.434,0.372
"11218","164562",2007,594,331,263,417,176,241,72.81,0.7281,0.702,0.669
"11219","165015",2007,701,391,310,604,264,340,86.96,0.8696,0.862,0.852
"11220","165024",2007,1551,935,616,445,139,306,32.73,0.3273,0.287,0.226
"11221","165334",2007,572,361,211,432,157,275,76.18,0.7618,0.755,0.744
"11222","165662",2007,842,477,365,671,274,397,83.23,0.8323,0.797,0.751
"11223","165671",2007,582,436,146,299,74,225,51.61,0.5161,0.514,0.507
"11224","165820",2007,698,366,332,142,56,86,23.5,0.235,0.203,0.169
"11225","165866",2007,633,420,213,212,52,160,38.1,0.381,0.335,0.244
"11226","165936",2007,454,286,168,264,95,169,59.09,0.5909,0.581,0.565
"11227","166027",2007,1657,839,818,1434,695,739,88.08,0.8808,0.865,0.85
"11228","166124",2007,718,398,320,639,272,367,92.21,0.9221,0.89,0.85
"11229","166513",2007,1220,424,796,346,179,167,39.39,0.3939,0.284,0.225
"11230","166629",2007,4374,2321,2053,2504,1060,1444,62.21,0.6221,0.572,0.516
"11231","166638",2007,950,558,392,144,42,102,18.28,0.1828,0.152,0.107
"11232","166683",2007,1068,492,576,892,463,429,87.2,0.872,0.835,0.804
"11233","167288",2007,334,207,127,128,37,91,43.96,0.4396,0.383,0.291
"11234","167987",2007,1901,859,1042,575,262,313,36.44,0.3644,0.302,0.251
"11235","167996",2007,659,409,250,539,199,340,83.13,0.8313,0.818,0.796
"11236","168005",2007,1308,752,556,531,218,313,41.62,0.4162,0.406,0.392
"11237","168148",2007,1370,703,667,1194,570,624,88.76,0.8876,0.872,0.855
"11238","168254",2007,713,293,420,372,193,179,61.09,0.6109,0.522,0.46
"11239","168281",2007,418,262,156,297,98,199,75.95,0.7595,0.711,0.628
"11240","168342",2007,539,258,281,483,248,235,91.09,0.9109,0.896,0.883
"11241","168546",2007,500,258,242,322,144,178,68.99,0.6899,0.644,0.595
"11242","168786",2007,410,269,141,124,35,89,33.09,0.3309,0.302,0.248
"11243","169080",2007,1034,556,478,590,246,344,61.87,0.6187,0.571,0.515
"11244","169798",2007,2365,1345,1020,294,109,185,13.75,0.1375,0.124,0.107
"11245","169910",2007,2035,933,1102,182,79,103,11.04,0.1104,0.089,0.072
"11246","170082",2007,3446,2201,1245,1137,346,791,35.94,0.3594,0.33,0.278
"11247","170301",2007,819,495,324,554,199,355,71.72,0.7172,0.676,0.614
"11248","170532",2007,363,213,150,263,100,163,76.53,0.7653,0.725,0.667
"11249","170639",2007,469,230,239,66,35,31,13.48,0.1348,0.141,0.146
"11250","170976",2007,5955,3019,2936,4513,2063,2450,81.15,0.8115,0.758,0.703
"11251","171100",2007,7398,4099,3299,3666,1372,2294,55.96,0.5596,0.496,0.416
"11252","171128",2007,1215,287,928,275,197,78,27.18,0.2718,0.226,0.212
"11253","171137",2007,859,420,439,128,61,67,15.95,0.1595,0.149,0.139
"11254","171146",2007,594,346,248,56,16,40,11.56,0.1156,0.094,0.065
"11255","171599",2007,182,67,115,48,18,30,44.78,0.4478,0.264,0.157
"11256","172051",2007,1533,883,650,155,56,99,11.21,0.1121,0.101,0.086
"11257","172699",2007,3473,1750,1723,842,362,480,27.43,0.2743,0.242,0.21
"11258","173160",2007,597,370,227,374,126,248,67.03,0.6703,0.626,0.555
"11259","173258",2007,509,255,254,456,221,235,92.16,0.9216,0.896,0.87
"11260","173328",2007,201,112,89,61,20,41,36.61,0.3661,0.303,0.225
"11261","173647",2007,666,374,292,542,234,308,82.35,0.8235,0.814,0.801
"11262","173902",2007,485,270,215,411,176,235,87.04,0.8704,0.847,0.819
"11263","174066",2007,5256,2927,2329,2863,1182,1681,57.43,0.5743,0.545,0.508
"11264","174233",2007,2196,1100,1096,649,244,405,36.82,0.3682,0.296,0.223
"11265","174251",2007,358,205,153,180,65,115,56.1,0.561,0.503,0.425
"11266","174491",2007,526,315,211,264,99,165,52.38,0.5238,0.502,0.469
"11267","174792",2007,516,0,516,364,364,0,NA,NA,0.705,0.705
"11268","174844",2007,751,406,345,624,287,337,83,0.83,0.831,0.832
"11269","174899",2007,487,336,151,288,76,212,63.1,0.631,0.591,0.503
"11270","174914",2007,1313,672,641,822,365,457,68.01,0.6801,0.626,0.569
"11271","175342",2007,514,305,209,94,27,67,21.97,0.2197,0.183,0.129
"11272","175421",2007,241,134,107,60,15,45,33.58,0.3358,0.249,0.14
"11273","175616",2007,477,293,184,78,27,51,17.41,0.1741,0.164,0.147
"11274","175856",2007,919,541,378,153,41,112,20.7,0.207,0.166,0.108
"11275","175980",2007,296,154,142,175,75,100,64.94,0.6494,0.591,0.528
"11276","176017",2007,2434,1293,1141,885,328,557,43.08,0.4308,0.364,0.287
"11277","176035",2007,235,213,22,46,6,40,18.78,0.1878,0.196,0.273
"11278","176044",2007,485,256,229,51,15,36,14.06,0.1406,0.105,0.066
"11279","176080",2007,2262,1105,1157,699,274,425,38.46,0.3846,0.309,0.237
"11280","176406",2007,200,135,65,53,9,44,32.59,0.3259,0.265,0.138
"11281","176628",2007,114,79,35,30,5,25,31.65,0.3165,0.263,0.143
"11282","176947",2007,270,123,147,69,31,38,30.89,0.3089,0.256,0.211
"11283","176965",2007,1426,786,640,428,148,280,35.62,0.3562,0.3,0.231
"11284","177418",2007,193,110,83,5,1,4,3.64,0.0364,0.026,0.012
"11285","178059",2007,294,211,83,149,43,106,50.24,0.5024,0.507,0.518
"11286","178341",2007,766,416,350,110,29,81,19.47,0.1947,0.144,0.083
"11287","178387",2007,935,538,397,126,36,90,16.73,0.1673,0.135,0.091
"11288","178396",2007,4897,2672,2225,2305,829,1476,55.24,0.5524,0.471,0.373
"11289","178402",2007,916,568,348,188,59,129,22.71,0.2271,0.205,0.17
"11290","178411",2007,1018,208,810,257,180,77,37.02,0.3702,0.252,0.222
"11291","178420",2007,462,280,182,94,25,69,24.64,0.2464,0.203,0.137
"11292","178615",2007,1402,814,588,754,248,506,62.16,0.6216,0.538,0.422
"11293","179043",2007,367,230,137,222,81,141,61.3,0.613,0.605,0.591
"11294","179159",2007,1629,933,696,988,380,608,65.17,0.6517,0.607,0.546
"11295","179557",2007,1650,946,704,438,158,280,29.6,0.296,0.265,0.224
"11296","179566",2007,2610,1514,1096,796,263,533,35.2,0.352,0.305,0.24
"11297","179867",2007,1325,645,680,1169,593,576,89.3,0.893,0.882,0.872
"11298","179894",2007,483,278,205,224,80,144,51.8,0.518,0.464,0.39
"11299","179946",2007,223,95,128,115,57,58,61.05,0.6105,0.516,0.445
"11300","180179",2007,724,393,331,60,16,44,11.2,0.112,0.083,0.048
"11301","180461",2007,1852,791,1061,371,162,209,26.42,0.2642,0.2,0.153
"11302","180522",2007,186,69,117,19,12,7,10.14,0.1014,0.102,0.103
"11303","180984",2007,264,141,123,111,41,70,49.65,0.4965,0.42,0.333
"11304","181002",2007,947,577,370,638,254,384,66.55,0.6655,0.674,0.686
"11305","181020",2007,259,115,144,132,65,67,58.26,0.5826,0.51,0.451
"11306","181127",2007,302,117,185,131,70,61,52.14,0.5214,0.434,0.378
"11307","181215",2007,915,484,431,193,74,119,24.59,0.2459,0.211,0.172
"11308","181394",2007,1596,834,762,228,106,122,14.63,0.1463,0.143,0.139
"11309","181446",2007,438,272,166,239,74,165,60.66,0.6066,0.546,0.446
"11310","181464",2007,4214,2061,2153,1363,555,808,39.2,0.392,0.323,0.258
"11311","181534",2007,197,89,108,38,13,25,28.09,0.2809,0.193,0.12
"11312","181783",2007,654,364,290,162,48,114,31.32,0.3132,0.248,0.166
"11313","182281",2007,2780,1596,1184,406,117,289,18.11,0.1811,0.146,0.099
"11314","182290",2007,2226,1166,1060,349,131,218,18.7,0.187,0.157,0.124
"11315","182634",2007,353,240,113,169,44,125,52.08,0.5208,0.479,0.389
"11316","182795",2007,533,239,294,207,100,107,44.77,0.4477,0.388,0.34
"11317","183062",2007,1295,762,533,666,252,414,54.33,0.5433,0.514,0.473
"11318","183080",2007,1006,444,562,414,206,208,46.85,0.4685,0.412,0.367
"11319","183239",2007,568,300,268,404,169,235,78.33,0.7833,0.711,0.631
"11320","183822",2007,313,176,137,45,24,21,11.93,0.1193,0.144,0.175
"11321","183974",2007,275,175,100,154,54,100,57.14,0.5714,0.56,0.54
"11322","184348",2007,452,268,184,293,107,186,69.4,0.694,0.648,0.582
"11323","184603",2007,400,210,190,117,30,87,41.43,0.4143,0.292,0.158
"11324","184612",2007,294,213,81,72,18,54,25.35,0.2535,0.245,0.222
"11325","184782",2007,1226,506,720,561,301,260,51.38,0.5138,0.458,0.418
"11326","185129",2007,649,340,309,32,16,16,4.71,0.0471,0.049,0.052
"11327","185572",2007,944,538,406,393,165,228,42.38,0.4238,0.416,0.406
"11328","185590",2007,2068,1276,792,711,205,506,39.66,0.3966,0.344,0.259
"11329","185828",2007,730,148,582,171,117,54,36.49,0.3649,0.234,0.201
"11330","186131",2007,1243,593,650,1091,553,538,90.73,0.9073,0.878,0.851
"11331","186201",2007,898,519,379,527,181,346,66.67,0.6667,0.587,0.478
"11332","186283",2007,990,569,421,547,201,346,60.81,0.6081,0.553,0.477
"11333","186584",2007,1256,664,592,631,277,354,53.31,0.5331,0.502,0.468
"11334","186876",2007,794,480,314,335,93,242,50.42,0.5042,0.422,0.296
"11335","187134",2007,1297,774,523,940,334,606,78.29,0.7829,0.725,0.639
"11336","187444",2007,1299,642,657,211,89,122,19,0.19,0.162,0.135
"11337","187985",2007,2850,1637,1213,415,147,268,16.37,0.1637,0.146,0.121
"11338","188030",2007,2105,1123,982,329,94,235,20.93,0.2093,0.156,0.096
"11339","188429",2007,883,603,280,464,134,330,54.73,0.5473,0.525,0.479
"11340","188641",2007,518,239,279,231,107,124,51.88,0.5188,0.446,0.384
"11341","190044",2007,682,189,493,418,289,129,68.25,0.6825,0.613,0.586
"11342","190099",2007,744,382,362,644,297,347,90.84,0.9084,0.866,0.82
"11343","190150",2007,1371,671,700,1173,586,587,87.48,0.8748,0.856,0.837
"11344","190248",2007,127,76,51,35,9,26,34.21,0.3421,0.276,0.176
"11345","190415",2007,3005,1454,1551,2601,1285,1316,90.51,0.9051,0.866,0.828
"11346","190512",2007,1470,695,775,578,259,319,45.9,0.459,0.393,0.334
"11347","190549",2007,1300,743,557,305,103,202,27.19,0.2719,0.235,0.185
"11348","190558",2007,2273,1272,1001,122,48,74,5.82,0.0582,0.054,0.048
"11349","190567",2007,1771,916,855,166,65,101,11.03,0.1103,0.094,0.076
"11350","190594",2007,1854,1226,628,402,89,313,25.53,0.2553,0.217,0.142
"11351","190637",2007,874,610,264,129,35,94,15.41,0.1541,0.148,0.133
"11352","190664",2007,1755,1064,691,440,112,328,30.83,0.3083,0.251,0.162
"11353","190691",2007,983,636,347,50,11,39,6.13,0.0613,0.051,0.032
"11354","190725",2007,361,268,93,99,19,80,29.85,0.2985,0.274,0.204
"11355","191241",2007,1760,910,850,1338,645,693,76.15,0.7615,0.76,0.759
"11356","191515",2007,468,247,221,419,193,226,91.5,0.915,0.895,0.873
"11357","191533",2007,452,256,196,243,92,151,58.98,0.5898,0.538,0.469
"11358","191630",2007,600,338,262,444,172,272,80.47,0.8047,0.74,0.656
"11359","191649",2007,1716,907,809,850,344,506,55.79,0.5579,0.495,0.425
"11360","191676",2007,264,174,90,171,54,117,67.24,0.6724,0.648,0.6
"11361","191931",2007,906,486,420,476,195,281,57.82,0.5782,0.525,0.464
"11362","191968",2007,1794,1055,739,1241,488,753,71.37,0.7137,0.692,0.66
"11363","192192",2007,274,192,82,98,28,70,36.46,0.3646,0.358,0.341
"11364","192323",2007,577,348,229,362,125,237,68.1,0.681,0.627,0.546
"11365","192439",2007,1021,721,300,61,16,45,6.24,0.0624,0.06,0.053
"11366","192703",2007,708,356,352,427,201,226,63.48,0.6348,0.603,0.571
"11367","192749",2007,463,315,148,249,59,190,60.32,0.6032,0.538,0.399
"11368","192819",2007,1019,561,458,713,295,418,74.51,0.7451,0.7,0.644
"11369","192925",2007,409,255,154,131,56,75,29.41,0.2941,0.32,0.364
"11370","193016",2007,532,343,189,111,21,90,26.24,0.2624,0.209,0.111
"11371","193292",2007,370,282,88,140,31,109,38.65,0.3865,0.378,0.352
"11372","193353",2007,364,252,112,150,31,119,47.22,0.4722,0.412,0.277
"11373","193399",2007,394,272,122,144,39,105,38.6,0.386,0.365,0.32
"11374","193584",2007,456,335,121,268,60,208,62.09,0.6209,0.588,0.496
"11375","193645",2007,805,733,72,126,2,124,16.92,0.1692,0.157,0.028
"11376","193654",2007,999,740,259,482,118,364,49.19,0.4919,0.482,0.456
"11377","193900",2007,4884,3064,1820,2973,1082,1891,61.72,0.6172,0.609,0.595
"11378","193973",2007,737,435,302,440,164,276,63.45,0.6345,0.597,0.543
"11379","194161",2007,304,172,132,74,22,52,30.23,0.3023,0.243,0.167
"11380","194310",2007,1537,937,600,528,183,345,36.82,0.3682,0.344,0.305
"11381","194824",2007,1288,389,899,836,576,260,66.84,0.6684,0.649,0.641
"11382","195003",2007,2497,788,1709,648,306,342,43.4,0.434,0.26,0.179
"11383","195030",2007,1181,603,578,905,415,490,81.26,0.8126,0.766,0.718
"11384","195164",2007,527,264,263,283,133,150,56.82,0.5682,0.537,0.506
"11385","195173",2007,478,261,217,130,48,82,31.42,0.3142,0.272,0.221
"11386","195216",2007,627,383,244,482,181,301,78.59,0.7859,0.769,0.742
"11387","195234",2007,611,456,155,326,63,263,57.68,0.5768,0.534,0.406
"11388","195243",2007,324,163,161,117,49,68,41.72,0.4172,0.361,0.304
"11389","195304",2007,363,278,85,226,50,176,63.31,0.6331,0.623,0.588
"11390","195474",2007,781,463,318,578,219,359,77.54,0.7754,0.74,0.689
"11391","195526",2007,682,406,276,564,213,351,86.45,0.8645,0.827,0.772
"11392","195544",2007,672,474,198,373,87,286,60.34,0.6034,0.555,0.439
"11393","195809",2007,3151,1689,1462,1121,455,666,39.43,0.3943,0.356,0.311
"11394","196413",2007,3092,1756,1336,2119,846,1273,72.49,0.7249,0.685,0.633
"11395","196592",2007,848,545,303,80,22,58,10.64,0.1064,0.094,0.073
"11396","197045",2007,492,265,227,146,60,86,32.45,0.3245,0.297,0.264
"11397","197133",2007,677,409,268,607,233,374,91.44,0.9144,0.897,0.869
"11398","197869",2007,2730,1401,1329,1133,431,702,50.11,0.5011,0.415,0.324
"11399","197984",2007,210,90,120,69,28,41,45.56,0.4556,0.329,0.233
"11400","198385",2007,464,234,230,417,198,219,93.59,0.9359,0.899,0.861
"11401","198464",2007,4195,2535,1660,1294,391,903,35.62,0.3562,0.308,0.236
"11402","198507",2007,642,391,251,138,39,99,25.32,0.2532,0.215,0.155
"11403","198516",2007,1286,746,540,987,380,607,81.37,0.8137,0.767,0.704
"11404","198835",2007,367,214,153,146,48,98,45.79,0.4579,0.398,0.314
"11405","198969",2007,433,138,295,76,31,45,32.61,0.3261,0.176,0.105
"11406","199102",2007,1569,819,750,251,64,187,22.83,0.2283,0.16,0.085
"11407","199111",2007,571,341,230,211,67,144,42.23,0.4223,0.37,0.291
"11408","199120",2007,3877,2338,1539,3124,1151,1973,84.39,0.8439,0.806,0.748
"11409","199139",2007,2926,1520,1406,749,304,445,29.28,0.2928,0.256,0.216
"11410","199148",2007,2431,1689,742,721,166,555,32.86,0.3286,0.297,0.224
"11411","199157",2007,1236,764,472,185,47,138,18.06,0.1806,0.15,0.1
"11412","199193",2007,4895,2179,2716,1975,836,1139,52.27,0.5227,0.403,0.308
"11413","199218",2007,1913,1138,775,991,340,651,57.21,0.5721,0.518,0.439
"11414","199281",2007,1101,585,516,170,57,113,19.32,0.1932,0.154,0.11
"11415","199306",2007,189,90,99,63,28,35,38.89,0.3889,0.333,0.283
"11416","199412",2007,290,198,92,126,32,94,47.47,0.4747,0.434,0.348
"11417","199582",2007,417,188,229,91,31,60,31.91,0.3191,0.218,0.135
"11418","199643",2007,565,321,244,89,35,54,16.82,0.1682,0.158,0.143
"11419","199847",2007,1123,573,550,919,433,486,84.82,0.8482,0.818,0.787
"11420","199962",2007,426,209,217,200,87,113,54.07,0.5407,0.469,0.401
"11421","199999",2007,962,661,301,171,40,131,19.82,0.1982,0.178,0.133
"11422","200004",2007,1249,651,598,400,142,258,39.63,0.3963,0.32,0.237
"11423","200059",2007,355,191,164,48,19,29,15.18,0.1518,0.135,0.116
"11424","200156",2007,264,140,124,88,26,62,44.29,0.4429,0.333,0.21
"11425","200217",2007,352,206,146,99,20,79,38.35,0.3835,0.281,0.137
"11426","200226",2007,89,42,47,18,5,13,30.95,0.3095,0.202,0.106
"11427","200253",2007,418,231,187,60,21,39,16.88,0.1688,0.144,0.112
"11428","200280",2007,1832,883,949,441,200,241,27.29,0.2729,0.241,0.211
"11429","200332",2007,2125,965,1160,544,244,300,31.09,0.3109,0.256,0.21
"11430","200572",2007,184,86,98,42,14,28,32.56,0.3256,0.228,0.143
"11431","201104",2007,639,371,268,264,77,187,50.4,0.504,0.413,0.287
"11432","201371",2007,206,117,89,108,41,67,57.26,0.5726,0.524,0.461
"11433","201548",2007,627,377,250,323,117,206,54.64,0.5464,0.515,0.468
"11434","201645",2007,1132,492,640,734,368,366,74.39,0.7439,0.648,0.575
"11435","201690",2007,564,278,286,59,15,44,15.83,0.1583,0.105,0.052
"11436","202134",2007,1132,622,510,94,37,57,9.16,0.0916,0.083,0.073
"11437","202480",2007,1763,893,870,1064,460,604,67.64,0.6764,0.604,0.529
"11438","202523",2007,585,325,260,455,199,256,78.77,0.7877,0.778,0.765
"11439","202763",2007,594,416,178,258,53,205,49.28,0.4928,0.434,0.298
"11440","203085",2007,369,149,220,130,64,66,44.3,0.443,0.352,0.291
"11441","203128",2007,333,184,149,199,77,122,66.3,0.663,0.598,0.517
"11442","203368",2007,720,358,362,471,216,255,71.23,0.7123,0.654,0.597
"11443","203517",2007,3729,2300,1429,1031,308,723,31.43,0.3143,0.276,0.216
"11444","203535",2007,458,249,209,395,175,220,88.35,0.8835,0.862,0.837
"11445","203580",2007,237,108,129,66,21,45,41.67,0.4167,0.278,0.163
"11446","203775",2007,387,235,152,177,58,119,50.64,0.5064,0.457,0.382
"11447","203845",2007,415,201,214,182,75,107,53.23,0.5323,0.439,0.35
"11448","204024",2007,3456,1902,1554,2359,968,1391,73.13,0.7313,0.683,0.623
"11449","204185",2007,593,282,311,316,130,186,65.96,0.6596,0.533,0.418
"11450","204194",2007,350,210,140,171,56,115,54.76,0.5476,0.489,0.4
"11451","204617",2007,391,207,184,112,48,64,30.92,0.3092,0.286,0.261
"11452","204796",2007,6155,3039,3116,3602,1534,2068,68.05,0.6805,0.585,0.492
"11453","204857",2007,3970,2059,1911,1902,781,1121,54.44,0.5444,0.479,0.409
"11454","206330",2007,240,101,139,57,29,28,27.72,0.2772,0.238,0.209
"11455","206589",2007,545,287,258,384,159,225,78.4,0.784,0.705,0.616
"11456","206604",2007,2371,1339,1032,447,160,287,21.43,0.2143,0.189,0.155
"11457","206622",2007,858,447,411,572,268,304,68.01,0.6801,0.667,0.652
"11458","206695",2007,2140,1101,1039,168,70,98,8.9,0.089,0.079,0.067
"11459","206914",2007,716,382,334,50,22,28,7.33,0.0733,0.07,0.066
"11460","207209",2007,559,270,289,48,8,40,14.81,0.1481,0.086,0.028
"11461","207306",2007,328,173,155,43,13,30,17.34,0.1734,0.131,0.084
"11462","207324",2007,521,269,252,148,63,85,31.6,0.316,0.284,0.25
"11463","207388",2007,3111,1599,1512,1013,399,614,38.4,0.384,0.326,0.264
"11464","207500",2007,3824,2043,1781,1331,452,879,43.02,0.4302,0.348,0.254
"11465","207722",2007,198,123,75,51,13,38,30.89,0.3089,0.258,0.173
"11466","207847",2007,631,326,305,82,33,49,15.03,0.1503,0.13,0.108
"11467","207865",2007,896,552,344,116,32,84,15.22,0.1522,0.129,0.093
"11468","208822",2007,435,279,156,225,61,164,58.78,0.5878,0.517,0.391
"11469","209056",2007,506,322,184,338,108,230,71.43,0.7143,0.668,0.587
"11470","209065",2007,476,276,200,281,96,185,67.03,0.6703,0.59,0.48
"11471","209542",2007,2974,1436,1538,879,333,546,38.02,0.3802,0.296,0.217
"11472","209551",2007,3505,1839,1666,1528,629,899,48.89,0.4889,0.436,0.378
"11473","209612",2007,372,242,130,194,59,135,55.79,0.5579,0.522,0.454
"11474","209807",2007,1427,759,668,252,93,159,20.95,0.2095,0.177,0.139
"11475","209922",2007,337,187,150,236,99,137,73.26,0.7326,0.7,0.66
"11476","210146",2007,703,405,298,127,37,90,22.22,0.2222,0.181,0.124
"11477","210401",2007,444,238,206,315,130,185,77.73,0.7773,0.709,0.631
"11478","210429",2007,916,527,389,184,54,130,24.67,0.2467,0.201,0.139
"11479","210571",2007,512,307,205,247,90,157,51.14,0.5114,0.482,0.439
"11480","210669",2007,581,351,230,431,159,272,77.49,0.7749,0.742,0.691
"11481","210775",2007,302,165,137,107,48,59,35.76,0.3576,0.354,0.35
"11482","211088",2007,476,364,112,253,53,200,54.95,0.5495,0.532,0.473
"11483","211158",2007,1679,969,710,710,237,473,48.81,0.4881,0.423,0.334
"11484","211291",2007,887,441,446,774,373,401,90.93,0.9093,0.873,0.836
"11485","211352",2007,513,329,184,202,66,136,41.34,0.4134,0.394,0.359
"11486","211361",2007,1250,622,628,281,124,157,25.24,0.2524,0.225,0.197
"11487","211431",2007,199,194,5,93,0,93,47.94,0.4794,0.467,0
"11488","211440",2007,1407,554,853,1046,612,434,78.34,0.7834,0.743,0.717
"11489","211468",2007,222,221,1,112,0,112,50.68,0.5068,0.505,0
"11490","211556",2007,175,175,0,77,0,77,44,0.44,0.44,NA
"11491","211583",2007,234,128,106,63,24,39,30.47,0.3047,0.269,0.226
"11492","211608",2007,278,166,112,26,5,21,12.65,0.1265,0.094,0.045
"11493","211644",2007,1381,799,582,417,142,275,34.42,0.3442,0.302,0.244
"11494","211981",2007,475,270,205,221,79,142,52.59,0.5259,0.465,0.385
"11495","212009",2007,619,319,300,515,237,278,87.15,0.8715,0.832,0.79
"11496","212054",2007,2260,945,1315,640,254,386,40.85,0.4085,0.283,0.193
"11497","212106",2007,1354,785,569,796,307,489,62.29,0.6229,0.588,0.54
"11498","212115",2007,1183,612,571,422,156,266,43.46,0.4346,0.357,0.273
"11499","212133",2007,483,319,164,206,58,148,46.39,0.4639,0.427,0.354
"11500","212160",2007,1243,707,536,239,75,164,23.2,0.232,0.192,0.14
"11501","212197",2007,487,324,163,344,113,231,71.3,0.713,0.706,0.693
"11502","212577",2007,569,301,268,477,214,263,87.38,0.8738,0.838,0.799
"11503","212601",2007,610,365,245,276,96,180,49.32,0.4932,0.452,0.392
"11504","212832",2007,291,208,83,58,23,35,16.83,0.1683,0.199,0.277
"11505","212911",2007,315,169,146,287,131,156,92.31,0.9231,0.911,0.897
"11506","213020",2007,2524,1450,1074,786,257,529,36.48,0.3648,0.311,0.239
"11507","213251",2007,377,220,157,271,104,167,75.91,0.7591,0.719,0.662
"11508","213321",2007,555,268,287,338,173,165,61.57,0.6157,0.609,0.603
"11509","213349",2007,1888,1111,777,645,182,463,41.67,0.4167,0.342,0.234
"11510","213358",2007,294,192,102,93,29,64,33.33,0.3333,0.316,0.284
"11511","213367",2007,804,472,332,424,136,288,61.02,0.6102,0.527,0.41
"11512","213385",2007,591,277,314,500,253,247,89.17,0.8917,0.846,0.806
"11513","213507",2007,450,261,189,308,109,199,76.25,0.7625,0.684,0.577
"11514","213543",2007,1165,450,715,851,485,366,81.33,0.8133,0.73,0.678
"11515","213613",2007,1217,656,561,321,144,177,26.98,0.2698,0.264,0.257
"11516","213668",2007,399,211,188,215,84,131,62.09,0.6209,0.539,0.447
"11517","213783",2007,661,397,264,198,63,135,34.01,0.3401,0.3,0.239
"11518","213826",2007,407,297,110,218,46,172,57.91,0.5791,0.536,0.418
"11519","213996",2007,723,459,264,514,185,329,71.68,0.7168,0.711,0.701
"11520","214041",2007,1326,766,560,491,161,330,43.08,0.4308,0.37,0.288
"11521","214069",2007,364,273,91,234,51,183,67.03,0.6703,0.643,0.56
"11522","214157",2007,401,214,187,282,130,152,71.03,0.7103,0.703,0.695
"11523","214175",2007,551,304,247,445,189,256,84.21,0.8421,0.808,0.765
"11524","214272",2007,540,336,204,157,44,113,33.63,0.3363,0.291,0.216
"11525","214777",2007,6492,3121,3371,4191,1943,2248,72.03,0.7203,0.646,0.576
"11526","215062",2007,2342,1107,1235,2058,1052,1006,90.88,0.9088,0.879,0.852
"11527","215743",2007,403,258,145,230,71,159,61.63,0.6163,0.571,0.49
"11528","215798",2007,423,200,223,269,130,139,69.5,0.695,0.636,0.583
"11529","215929",2007,1025,574,451,771,307,464,80.84,0.8084,0.752,0.681
"11530","216010",2007,1720,927,793,639,251,388,41.86,0.4186,0.372,0.317
"11531","216038",2007,1498,876,622,596,185,411,46.92,0.4692,0.398,0.297
"11532","216287",2007,365,190,175,324,152,172,90.53,0.9053,0.888,0.869
"11533","216339",2007,4385,2478,1907,1705,684,1021,41.2,0.412,0.389,0.359
"11534","216524",2007,468,242,226,353,159,194,80.17,0.8017,0.754,0.704
"11535","216694",2007,402,232,170,182,67,115,49.57,0.4957,0.453,0.394
"11536","216764",2007,1955,1215,740,857,235,622,51.19,0.5119,0.438,0.318
"11537","216807",2007,311,179,132,195,76,119,66.48,0.6648,0.627,0.576
"11538","216852",2007,782,382,400,312,133,179,46.86,0.4686,0.399,0.332
"11539","216931",2007,620,299,321,291,146,145,48.49,0.4849,0.469,0.455
"11540","217059",2007,1177,597,580,437,189,248,41.54,0.4154,0.371,0.326
"11541","217156",2007,1477,814,663,1246,548,698,85.75,0.8575,0.844,0.827
"11542","217402",2007,989,559,430,820,361,459,82.11,0.8211,0.829,0.84
"11543","217536",2007,556,353,203,338,117,221,62.61,0.6261,0.608,0.576
"11544","217776",2007,183,114,69,49,20,29,25.44,0.2544,0.268,0.29
"11545","217819",2007,2061,1352,709,1071,302,769,56.88,0.5688,0.52,0.426
"11546","217882",2007,2702,1304,1398,1598,677,921,70.63,0.7063,0.591,0.484
"11547","217998",2007,163,94,69,84,30,54,57.45,0.5745,0.515,0.435
"11548","218061",2007,776,493,283,127,47,80,16.23,0.1623,0.164,0.166
"11549","218229",2007,433,296,137,139,35,104,35.14,0.3514,0.321,0.255
"11550","218238",2007,225,92,133,42,18,24,26.09,0.2609,0.187,0.135
"11551","218399",2007,295,152,143,40,14,26,17.11,0.1711,0.136,0.098
"11552","218414",2007,323,122,201,88,41,47,38.52,0.3852,0.272,0.204
"11553","218663",2007,3690,2117,1573,1999,734,1265,59.75,0.5975,0.542,0.467
"11554","218724",2007,1647,886,761,443,143,300,33.86,0.3386,0.269,0.188
"11555","218733",2007,1292,652,640,177,59,118,18.1,0.181,0.137,0.092
"11556","218742",2007,805,488,317,191,54,137,28.07,0.2807,0.237,0.17
"11557","218973",2007,385,193,192,301,141,160,82.9,0.829,0.782,0.734
"11558","219000",2007,429,272,157,207,54,153,56.25,0.5625,0.483,0.344
"11559","219046",2007,472,268,204,51,14,37,13.81,0.1381,0.108,0.069
"11560","219082",2007,243,110,133,44,23,21,19.09,0.1909,0.181,0.173
"11561","219198",2007,108,73,35,49,14,35,47.95,0.4795,0.454,0.4
"11562","219259",2007,340,203,137,70,15,55,27.09,0.2709,0.206,0.109
"11563","219356",2007,1933,950,983,495,183,312,32.84,0.3284,0.256,0.186
"11564","219471",2007,1030,612,418,282,105,177,28.92,0.2892,0.274,0.251
"11565","219602",2007,1188,683,505,178,55,123,18.01,0.1801,0.15,0.109
"11566","219709",2007,799,453,346,449,187,262,57.84,0.5784,0.562,0.54
"11567","219718",2007,255,115,140,27,13,14,12.17,0.1217,0.106,0.093
"11568","219949",2007,210,75,135,43,22,21,28,0.28,0.205,0.163
"11569","220075",2007,1918,1063,855,330,110,220,20.7,0.207,0.172,0.129
"11570","220215",2007,385,222,163,148,58,90,40.54,0.4054,0.384,0.356
"11571","220613",2007,783,437,346,271,88,183,41.88,0.4188,0.346,0.254
"11572","220631",2007,230,159,71,23,19,4,2.52,0.0252,0.1,0.268
"11573","220710",2007,317,158,159,148,49,99,62.66,0.6266,0.467,0.308
"11574","221351",2007,452,252,200,335,148,187,74.21,0.7421,0.741,0.74
"11575","221519",2007,401,235,166,303,115,188,80,0.8,0.756,0.693
"11576","221731",2007,153,86,67,49,19,30,34.88,0.3488,0.32,0.284
"11577","221847",2007,1649,730,919,371,157,214,29.32,0.2932,0.225,0.171
"11578","221892",2007,238,139,99,85,31,54,38.85,0.3885,0.357,0.313
"11579","222178",2007,887,476,411,324,113,211,44.33,0.4433,0.365,0.275
"11580","222983",2007,333,174,159,223,91,132,75.86,0.7586,0.67,0.572
"11581","223232",2007,2721,1618,1103,1556,552,1004,62.05,0.6205,0.572,0.5
"11582","224004",2007,160,87,73,29,9,20,22.99,0.2299,0.181,0.123
"11583","224323",2007,362,200,162,201,85,116,58,0.58,0.555,0.525
"11584","225432",2007,831,438,393,22,7,15,3.42,0.0342,0.026,0.018
"11585","225548",2007,255,103,152,77,31,46,44.66,0.4466,0.302,0.204
"11586","225627",2007,715,463,252,138,41,97,20.95,0.2095,0.193,0.163
"11587","226231",2007,322,97,225,108,71,37,38.14,0.3814,0.335,0.316
"11588","226833",2007,735,384,351,118,43,75,19.53,0.1953,0.161,0.123
"11589","227216",2007,3495,1996,1499,862,254,608,30.46,0.3046,0.247,0.169
"11590","227331",2007,283,189,94,51,13,38,20.11,0.2011,0.18,0.138
"11591","227526",2007,1391,784,607,155,36,119,15.18,0.1518,0.111,0.059
"11592","227757",2007,742,346,396,585,288,297,85.84,0.8584,0.788,0.727
"11593","227845",2007,725,437,288,372,127,245,56.06,0.5606,0.513,0.441
"11594","227863",2007,288,179,109,77,25,52,29.05,0.2905,0.267,0.229
"11595","228042",2007,262,135,127,92,36,56,41.48,0.4148,0.351,0.283
"11596","228149",2007,565,334,231,187,54,133,39.82,0.3982,0.331,0.234
"11597","228246",2007,1306,697,609,870,359,511,73.31,0.7331,0.666,0.589
"11598","228343",2007,371,232,139,242,84,158,68.1,0.681,0.652,0.604
"11599","228431",2007,2268,1375,893,521,156,365,26.55,0.2655,0.23,0.175
"11600","228459",2007,3237,1900,1337,983,288,695,36.58,0.3658,0.304,0.215
"11601","228501",2007,242,92,150,34,6,28,30.43,0.3043,0.14,0.04
"11602","228529",2007,1190,685,505,259,86,173,25.26,0.2526,0.218,0.17
"11603","228705",2007,651,251,400,115,58,57,22.71,0.2271,0.177,0.145
"11604","228723",2007,8025,4074,3951,3968,1491,2477,60.8,0.608,0.494,0.377
"11605","228769",2007,2096,1041,1055,354,130,224,21.52,0.2152,0.169,0.123
"11606","228778",2007,7419,3973,3446,3776,1472,2304,57.99,0.5799,0.509,0.427
"11607","228787",2007,1030,421,609,472,237,235,55.82,0.5582,0.458,0.389
"11608","228796",2007,2017,1046,971,245,94,151,14.44,0.1444,0.121,0.097
"11609","228875",2007,1642,965,677,961,348,613,63.52,0.6352,0.585,0.514
"11610","228981",2007,365,177,188,114,39,75,42.37,0.4237,0.312,0.207
"11611","229018",2007,372,198,174,48,15,33,16.67,0.1667,0.129,0.086
"11612","229027",2007,4833,2309,2524,465,179,286,12.39,0.1239,0.096,0.071
"11613","229115",2007,4439,2065,2374,1455,600,855,41.4,0.414,0.328,0.253
"11614","229780",2007,247,129,118,53,20,33,25.58,0.2558,0.215,0.169
"11615","229814",2007,923,480,443,227,79,148,30.83,0.3083,0.246,0.178
"11616","230603",2007,865,579,286,185,39,146,25.22,0.2522,0.214,0.136
"11617","230728",2007,2654,1697,957,544,113,431,25.4,0.254,0.205,0.118
"11618","230764",2007,1953,1082,871,469,170,299,27.63,0.2763,0.24,0.195
"11619","230782",2007,1364,783,581,110,27,83,10.6,0.106,0.081,0.046
"11620","231059",2007,524,280,244,364,154,210,75,0.75,0.695,0.631
"11621","231174",2007,2432,1346,1086,1577,650,927,68.87,0.6887,0.648,0.599
"11622","231420",2007,238,70,168,43,23,20,28.57,0.2857,0.181,0.137
"11623","231554",2007,89,49,40,34,10,24,48.98,0.4898,0.382,0.25
"11624","231624",2007,1341,729,612,1114,474,640,87.79,0.8779,0.831,0.775
"11625","231712",2007,1241,706,535,618,200,418,59.21,0.5921,0.498,0.374
"11626","232025",2007,240,103,137,80,37,43,41.75,0.4175,0.333,0.27
"11627","232043",2007,203,121,82,100,34,66,54.55,0.5455,0.493,0.415
"11628","232089",2007,525,228,297,103,42,61,26.75,0.2675,0.196,0.141
"11629","232186",2007,2174,1222,952,942,316,626,51.23,0.5123,0.433,0.332
"11630","232265",2007,1179,757,422,585,163,422,55.75,0.5575,0.496,0.386
"11631","232423",2007,3864,2401,1463,2520,829,1691,70.43,0.7043,0.652,0.567
"11632","232557",2007,2715,1474,1241,715,278,437,29.65,0.2965,0.263,0.224
"11633","232566",2007,984,650,334,412,107,305,46.92,0.4692,0.419,0.32
"11634","232609",2007,598,324,274,274,95,179,55.25,0.5525,0.458,0.347
"11635","232681",2007,951,649,302,626,175,451,69.49,0.6949,0.658,0.579
"11636","232706",2007,396,288,108,176,35,141,48.96,0.4896,0.444,0.324
"11637","232937",2007,938,571,367,179,46,133,23.29,0.2329,0.191,0.125
"11638","232982",2007,2513,1327,1186,581,200,381,28.71,0.2871,0.231,0.169
"11639","233277",2007,1840,1055,785,758,273,485,45.97,0.4597,0.412,0.348
"11640","233374",2007,801,427,374,653,295,358,83.84,0.8384,0.815,0.789
"11641","233426",2007,565,335,230,327,115,212,63.28,0.6328,0.579,0.5
"11642","233541",2007,397,205,192,135,49,86,41.95,0.4195,0.34,0.255
"11643","233897",2007,401,184,217,97,41,56,30.43,0.3043,0.242,0.189
"11644","233921",2007,5112,2264,2848,3063,1430,1633,72.13,0.7213,0.599,0.502
"11645","234030",2007,3802,2159,1643,1129,405,724,33.53,0.3353,0.297,0.247
"11646","234085",2007,410,36,374,240,221,19,52.78,0.5278,0.585,0.591
"11647","234155",2007,1185,796,389,259,58,201,25.25,0.2525,0.219,0.149
"11648","234164",2007,375,209,166,81,17,64,30.62,0.3062,0.216,0.102
"11649","235097",2007,1313,770,543,243,81,162,21.04,0.2104,0.185,0.149
"11650","235167",2007,677,347,330,288,138,150,43.23,0.4323,0.425,0.418
"11651","236230",2007,714,453,261,394,134,260,57.4,0.574,0.552,0.513
"11652","236328",2007,641,393,248,437,157,280,71.25,0.7125,0.682,0.633
"11653","236577",2007,716,499,217,390,110,280,56.11,0.5611,0.545,0.507
"11654","236595",2007,736,479,257,432,127,305,63.67,0.6367,0.587,0.494
"11655","236896",2007,344,162,182,58,25,33,20.37,0.2037,0.169,0.137
"11656","236939",2007,3184,1588,1596,1275,508,767,48.3,0.483,0.4,0.318
"11657","236948",2007,5163,2771,2392,2968,1213,1755,63.33,0.6333,0.575,0.507
"11658","237011",2007,2572,1484,1088,970,324,646,43.53,0.4353,0.377,0.298
"11659","237057",2007,400,239,161,319,124,195,81.59,0.8159,0.797,0.77
"11660","237066",2007,532,293,239,347,141,206,70.31,0.7031,0.652,0.59
"11661","237215",2007,296,167,129,18,11,7,4.19,0.0419,0.061,0.085
"11662","237330",2007,618,335,283,115,49,66,19.7,0.197,0.186,0.173
"11663","237358",2007,120,70,50,21,9,12,17.14,0.1714,0.175,0.18
"11664","237367",2007,632,331,301,87,37,50,15.11,0.1511,0.138,0.123
"11665","237792",2007,691,366,325,124,48,76,20.77,0.2077,0.179,0.148
"11666","237899",2007,364,170,194,14,5,9,5.29,0.0529,0.038,0.026
"11667","237932",2007,499,264,235,110,27,83,31.44,0.3144,0.22,0.115
"11668","237969",2007,401,203,198,174,71,103,50.74,0.5074,0.434,0.359
"11669","238032",2007,4664,2156,2508,1561,696,865,40.12,0.4012,0.335,0.278
"11670","238333",2007,325,183,142,229,99,130,71.04,0.7104,0.705,0.697
"11671","238430",2007,173,115,58,25,6,19,16.52,0.1652,0.145,0.103
"11672","238458",2007,652,440,212,277,88,189,42.95,0.4295,0.425,0.415
"11673","238476",2007,683,350,333,371,145,226,64.57,0.6457,0.543,0.435
"11674","238616",2007,422,232,190,143,46,97,41.81,0.4181,0.339,0.242
"11675","238661",2007,302,202,100,98,28,70,34.65,0.3465,0.325,0.28
"11676","239080",2007,266,191,75,80,8,72,37.7,0.377,0.301,0.107
"11677","239105",2007,1811,966,845,1038,442,596,61.7,0.617,0.573,0.523
"11678","239628",2007,262,124,138,158,78,80,64.52,0.6452,0.603,0.565
"11679","239716",2007,542,328,214,372,130,242,73.78,0.7378,0.686,0.607
"11680","240107",2007,361,252,109,108,26,82,32.54,0.3254,0.299,0.239
"11681","240189",2007,2048,993,1055,564,258,306,30.82,0.3082,0.275,0.245
"11682","240277",2007,987,644,343,201,42,159,24.69,0.2469,0.204,0.122
"11683","240329",2007,1750,1084,666,621,196,425,39.21,0.3921,0.355,0.294
"11684","240338",2007,181,97,84,82,34,48,49.48,0.4948,0.453,0.405
"11685","240365",2007,1723,1018,705,300,96,204,20.04,0.2004,0.174,0.136
"11686","240374",2007,833,418,415,75,38,37,8.85,0.0885,0.09,0.092
"11687","240417",2007,1489,763,726,309,108,201,26.34,0.2634,0.208,0.149
"11688","240426",2007,343,197,146,47,14,33,16.75,0.1675,0.137,0.096
"11689","240444",2007,5980,3197,2783,3291,1332,1959,61.28,0.6128,0.55,0.479
"11690","240453",2007,4465,2228,2237,585,259,326,14.63,0.1463,0.131,0.116
"11691","240462",2007,1466,500,966,275,127,148,29.6,0.296,0.188,0.131
"11692","240471",2007,1276,743,533,297,103,194,26.11,0.2611,0.233,0.193
"11693","240480",2007,1611,892,719,358,145,213,23.88,0.2388,0.222,0.202
"11694","240727",2007,1614,831,783,389,132,257,30.93,0.3093,0.241,0.169
"11695","243443",2007,690,422,268,41,10,31,7.35,0.0735,0.059,0.037
"11696","243780",2007,6830,2882,3948,2702,1260,1442,50.03,0.5003,0.396,0.319
"11697","100654",2008,1044,568,476,115,23,92,16.2,0.162,0.11,0.048
"11698","100663",2008,1246,710,536,406,140,266,37.46,0.3746,0.326,0.261
"11699","100751",2008,5009,2776,2233,1942,703,1239,44.63,0.4463,0.388,0.315
"11700","100858",2008,3967,2049,1918,1676,627,1049,51.2,0.512,0.422,0.327
"11701","101435",2008,253,106,147,76,28,48,45.28,0.4528,0.3,0.19
"11702","101480",2008,1243,663,580,108,31,77,11.61,0.1161,0.087,0.053
"11703","101675",2008,461,213,248,38,5,33,15.49,0.1549,0.082,0.02
"11704","101879",2008,988,533,455,119,34,85,15.95,0.1595,0.12,0.075
"11705","102049",2008,705,442,263,336,104,232,52.49,0.5249,0.477,0.395
"11706","102094",2008,1543,875,668,230,68,162,18.51,0.1851,0.149,0.102
"11707","102234",2008,344,213,131,175,62,113,53.05,0.5305,0.509,0.473
"11708","102368",2008,1827,1081,746,246,76,170,15.73,0.1573,0.135,0.102
"11709","102377",2008,722,414,308,154,44,110,26.57,0.2657,0.213,0.143
"11710","104151",2008,6743,3320,3423,2886,1224,1662,50.06,0.5006,0.428,0.358
"11711","104179",2008,6331,3377,2954,2536,1017,1519,44.98,0.4498,0.401,0.344
"11712","105330",2008,3248,1899,1349,1078,316,762,40.13,0.4013,0.332,0.234
"11713","106245",2008,618,375,243,50,23,27,7.2,0.072,0.081,0.095
"11714","106342",2008,102,52,50,50,25,25,48.08,0.4808,0.49,0.5
"11715","106397",2008,2977,1488,1489,1108,475,633,42.54,0.4254,0.372,0.319
"11716","106412",2008,952,504,448,93,21,72,14.29,0.1429,0.098,0.047
"11717","106458",2008,1743,981,762,352,129,223,22.73,0.2273,0.202,0.169
"11718","106467",2008,1450,763,687,305,115,190,24.9,0.249,0.21,0.167
"11719","106485",2008,661,361,300,89,33,56,15.51,0.1551,0.135,0.11
"11720","106704",2008,2075,1165,910,444,157,287,24.64,0.2464,0.214,0.173
"11721","107044",2008,980,537,443,425,158,267,49.72,0.4972,0.434,0.357
"11722","107080",2008,430,238,192,284,122,162,68.07,0.6807,0.66,0.635
"11723","107141",2008,307,165,142,160,72,88,53.33,0.5333,0.521,0.507
"11724","107512",2008,404,220,184,205,80,125,56.82,0.5682,0.507,0.435
"11725","107558",2008,195,113,82,72,27,45,39.82,0.3982,0.369,0.329
"11726","110097",2008,846,530,316,430,157,273,51.51,0.5151,0.508,0.497
"11727","110404",2008,236,97,139,200,112,88,90.72,0.9072,0.847,0.806
"11728","110422",2008,3448,1553,1895,1246,458,788,50.74,0.5074,0.361,0.242
"11729","110486",2008,901,592,309,144,45,99,16.72,0.1672,0.16,0.146
"11730","110495",2008,899,576,323,133,33,100,17.36,0.1736,0.148,0.102
"11731","110510",2008,1916,1213,703,241,77,164,13.52,0.1352,0.126,0.11
"11732","110529",2008,2538,1068,1470,299,135,164,15.36,0.1536,0.118,0.092
"11733","110538",2008,2727,1420,1307,537,163,374,26.34,0.2634,0.197,0.125
"11734","110547",2008,889,599,290,42,14,28,4.67,0.0467,0.047,0.048
"11735","110556",2008,2731,1604,1127,402,121,281,17.52,0.1752,0.147,0.107
"11736","110565",2008,4519,2673,1846,630,180,450,16.84,0.1684,0.139,0.098
"11737","110574",2008,1356,828,528,141,45,96,11.59,0.1159,0.104,0.085
"11738","110583",2008,4536,2856,1680,676,183,493,17.26,0.1726,0.149,0.109
"11739","110592",2008,1676,1014,662,105,40,65,6.41,0.0641,0.063,0.06
"11740","110617",2008,2536,1493,1043,191,50,141,9.44,0.0944,0.075,0.048
"11741","113698",2008,267,202,65,146,31,115,56.93,0.5693,0.547,0.477
"11742","115755",2008,1168,661,507,147,37,110,16.64,0.1664,0.126,0.073
"11743","119173",2008,313,302,11,84,2,82,27.15,0.2715,0.268,0.182
"11744","120184",2008,147,85,62,63,21,42,49.41,0.4941,0.429,0.339
"11745","121309",2008,538,327,211,318,116,202,61.77,0.6177,0.591,0.55
"11746","121345",2008,382,194,188,344,168,176,90.72,0.9072,0.901,0.894
"11747","122409",2008,3578,2086,1492,1053,346,707,33.89,0.3389,0.294,0.232
"11748","122436",2008,1259,771,488,838,289,549,71.21,0.7121,0.666,0.592
"11749","122597",2008,3512,2334,1178,524,145,379,16.24,0.1624,0.149,0.123
"11750","122612",2008,1036,686,350,632,196,436,63.56,0.6356,0.61,0.56
"11751","122931",2008,1220,623,597,951,436,515,82.66,0.8266,0.78,0.73
"11752","123554",2008,665,436,229,349,100,249,57.11,0.5711,0.525,0.437
"11753","123572",2008,1631,1058,573,444,96,348,32.89,0.3289,0.272,0.168
"11754","126562",2008,1036,603,433,156,68,88,14.59,0.1459,0.151,0.157
"11755","126580",2008,1075,577,498,288,110,178,30.85,0.3085,0.268,0.221
"11756","126614",2008,5811,2890,2921,2678,1158,1520,52.6,0.526,0.461,0.396
"11757","126818",2008,4386,2435,1951,1693,567,1126,46.24,0.4624,0.386,0.291
"11758","127060",2008,1131,633,498,743,317,426,67.3,0.673,0.657,0.637
"11759","127185",2008,758,355,403,136,62,74,20.85,0.2085,0.179,0.154
"11760","127565",2008,1918,969,949,88,33,55,5.68,0.0568,0.046,0.035
"11761","127741",2008,2071,1227,844,558,156,402,32.76,0.3276,0.269,0.185
"11762","128106",2008,1002,465,537,160,65,95,20.43,0.2043,0.16,0.121
"11763","128744",2008,444,266,178,90,30,60,22.56,0.2256,0.203,0.169
"11764","128771",2008,1297,578,719,279,133,146,25.26,0.2526,0.215,0.185
"11765","129020",2008,3587,1780,1807,2382,1098,1284,72.13,0.7213,0.664,0.608
"11766","129242",2008,898,537,361,688,257,431,80.26,0.8026,0.766,0.712
"11767","129941",2008,1129,569,560,430,175,255,44.82,0.4482,0.381,0.312
"11768","130253",2008,981,577,404,583,201,382,66.2,0.662,0.594,0.498
"11769","130314",2008,225,225,0,92,0,92,40.89,0.4089,0.409,NA
"11770","130493",2008,1288,858,430,293,77,216,25.17,0.2517,0.227,0.179
"11771","130590",2008,589,300,289,464,214,250,83.33,0.8333,0.788,0.74
"11772","130697",2008,715,355,360,622,300,322,90.7,0.907,0.87,0.833
"11773","130776",2008,928,462,466,180,82,98,21.21,0.2121,0.194,0.176
"11774","130794",2008,1316,664,652,1150,543,607,91.42,0.9142,0.874,0.833
"11775","130934",2008,721,455,266,154,36,118,25.93,0.2593,0.214,0.135
"11776","130943",2008,3834,2211,1623,2378,891,1487,67.25,0.6725,0.62,0.549
"11777","131159",2008,1570,967,603,1199,442,757,78.28,0.7828,0.764,0.733
"11778","131283",2008,901,475,426,537,234,303,63.79,0.6379,0.596,0.549
"11779","131450",2008,179,97,82,29,9,20,20.62,0.2062,0.162,0.11
"11780","131469",2008,2449,1408,1041,1755,687,1068,75.85,0.7585,0.717,0.66
"11781","131496",2008,1571,822,749,1430,665,765,93.07,0.9307,0.91,0.888
"11782","131520",2008,1477,1004,473,629,133,496,49.4,0.494,0.426,0.281
"11783","132471",2008,584,400,184,120,34,86,21.5,0.215,0.205,0.185
"11784","132602",2008,719,478,241,198,38,160,33.47,0.3347,0.275,0.158
"11785","132903",2008,6139,3283,2856,2464,867,1597,48.64,0.4864,0.401,0.304
"11786","133492",2008,487,285,202,283,116,167,58.6,0.586,0.581,0.574
"11787","133553",2008,1058,158,900,325,263,62,39.24,0.3924,0.307,0.292
"11788","133650",2008,2090,1196,894,254,79,175,14.63,0.1463,0.122,0.088
"11789","133669",2008,2677,1407,1270,457,149,308,21.89,0.2189,0.171,0.117
"11790","133711",2008,645,365,280,312,116,196,53.7,0.537,0.484,0.414
"11791","133881",2008,635,194,441,247,152,95,48.97,0.4897,0.389,0.345
"11792","133951",2008,3106,1642,1464,732,234,498,30.33,0.3033,0.236,0.16
"11793","134079",2008,497,304,193,277,102,175,57.57,0.5757,0.557,0.528
"11794","134097",2008,4993,2928,2065,3066,1093,1973,67.38,0.6738,0.614,0.529
"11795","134130",2008,6382,3787,2595,4289,1442,2847,75.18,0.7518,0.672,0.556
"11796","134945",2008,539,249,290,151,67,84,33.73,0.3373,0.28,0.231
"11797","135726",2008,1983,987,996,1358,647,711,72.04,0.7204,0.685,0.65
"11798","136172",2008,1694,1013,681,444,115,329,32.48,0.3248,0.262,0.169
"11799","136950",2008,464,262,202,293,118,175,66.79,0.6679,0.631,0.584
"11800","137546",2008,617,360,257,344,133,211,58.61,0.5861,0.558,0.518
"11801","138354",2008,1030,605,425,277,94,183,30.25,0.3025,0.269,0.221
"11802","138716",2008,626,392,234,65,9,56,14.29,0.1429,0.104,0.038
"11803","138789",2008,864,511,353,87,23,64,12.52,0.1252,0.101,0.065
"11804","139144",2008,448,311,137,243,70,173,55.63,0.5563,0.542,0.511
"11805","139366",2008,1114,642,472,131,38,93,14.49,0.1449,0.118,0.081
"11806","139393",2008,267,149,118,129,51,78,52.35,0.5235,0.483,0.432
"11807","139658",2008,1661,893,768,1064,501,563,63.05,0.6305,0.641,0.652
"11808","139719",2008,1074,568,506,117,32,85,14.96,0.1496,0.109,0.063
"11809","139755",2008,2633,838,1795,974,604,370,44.15,0.4415,0.37,0.336
"11810","139764",2008,418,240,178,42,16,26,10.83,0.1083,0.1,0.09
"11811","139861",2008,1177,751,426,470,136,334,44.47,0.4447,0.399,0.319
"11812","139931",2008,3106,1453,1653,828,300,528,36.34,0.3634,0.267,0.181
"11813","139940",2008,2743,1609,1134,614,206,408,25.36,0.2536,0.224,0.182
"11814","139959",2008,4778,3013,1765,2853,924,1929,64.02,0.6402,0.597,0.524
"11815","140447",2008,615,365,250,298,94,204,55.89,0.5589,0.485,0.376
"11816","140960",2008,905,490,415,71,22,49,10,0.1,0.078,0.053
"11817","140988",2008,330,163,167,117,46,71,43.56,0.4356,0.355,0.275
"11818","141185",2008,155,93,62,63,20,43,46.24,0.4624,0.406,0.323
"11819","141264",2008,2106,1223,883,344,93,251,20.52,0.2052,0.163,0.105
"11820","141334",2008,2008,1216,792,321,88,233,19.16,0.1916,0.16,0.111
"11821","141486",2008,236,161,75,69,18,51,31.68,0.3168,0.292,0.24
"11822","141565",2008,536,326,210,61,16,45,13.8,0.138,0.114,0.076
"11823","141574",2008,1808,1027,781,358,114,244,23.76,0.2376,0.198,0.146
"11824","142276",2008,1031,525,506,94,35,59,11.24,0.1124,0.091,0.069
"11825","142285",2008,1663,777,886,460,202,258,33.2,0.332,0.277,0.228
"11826","142461",2008,301,169,132,96,34,62,36.69,0.3669,0.319,0.258
"11827","143084",2008,640,369,271,454,179,275,74.53,0.7453,0.709,0.661
"11828","143288",2008,171,94,77,52,18,34,36.17,0.3617,0.304,0.234
"11829","144005",2008,402,279,123,10,4,6,2.15,0.0215,0.025,0.033
"11830","144281",2008,2329,1289,1040,690,277,413,32.04,0.3204,0.296,0.266
"11831","144740",2008,2553,1502,1051,1430,537,893,59.45,0.5945,0.56,0.511
"11832","144892",2008,1764,1029,735,582,196,386,37.51,0.3751,0.33,0.267
"11833","144962",2008,576,348,228,350,113,237,68.1,0.681,0.608,0.496
"11834","144971",2008,153,75,78,53,18,35,46.67,0.4667,0.346,0.231
"11835","145600",2008,2944,1659,1285,981,392,589,35.5,0.355,0.333,0.305
"11836","145619",2008,434,227,207,141,57,84,37,0.37,0.325,0.275
"11837","145637",2008,7277,3386,3891,5015,2439,2576,76.08,0.7608,0.689,0.627
"11838","145691",2008,166,84,82,110,51,59,70.24,0.7024,0.663,0.622
"11839","145813",2008,3387,2088,1299,1545,503,1042,49.9,0.499,0.456,0.387
"11840","146481",2008,378,218,160,242,85,157,72.02,0.7202,0.64,0.531
"11841","146612",2008,650,345,305,272,127,145,42.03,0.4203,0.418,0.416
"11842","146719",2008,2176,1460,716,1419,448,971,66.51,0.6651,0.652,0.626
"11843","146825",2008,90,36,54,21,8,13,36.11,0.3611,0.233,0.148
"11844","147013",2008,308,145,163,110,40,70,48.28,0.4828,0.357,0.245
"11845","147244",2008,484,298,186,247,83,164,55.03,0.5503,0.51,0.446
"11846","147341",2008,383,179,204,182,84,98,54.75,0.5475,0.475,0.412
"11847","147703",2008,2844,1469,1375,718,315,403,27.43,0.2743,0.252,0.229
"11848","147767",2008,2077,1075,1002,1773,822,951,88.47,0.8847,0.854,0.82
"11849","147776",2008,952,519,433,48,18,30,5.78,0.0578,0.05,0.042
"11850","147828",2008,590,357,233,260,76,184,51.54,0.5154,0.441,0.326
"11851","148131",2008,245,108,137,81,31,50,46.3,0.463,0.331,0.226
"11852","148496",2008,416,291,125,198,59,139,47.77,0.4777,0.476,0.472
"11853","148584",2008,203,125,78,77,27,50,40,0.4,0.379,0.346
"11854","148627",2008,547,375,172,176,55,121,32.27,0.3227,0.322,0.32
"11855","149222",2008,2592,1183,1409,627,305,322,27.22,0.2722,0.242,0.216
"11856","149231",2008,1901,1101,800,545,194,351,31.88,0.3188,0.287,0.242
"11857","149772",2008,1806,881,925,536,278,258,29.28,0.2928,0.297,0.301
"11858","149781",2008,580,291,289,462,219,243,83.51,0.8351,0.797,0.758
"11859","150066",2008,540,316,224,259,97,162,51.27,0.5127,0.48,0.433
"11860","150136",2008,3983,2188,1795,1384,504,880,40.22,0.4022,0.347,0.281
"11861","150145",2008,242,149,93,132,45,87,58.39,0.5839,0.545,0.484
"11862","150163",2008,934,566,368,580,209,371,65.55,0.6555,0.621,0.568
"11863","150400",2008,600,341,259,448,172,276,80.94,0.8094,0.747,0.664
"11864","150534",2008,616,377,239,325,116,209,55.44,0.5544,0.528,0.485
"11865","150668",2008,172,97,75,95,36,59,60.82,0.6082,0.552,0.48
"11866","150941",2008,275,161,114,133,51,82,50.93,0.5093,0.484,0.447
"11867","151102",2008,1905,1009,896,118,36,82,8.13,0.0813,0.062,0.04
"11868","151111",2008,2802,1657,1145,463,170,293,17.68,0.1768,0.165,0.148
"11869","151306",2008,2055,1232,823,340,83,257,20.86,0.2086,0.165,0.101
"11870","151324",2008,1907,954,953,357,151,206,21.59,0.2159,0.187,0.158
"11871","151333",2008,341,212,129,31,6,25,11.79,0.1179,0.091,0.047
"11872","151342",2008,943,590,353,54,23,31,5.25,0.0525,0.057,0.065
"11873","151351",2008,7550,3990,3560,4485,1959,2526,63.31,0.6331,0.594,0.55
"11874","151360",2008,596,387,209,47,13,34,8.79,0.0879,0.079,0.062
"11875","151379",2008,970,590,380,81,26,55,9.32,0.0932,0.084,0.068
"11876","151388",2008,291,190,101,26,8,18,9.47,0.0947,0.089,0.079
"11877","151777",2008,396,202,194,190,77,113,55.94,0.5594,0.48,0.397
"11878","151786",2008,326,158,168,111,50,61,38.61,0.3861,0.34,0.298
"11879","152080",2008,1991,951,1040,1806,932,874,91.9,0.919,0.907,0.896
"11880","152248",2008,1213,624,589,108,50,58,9.29,0.0929,0.089,0.085
"11881","152363",2008,296,144,152,118,51,67,46.53,0.4653,0.399,0.336
"11882","152530",2008,465,266,199,312,115,197,74.06,0.7406,0.671,0.578
"11883","152600",2008,655,336,319,390,169,221,65.77,0.6577,0.595,0.53
"11884","153001",2008,273,117,156,96,46,50,42.74,0.4274,0.352,0.295
"11885","153108",2008,404,204,200,255,101,154,75.49,0.7549,0.631,0.505
"11886","153269",2008,901,544,357,507,199,308,56.62,0.5662,0.563,0.557
"11887","153384",2008,462,251,211,392,171,221,88.05,0.8805,0.848,0.81
"11888","153603",2008,4528,2074,2454,1787,772,1015,48.94,0.4894,0.395,0.315
"11889","153834",2008,630,371,259,469,194,275,74.12,0.7412,0.744,0.749
"11890","154095",2008,1972,1206,766,747,254,493,40.88,0.4088,0.379,0.332
"11891","155089",2008,169,100,69,20,2,18,18,0.18,0.118,0.029
"11892","155317",2008,4435,2260,2175,1649,670,979,43.32,0.4332,0.372,0.308
"11893","155335",2008,115,74,41,36,10,26,35.14,0.3514,0.313,0.244
"11894","155399",2008,3518,1780,1738,960,339,621,34.89,0.3489,0.273,0.195
"11895","155520",2008,208,114,94,69,25,44,38.6,0.386,0.332,0.266
"11896","155627",2008,201,100,101,40,17,23,23,0.23,0.199,0.168
"11897","155937",2008,150,71,79,44,15,29,40.85,0.4085,0.293,0.19
"11898","156213",2008,313,208,105,173,57,116,55.77,0.5577,0.553,0.543
"11899","156286",2008,567,356,211,301,109,192,53.93,0.5393,0.531,0.517
"11900","156295",2008,413,241,172,184,72,112,46.47,0.4647,0.446,0.419
"11901","156365",2008,442,192,250,112,56,56,29.17,0.2917,0.253,0.224
"11902","156541",2008,478,223,255,120,38,82,36.77,0.3677,0.251,0.149
"11903","156745",2008,379,209,170,169,61,108,51.67,0.5167,0.446,0.359
"11904","157058",2008,566,293,273,32,7,25,8.53,0.0853,0.057,0.026
"11905","157076",2008,219,103,116,81,44,37,35.92,0.3592,0.37,0.379
"11906","157085",2008,4074,2086,1988,1323,513,810,38.83,0.3883,0.325,0.258
"11907","157289",2008,2548,1344,1204,915,391,524,38.99,0.3899,0.359,0.325
"11908","157386",2008,1313,777,536,235,78,157,20.21,0.2021,0.179,0.146
"11909","157401",2008,1452,875,577,415,120,295,33.71,0.3371,0.286,0.208
"11910","157447",2008,2001,1117,884,252,77,175,15.67,0.1567,0.126,0.087
"11911","157535",2008,177,83,94,41,13,28,33.73,0.3373,0.232,0.138
"11912","157951",2008,3203,1821,1382,684,247,437,24,0.24,0.214,0.179
"11913","158477",2008,246,148,98,104,41,63,42.57,0.4257,0.423,0.418
"11914","159009",2008,1203,626,577,144,53,91,14.54,0.1454,0.12,0.092
"11915","159391",2008,5131,2781,2350,1900,699,1201,43.19,0.4319,0.37,0.297
"11916","159647",2008,1503,695,808,428,187,241,34.68,0.3468,0.285,0.231
"11917","159717",2008,1272,742,530,203,62,141,19,0.19,0.16,0.117
"11918","159966",2008,1217,712,505,207,60,147,20.65,0.2065,0.17,0.119
"11919","160038",2008,1183,736,447,225,69,156,21.2,0.212,0.19,0.154
"11920","160612",2008,2613,1538,1075,358,112,246,15.99,0.1599,0.137,0.104
"11921","160621",2008,1034,605,429,62,19,43,7.11,0.0711,0.06,0.044
"11922","160658",2008,2566,1435,1131,373,128,245,17.07,0.1707,0.145,0.113
"11923","161004",2008,488,232,256,420,203,217,93.53,0.9353,0.861,0.793
"11924","161226",2008,512,335,177,184,47,137,40.9,0.409,0.359,0.266
"11925","161235",2008,111,60,51,27,14,13,21.67,0.2167,0.243,0.275
"11926","161244",2008,105,62,43,23,8,15,24.19,0.2419,0.219,0.186
"11927","161253",2008,1931,947,984,717,320,397,41.92,0.4192,0.371,0.325
"11928","161554",2008,991,531,460,126,53,73,13.75,0.1375,0.127,0.115
"11929","162007",2008,664,393,271,52,12,40,10.18,0.1018,0.078,0.044
"11930","162210",2008,98,61,37,16,4,12,19.67,0.1967,0.163,0.108
"11931","162283",2008,570,428,142,28,6,22,5.14,0.0514,0.049,0.042
"11932","162584",2008,1030,478,552,201,86,115,24.06,0.2406,0.195,0.156
"11933","162654",2008,360,262,98,205,54,151,57.63,0.5763,0.569,0.551
"11934","162760",2008,308,200,108,179,57,122,61,0.61,0.581,0.528
"11935","162928",2008,1315,612,703,1140,587,553,90.36,0.9036,0.867,0.835
"11936","163046",2008,1066,637,429,825,307,518,81.32,0.8132,0.774,0.716
"11937","163268",2008,1555,650,905,531,237,294,45.23,0.4523,0.341,0.262
"11938","163286",2008,3907,1824,2083,2610,1298,1312,71.93,0.7193,0.668,0.623
"11939","163453",2008,1430,808,622,169,46,123,15.22,0.1522,0.118,0.074
"11940","163462",2008,410,218,192,236,99,137,62.84,0.6284,0.576,0.516
"11941","163851",2008,1198,694,504,533,151,382,55.04,0.5504,0.445,0.3
"11942","163912",2008,458,279,179,332,119,213,76.34,0.7634,0.725,0.665
"11943","164076",2008,2825,1786,1039,1210,385,825,46.19,0.4619,0.428,0.371
"11944","164173",2008,626,436,190,301,81,220,50.46,0.5046,0.481,0.426
"11945","164216",2008,415,248,167,291,108,183,73.79,0.7379,0.701,0.647
"11946","164270",2008,426,223,203,263,117,146,65.47,0.6547,0.617,0.576
"11947","164447",2008,371,185,186,102,46,56,30.27,0.3027,0.275,0.247
"11948","164492",2008,245,135,110,81,38,43,31.85,0.3185,0.331,0.345
"11949","164562",2008,606,357,249,402,151,251,70.31,0.7031,0.663,0.606
"11950","165015",2008,754,426,328,643,274,369,86.62,0.8662,0.853,0.835
"11951","165024",2008,1464,915,549,412,134,278,30.38,0.3038,0.281,0.244
"11952","165334",2008,586,348,238,424,162,262,75.29,0.7529,0.724,0.681
"11953","165662",2008,772,466,306,598,243,355,76.18,0.7618,0.775,0.794
"11954","165671",2008,480,346,134,268,73,195,56.36,0.5636,0.558,0.545
"11955","165820",2008,763,421,342,227,76,151,35.87,0.3587,0.298,0.222
"11956","165866",2008,644,450,194,213,49,164,36.44,0.3644,0.331,0.253
"11957","165936",2008,419,260,159,256,91,165,63.46,0.6346,0.611,0.572
"11958","166027",2008,1656,836,820,1420,677,743,88.88,0.8888,0.857,0.826
"11959","166124",2008,737,420,317,664,285,379,90.24,0.9024,0.901,0.899
"11960","166513",2008,1514,540,974,411,213,198,36.67,0.3667,0.271,0.219
"11961","166629",2008,4256,2200,2056,2594,1140,1454,66.09,0.6609,0.609,0.554
"11962","166638",2008,972,570,402,154,60,94,16.49,0.1649,0.158,0.149
"11963","166683",2008,1046,487,559,849,441,408,83.78,0.8378,0.812,0.789
"11964","167288",2008,325,193,132,109,38,71,36.79,0.3679,0.335,0.288
"11965","167987",2008,1768,837,931,485,210,275,32.86,0.3286,0.274,0.226
"11966","167996",2008,634,384,250,503,185,318,82.81,0.8281,0.793,0.74
"11967","168005",2008,1557,920,637,607,215,392,42.61,0.4261,0.39,0.338
"11968","168148",2008,1298,702,596,1141,511,630,89.74,0.8974,0.879,0.857
"11969","168254",2008,735,281,454,370,206,164,58.36,0.5836,0.503,0.454
"11970","168281",2008,420,259,161,313,116,197,76.06,0.7606,0.745,0.72
"11971","168342",2008,538,284,254,476,222,254,89.44,0.8944,0.885,0.874
"11972","168546",2008,485,242,243,297,137,160,66.12,0.6612,0.612,0.564
"11973","168786",2008,456,283,173,138,43,95,33.57,0.3357,0.303,0.249
"11974","169080",2008,935,500,435,539,235,304,60.8,0.608,0.576,0.54
"11975","169798",2008,2167,1283,884,269,84,185,14.42,0.1442,0.124,0.095
"11976","169910",2008,2103,992,1111,169,75,94,9.48,0.0948,0.08,0.068
"11977","170082",2008,3879,2413,1466,1216,403,813,33.69,0.3369,0.313,0.275
"11978","170301",2008,805,499,306,565,189,376,75.35,0.7535,0.702,0.618
"11979","170532",2008,364,200,164,279,128,151,75.5,0.755,0.766,0.78
"11980","170639",2008,490,250,240,72,32,40,16,0.16,0.147,0.133
"11981","170976",2008,5738,2905,2833,4336,1989,2347,80.79,0.8079,0.756,0.702
"11982","171100",2008,7385,4098,3287,3831,1442,2389,58.3,0.583,0.519,0.439
"11983","171128",2008,1361,318,1043,333,218,115,36.16,0.3616,0.245,0.209
"11984","171137",2008,905,436,469,145,60,85,19.5,0.195,0.16,0.128
"11985","171146",2008,846,512,334,78,31,47,9.18,0.0918,0.092,0.093
"11986","171599",2008,282,99,183,76,34,42,42.42,0.4242,0.27,0.186
"11987","172051",2008,1647,949,698,144,50,94,9.91,0.0991,0.087,0.072
"11988","172699",2008,3803,1934,1869,880,381,499,25.8,0.258,0.231,0.204
"11989","173160",2008,632,377,255,408,155,253,67.11,0.6711,0.646,0.608
"11990","173258",2008,488,244,244,444,220,224,91.8,0.918,0.91,0.902
"11991","173328",2008,211,116,95,60,25,35,30.17,0.3017,0.284,0.263
"11992","173647",2008,616,346,270,495,211,284,82.08,0.8208,0.804,0.781
"11993","173902",2008,478,279,199,401,161,240,86.02,0.8602,0.839,0.809
"11994","174066",2008,5089,2813,2276,2975,1224,1751,62.25,0.6225,0.585,0.538
"11995","174233",2008,2213,1110,1103,760,306,454,40.9,0.409,0.343,0.277
"11996","174251",2008,373,209,164,200,80,120,57.42,0.5742,0.536,0.488
"11997","174491",2008,455,273,182,202,62,140,51.28,0.5128,0.444,0.341
"11998","174792",2008,461,0,461,332,332,0,NA,NA,0.72,0.72
"11999","174844",2008,813,454,359,698,292,406,89.43,0.8943,0.859,0.813
"12000","174899",2008,575,381,194,314,93,221,58.01,0.5801,0.546,0.479
"12001","174914",2008,1321,638,683,792,374,418,65.52,0.6552,0.6,0.548
"12002","175342",2008,451,261,190,87,36,51,19.54,0.1954,0.193,0.189
"12003","175421",2008,239,146,93,79,27,52,35.62,0.3562,0.331,0.29
"12004","175616",2008,384,227,157,58,19,39,17.18,0.1718,0.151,0.121
"12005","175856",2008,938,547,391,177,48,129,23.58,0.2358,0.189,0.123
"12006","175980",2008,266,141,125,165,66,99,70.21,0.7021,0.62,0.528
"12007","176017",2008,2316,1272,1044,857,301,556,43.71,0.4371,0.37,0.288
"12008","176035",2008,252,212,40,54,7,47,22.17,0.2217,0.214,0.175
"12009","176044",2008,446,203,243,57,23,34,16.75,0.1675,0.128,0.095
"12010","176080",2008,2474,1278,1196,746,282,464,36.31,0.3631,0.302,0.236
"12011","176406",2008,237,158,79,68,19,49,31.01,0.3101,0.287,0.241
"12012","176628",2008,183,105,78,45,9,36,34.29,0.3429,0.246,0.115
"12013","176947",2008,300,141,159,110,47,63,44.68,0.4468,0.367,0.296
"12014","176965",2008,1583,854,729,463,185,278,32.55,0.3255,0.292,0.254
"12015","177418",2008,187,112,75,44,12,32,28.57,0.2857,0.235,0.16
"12016","178059",2008,318,236,82,149,39,110,46.61,0.4661,0.469,0.476
"12017","178341",2008,727,398,329,106,34,72,18.09,0.1809,0.146,0.103
"12018","178387",2008,956,536,420,146,44,102,19.03,0.1903,0.153,0.105
"12019","178396",2008,5698,3031,2667,2622,1004,1618,53.38,0.5338,0.46,0.376
"12020","178402",2008,971,589,382,218,68,150,25.47,0.2547,0.225,0.178
"12021","178411",2008,1036,234,802,253,181,72,30.77,0.3077,0.244,0.226
"12022","178420",2008,437,244,193,92,34,58,23.77,0.2377,0.211,0.176
"12023","178615",2008,1334,779,555,757,251,506,64.96,0.6496,0.567,0.452
"12024","179043",2008,358,237,121,223,69,154,64.98,0.6498,0.623,0.57
"12025","179159",2008,1624,923,701,945,365,580,62.84,0.6284,0.582,0.521
"12026","179557",2008,1672,1054,618,492,141,351,33.3,0.333,0.294,0.228
"12027","179566",2008,2532,1464,1068,785,258,527,36,0.36,0.31,0.242
"12028","179867",2008,1408,711,697,1270,605,665,93.53,0.9353,0.902,0.868
"12029","179894",2008,407,250,157,173,58,115,46,0.46,0.425,0.369
"12030","179946",2008,244,108,136,123,67,56,51.85,0.5185,0.504,0.493
"12031","180179",2008,692,402,290,47,14,33,8.21,0.0821,0.068,0.048
"12032","180461",2008,1805,765,1040,354,154,200,26.14,0.2614,0.196,0.148
"12033","180522",2008,199,70,129,14,5,9,12.86,0.1286,0.07,0.039
"12034","180984",2008,273,129,144,125,57,68,52.71,0.5271,0.458,0.396
"12035","181002",2008,984,582,402,647,257,390,67.01,0.6701,0.658,0.639
"12036","181020",2008,247,105,142,135,62,73,69.52,0.6952,0.547,0.437
"12037","181127",2008,320,151,169,153,63,90,59.6,0.596,0.478,0.373
"12038","181215",2008,1019,530,489,232,87,145,27.36,0.2736,0.228,0.178
"12039","181394",2008,1755,920,835,286,107,179,19.46,0.1946,0.163,0.128
"12040","181446",2008,383,212,171,211,76,135,63.68,0.6368,0.551,0.444
"12041","181464",2008,4164,2015,2149,1377,566,811,40.25,0.4025,0.331,0.263
"12042","181534",2008,210,101,109,23,10,13,12.87,0.1287,0.11,0.092
"12043","181783",2008,653,345,308,148,52,96,27.83,0.2783,0.227,0.169
"12044","182281",2008,3020,1709,1311,422,142,280,16.38,0.1638,0.14,0.108
"12045","182290",2008,2260,1211,1049,467,179,288,23.78,0.2378,0.207,0.171
"12046","182634",2008,376,251,125,138,44,94,37.45,0.3745,0.367,0.352
"12047","182795",2008,474,205,269,185,89,96,46.83,0.4683,0.39,0.331
"12048","183062",2008,1287,777,510,667,238,429,55.21,0.5521,0.518,0.467
"12049","183080",2008,1087,500,587,476,214,262,52.4,0.524,0.438,0.365
"12050","183239",2008,500,286,214,351,143,208,72.73,0.7273,0.702,0.668
"12051","183822",2008,392,237,155,23,10,13,5.49,0.0549,0.059,0.065
"12052","183974",2008,310,196,114,188,63,125,63.78,0.6378,0.606,0.553
"12053","184348",2008,390,256,134,222,75,147,57.42,0.5742,0.569,0.56
"12054","184603",2008,461,276,185,126,39,87,31.52,0.3152,0.273,0.211
"12055","184612",2008,245,170,75,42,9,33,19.41,0.1941,0.171,0.12
"12056","184782",2008,1174,516,658,502,269,233,45.16,0.4516,0.428,0.409
"12057","185129",2008,563,306,257,42,19,23,7.52,0.0752,0.075,0.074
"12058","185572",2008,960,549,411,473,187,286,52.09,0.5209,0.493,0.455
"12059","185590",2008,2257,1365,892,817,230,587,43,0.43,0.362,0.258
"12060","185828",2008,779,158,621,185,136,49,31.01,0.3101,0.237,0.219
"12061","186131",2008,1243,620,623,1121,545,576,92.9,0.929,0.902,0.875
"12062","186201",2008,877,513,364,511,177,334,65.11,0.6511,0.583,0.486
"12063","186283",2008,875,516,359,460,167,293,56.78,0.5678,0.526,0.465
"12064","186584",2008,1216,688,528,687,282,405,58.87,0.5887,0.565,0.534
"12065","186876",2008,840,458,382,425,156,269,58.73,0.5873,0.506,0.408
"12066","187134",2008,1295,763,532,939,356,583,76.41,0.7641,0.725,0.669
"12067","187444",2008,1204,617,587,215,75,140,22.69,0.2269,0.179,0.128
"12068","187985",2008,3148,1737,1411,459,161,298,17.16,0.1716,0.146,0.114
"12069","188030",2008,2171,1175,996,337,130,207,17.62,0.1762,0.155,0.131
"12070","188429",2008,944,614,330,510,146,364,59.28,0.5928,0.54,0.442
"12071","188641",2008,502,219,283,193,99,94,42.92,0.4292,0.384,0.35
"12072","190044",2008,734,204,530,407,274,133,65.2,0.652,0.554,0.517
"12073","190099",2008,737,386,351,661,307,354,91.71,0.9171,0.897,0.875
"12074","190150",2008,1374,653,721,1208,613,595,91.12,0.9112,0.879,0.85
"12075","190248",2008,104,58,46,40,12,28,48.28,0.4828,0.385,0.261
"12076","190415",2008,3132,1573,1559,2718,1307,1411,89.7,0.897,0.868,0.838
"12077","190512",2008,1497,693,804,530,250,280,40.4,0.404,0.354,0.311
"12078","190549",2008,1330,792,538,319,107,212,26.77,0.2677,0.24,0.199
"12079","190558",2008,2282,1209,1073,112,47,65,5.38,0.0538,0.049,0.044
"12080","190567",2008,1744,919,825,182,67,115,12.51,0.1251,0.104,0.081
"12081","190594",2008,1988,1273,715,445,108,337,26.47,0.2647,0.224,0.151
"12082","190637",2008,987,654,333,139,40,99,15.14,0.1514,0.141,0.12
"12083","190664",2008,1642,961,681,445,125,320,33.3,0.333,0.271,0.184
"12084","190691",2008,1024,673,351,80,26,54,8.02,0.0802,0.078,0.074
"12085","190725",2008,405,309,96,110,24,86,27.83,0.2783,0.272,0.25
"12086","191241",2008,1852,991,861,1385,629,756,76.29,0.7629,0.748,0.731
"12087","191515",2008,461,257,204,396,164,232,90.27,0.9027,0.859,0.804
"12088","191533",2008,444,250,194,224,91,133,53.2,0.532,0.505,0.469
"12089","191630",2008,544,288,256,404,179,225,78.12,0.7812,0.743,0.699
"12090","191649",2008,1637,864,773,816,344,472,54.63,0.5463,0.498,0.445
"12091","191676",2008,327,211,116,193,56,137,64.93,0.6493,0.59,0.483
"12092","191931",2008,921,498,423,469,167,302,60.64,0.6064,0.509,0.395
"12093","191968",2008,1441,862,579,1017,397,620,71.93,0.7193,0.706,0.686
"12094","192192",2008,270,200,70,98,21,77,38.5,0.385,0.363,0.3
"12095","192323",2008,541,335,206,331,114,217,64.78,0.6478,0.612,0.553
"12096","192439",2008,992,706,286,73,18,55,7.79,0.0779,0.074,0.063
"12097","192703",2008,726,351,375,475,226,249,70.94,0.7094,0.654,0.603
"12098","192749",2008,476,326,150,270,82,188,57.67,0.5767,0.567,0.547
"12099","192819",2008,1018,611,407,697,249,448,73.32,0.7332,0.685,0.612
"12100","192925",2008,408,253,155,105,49,56,22.13,0.2213,0.257,0.316
"12101","193016",2008,677,441,236,92,14,78,17.69,0.1769,0.136,0.059
"12102","193292",2008,393,288,105,156,32,124,43.06,0.4306,0.397,0.305
"12103","193353",2008,432,318,114,191,50,141,44.34,0.4434,0.442,0.439
"12104","193399",2008,374,267,107,146,34,112,41.95,0.4195,0.39,0.318
"12105","193584",2008,471,361,110,306,62,244,67.59,0.6759,0.65,0.564
"12106","193645",2008,504,461,43,86,2,84,18.22,0.1822,0.171,0.047
"12107","193654",2008,1058,746,312,482,113,369,49.46,0.4946,0.456,0.362
"12108","193900",2008,4786,2738,2048,2740,1134,1606,58.66,0.5866,0.573,0.554
"12109","193973",2008,738,454,284,435,146,289,63.66,0.6366,0.589,0.514
"12110","194161",2008,253,140,113,61,22,39,27.86,0.2786,0.241,0.195
"12111","194310",2008,1616,1002,614,589,208,381,38.02,0.3802,0.364,0.339
"12112","194824",2008,1355,380,975,833,599,234,61.58,0.6158,0.615,0.614
"12113","195003",2008,2594,848,1746,706,357,349,41.16,0.4116,0.272,0.204
"12114","195030",2008,1282,642,640,936,442,494,76.95,0.7695,0.73,0.691
"12115","195164",2008,563,315,248,310,113,197,62.54,0.6254,0.551,0.456
"12116","195173",2008,566,292,274,160,68,92,31.51,0.3151,0.283,0.248
"12117","195216",2008,616,334,282,490,220,270,80.84,0.8084,0.795,0.78
"12118","195234",2008,574,415,159,312,72,240,57.83,0.5783,0.544,0.453
"12119","195243",2008,352,213,139,140,44,96,45.07,0.4507,0.398,0.317
"12120","195304",2008,348,273,75,246,57,189,69.23,0.6923,0.707,0.76
"12121","195474",2008,824,444,380,613,272,341,76.8,0.768,0.744,0.716
"12122","195526",2008,652,400,252,552,212,340,85,0.85,0.847,0.841
"12123","195544",2008,613,420,193,326,84,242,57.62,0.5762,0.532,0.435
"12124","195809",2008,3258,1737,1521,1294,521,773,44.5,0.445,0.397,0.343
"12125","196413",2008,3161,1853,1308,2173,846,1327,71.61,0.7161,0.687,0.647
"12126","196592",2008,790,486,304,69,27,42,8.64,0.0864,0.087,0.089
"12127","197045",2008,568,254,314,171,82,89,35.04,0.3504,0.301,0.261
"12128","197133",2008,638,365,273,560,235,325,89.04,0.8904,0.878,0.861
"12129","197869",2008,2768,1415,1353,1221,462,759,53.64,0.5364,0.441,0.341
"12130","197984",2008,286,134,152,93,39,54,40.3,0.403,0.325,0.257
"12131","198385",2008,480,250,230,436,209,227,90.8,0.908,0.908,0.909
"12132","198464",2008,4515,2608,1907,1468,483,985,37.77,0.3777,0.325,0.253
"12133","198507",2008,636,368,268,95,25,70,19.02,0.1902,0.149,0.093
"12134","198516",2008,1290,777,513,977,358,619,79.67,0.7967,0.757,0.698
"12135","198835",2008,345,217,128,140,32,108,49.77,0.4977,0.406,0.25
"12136","198969",2008,439,148,291,64,26,38,25.68,0.2568,0.146,0.089
"12137","199102",2008,1592,848,744,342,105,237,27.95,0.2795,0.215,0.141
"12138","199111",2008,586,361,225,225,77,148,41,0.41,0.384,0.342
"12139","199120",2008,3852,2270,1582,3096,1188,1908,84.05,0.8405,0.804,0.751
"12140","199139",2008,3059,1610,1449,766,289,477,29.63,0.2963,0.25,0.199
"12141","199148",2008,2471,1703,768,759,183,576,33.82,0.3382,0.307,0.238
"12142","199157",2008,1026,683,343,224,56,168,24.6,0.246,0.218,0.163
"12143","199193",2008,4792,2184,2608,2029,863,1166,53.39,0.5339,0.423,0.331
"12144","199218",2008,2069,1229,840,1017,326,691,56.22,0.5622,0.492,0.388
"12145","199281",2008,1054,563,491,157,50,107,19.01,0.1901,0.149,0.102
"12146","199306",2008,192,91,101,48,15,33,36.26,0.3626,0.25,0.149
"12147","199412",2008,307,214,93,164,49,115,53.74,0.5374,0.534,0.527
"12148","199582",2008,484,233,251,87,33,54,23.18,0.2318,0.18,0.131
"12149","199643",2008,532,308,224,64,21,43,13.96,0.1396,0.12,0.094
"12150","199847",2008,1197,621,576,991,455,536,86.31,0.8631,0.828,0.79
"12151","199962",2008,431,223,208,183,79,104,46.64,0.4664,0.425,0.38
"12152","199999",2008,1353,886,467,234,62,172,19.41,0.1941,0.173,0.133
"12153","200004",2008,1218,617,601,485,198,287,46.52,0.4652,0.398,0.329
"12154","200059",2008,320,142,178,34,16,18,12.68,0.1268,0.106,0.09
"12155","200156",2008,267,123,144,74,27,47,38.21,0.3821,0.277,0.188
"12156","200217",2008,373,227,146,108,25,83,36.56,0.3656,0.29,0.171
"12157","200226",2008,89,52,37,17,5,12,23.08,0.2308,0.191,0.135
"12158","200253",2008,406,259,147,55,11,44,16.99,0.1699,0.135,0.075
"12159","200280",2008,1923,896,1027,450,214,236,26.34,0.2634,0.234,0.208
"12160","200332",2008,2650,1182,1468,667,326,341,28.85,0.2885,0.252,0.222
"12161","200572",2008,154,70,84,35,14,21,30,0.3,0.227,0.167
"12162","201104",2008,570,306,264,236,83,153,50,0.5,0.414,0.314
"12163","201371",2008,272,140,132,144,62,82,58.57,0.5857,0.529,0.47
"12164","201548",2008,632,354,278,321,122,199,56.21,0.5621,0.508,0.439
"12165","201645",2008,1023,442,581,651,337,314,71.04,0.7104,0.636,0.58
"12166","201690",2008,646,330,316,72,10,62,18.79,0.1879,0.111,0.032
"12167","202134",2008,1005,548,457,150,50,100,18.25,0.1825,0.149,0.109
"12168","202480",2008,1985,1045,940,1177,452,725,69.38,0.6938,0.593,0.481
"12169","202523",2008,604,325,279,476,202,274,84.31,0.8431,0.788,0.724
"12170","202763",2008,562,391,171,242,56,186,47.57,0.4757,0.431,0.327
"12171","203085",2008,402,177,225,142,61,81,45.76,0.4576,0.353,0.271
"12172","203128",2008,331,164,167,189,82,107,65.24,0.6524,0.571,0.491
"12173","203368",2008,789,393,396,473,209,264,67.18,0.6718,0.599,0.528
"12174","203517",2008,3684,2261,1423,1135,325,810,35.82,0.3582,0.308,0.228
"12175","203535",2008,455,237,218,404,192,212,89.45,0.8945,0.888,0.881
"12176","203580",2008,249,131,118,91,29,62,47.33,0.4733,0.365,0.246
"12177","203775",2008,389,233,156,147,44,103,44.21,0.4421,0.378,0.282
"12178","203845",2008,385,178,207,201,95,106,59.55,0.5955,0.522,0.459
"12179","204024",2008,3598,1955,1643,2357,959,1398,71.51,0.7151,0.655,0.584
"12180","204185",2008,663,321,342,336,126,210,65.42,0.6542,0.507,0.368
"12181","204194",2008,368,234,134,183,66,117,50,0.5,0.497,0.493
"12182","204617",2008,356,194,162,113,49,64,32.99,0.3299,0.317,0.302
"12183","204796",2008,6151,3068,3083,3780,1643,2137,69.65,0.6965,0.615,0.533
"12184","204857",2008,3908,2114,1794,1910,769,1141,53.97,0.5397,0.489,0.429
"12185","206330",2008,226,72,154,67,32,35,48.61,0.4861,0.296,0.208
"12186","206589",2008,518,267,251,364,160,204,76.4,0.764,0.703,0.637
"12187","206604",2008,2596,1496,1100,556,193,363,24.26,0.2426,0.214,0.175
"12188","206622",2008,859,436,423,542,244,298,68.35,0.6835,0.631,0.577
"12189","206695",2008,2189,1090,1099,199,74,125,11.47,0.1147,0.091,0.067
"12190","206914",2008,817,457,360,66,22,44,9.63,0.0963,0.081,0.061
"12191","207209",2008,593,281,312,19,2,17,6.05,0.0605,0.032,0.006
"12192","207306",2008,317,162,155,47,14,33,20.37,0.2037,0.148,0.09
"12193","207324",2008,430,206,224,113,50,63,30.58,0.3058,0.263,0.223
"12194","207388",2008,2946,1501,1445,992,361,631,42.04,0.4204,0.337,0.25
"12195","207500",2008,3750,2058,1692,1394,525,869,42.23,0.4223,0.372,0.31
"12196","207722",2008,203,126,77,88,28,60,47.62,0.4762,0.433,0.364
"12197","207847",2008,583,296,287,68,29,39,13.18,0.1318,0.117,0.101
"12198","207865",2008,920,511,409,124,41,83,16.24,0.1624,0.135,0.1
"12199","208822",2008,401,245,156,204,74,130,53.06,0.5306,0.509,0.474
"12200","209056",2008,534,323,211,381,135,246,76.16,0.7616,0.713,0.64
"12201","209065",2008,474,274,200,290,106,184,67.15,0.6715,0.612,0.53
"12202","209542",2008,3006,1422,1584,922,373,549,38.61,0.3861,0.307,0.235
"12203","209551",2008,4191,2129,2062,1903,824,1079,50.68,0.5068,0.454,0.4
"12204","209612",2008,345,227,118,174,60,114,50.22,0.5022,0.504,0.508
"12205","209807",2008,1567,839,728,264,105,159,18.95,0.1895,0.168,0.144
"12206","209922",2008,329,194,135,219,88,131,67.53,0.6753,0.666,0.652
"12207","210146",2008,675,407,268,147,46,101,24.82,0.2482,0.218,0.172
"12208","210401",2008,482,278,204,333,129,204,73.38,0.7338,0.691,0.632
"12209","210429",2008,882,524,358,197,58,139,26.53,0.2653,0.223,0.162
"12210","210571",2008,505,260,245,224,86,138,53.08,0.5308,0.444,0.351
"12211","210669",2008,562,306,256,412,179,233,76.14,0.7614,0.733,0.699
"12212","210775",2008,383,233,150,148,44,104,44.64,0.4464,0.386,0.293
"12213","211088",2008,593,434,159,294,73,221,50.92,0.5092,0.496,0.459
"12214","211158",2008,1805,1028,777,781,263,518,50.39,0.5039,0.433,0.338
"12215","211291",2008,956,529,427,814,357,457,86.39,0.8639,0.851,0.836
"12216","211352",2008,503,341,162,210,62,148,43.4,0.434,0.417,0.383
"12217","211361",2008,1363,748,615,355,130,225,30.08,0.3008,0.26,0.211
"12218","211431",2008,226,215,11,99,2,97,45.12,0.4512,0.438,0.182
"12219","211440",2008,1462,625,837,1050,580,470,75.2,0.752,0.718,0.693
"12220","211468",2008,194,194,0,114,0,114,58.76,0.5876,0.588,NA
"12221","211556",2008,176,176,0,82,0,82,46.59,0.4659,0.466,NA
"12222","211583",2008,194,115,79,72,24,48,41.74,0.4174,0.371,0.304
"12223","211608",2008,280,157,123,31,6,25,15.92,0.1592,0.111,0.049
"12224","211644",2008,1305,747,558,355,116,239,31.99,0.3199,0.272,0.208
"12225","211981",2008,429,253,176,220,78,142,56.13,0.5613,0.513,0.443
"12226","212009",2008,613,337,276,495,204,291,86.35,0.8635,0.808,0.739
"12227","212054",2008,2402,992,1410,579,206,373,37.6,0.376,0.241,0.146
"12228","212106",2008,1425,838,587,801,308,493,58.83,0.5883,0.562,0.525
"12229","212115",2008,1262,655,607,458,167,291,44.43,0.4443,0.363,0.275
"12230","212133",2008,550,367,183,233,68,165,44.96,0.4496,0.424,0.372
"12231","212160",2008,1219,697,522,245,77,168,24.1,0.241,0.201,0.148
"12232","212197",2008,508,331,177,328,114,214,64.65,0.6465,0.646,0.644
"12233","212577",2008,588,321,267,485,210,275,85.67,0.8567,0.825,0.787
"12234","212601",2008,620,367,253,289,106,183,49.86,0.4986,0.466,0.419
"12235","212832",2008,339,223,116,56,23,33,14.8,0.148,0.165,0.198
"12236","212911",2008,327,182,145,287,124,163,89.56,0.8956,0.878,0.855
"12237","213020",2008,3065,1790,1275,1041,323,718,40.11,0.4011,0.34,0.253
"12238","213251",2008,461,260,201,332,134,198,76.15,0.7615,0.72,0.667
"12239","213321",2008,559,295,264,315,134,181,61.36,0.6136,0.564,0.508
"12240","213349",2008,1812,1034,778,680,206,474,45.84,0.4584,0.375,0.265
"12241","213358",2008,227,148,79,60,15,45,30.41,0.3041,0.264,0.19
"12242","213367",2008,902,519,383,471,190,281,54.14,0.5414,0.522,0.496
"12243","213385",2008,600,270,330,530,280,250,92.59,0.9259,0.883,0.848
"12244","213507",2008,395,217,178,276,110,166,76.5,0.765,0.699,0.618
"12245","213543",2008,1205,516,689,910,484,426,82.56,0.8256,0.755,0.702
"12246","213613",2008,1269,731,538,340,119,221,30.23,0.3023,0.268,0.221
"12247","213668",2008,340,161,179,178,77,101,62.73,0.6273,0.524,0.43
"12248","213783",2008,665,410,255,203,67,136,33.17,0.3317,0.305,0.263
"12249","213826",2008,422,291,131,238,62,176,60.48,0.6048,0.564,0.473
"12250","213996",2008,709,448,261,529,186,343,76.56,0.7656,0.746,0.713
"12251","214041",2008,1311,729,582,503,190,313,42.94,0.4294,0.384,0.326
"12252","214069",2008,378,248,130,238,72,166,66.94,0.6694,0.63,0.554
"12253","214157",2008,387,226,161,253,94,159,70.35,0.7035,0.654,0.584
"12254","214175",2008,597,344,253,484,197,287,83.43,0.8343,0.811,0.779
"12255","214272",2008,539,348,191,185,51,134,38.51,0.3851,0.343,0.267
"12256","214777",2008,7241,3428,3813,4746,2226,2520,73.51,0.7351,0.655,0.584
"12257","215062",2008,2392,1278,1114,2078,943,1135,88.81,0.8881,0.869,0.846
"12258","215743",2008,412,224,188,254,99,155,69.2,0.692,0.617,0.527
"12259","215798",2008,442,195,247,302,167,135,69.23,0.6923,0.683,0.676
"12260","215929",2008,961,555,406,710,274,436,78.56,0.7856,0.739,0.675
"12261","216010",2008,1716,871,845,638,247,391,44.89,0.4489,0.372,0.292
"12262","216038",2008,1527,887,640,749,272,477,53.78,0.5378,0.491,0.425
"12263","216287",2008,372,184,188,330,159,171,92.93,0.9293,0.887,0.846
"12264","216339",2008,4157,2260,1897,1718,663,1055,46.68,0.4668,0.413,0.349
"12265","216524",2008,543,304,239,428,181,247,81.25,0.8125,0.788,0.757
"12266","216694",2008,376,218,158,195,76,119,54.59,0.5459,0.519,0.481
"12267","216764",2008,1992,1231,761,872,232,640,51.99,0.5199,0.438,0.305
"12268","216807",2008,441,246,195,313,128,185,75.2,0.752,0.71,0.656
"12269","216852",2008,718,337,381,266,121,145,43.03,0.4303,0.37,0.318
"12270","216931",2008,559,290,269,249,114,135,46.55,0.4655,0.445,0.424
"12271","217059",2008,1097,580,517,427,185,242,41.72,0.4172,0.389,0.358
"12272","217156",2008,1546,813,733,1307,612,695,85.49,0.8549,0.845,0.835
"12273","217402",2008,987,575,412,821,336,485,84.35,0.8435,0.832,0.816
"12274","217536",2008,556,382,174,355,94,261,68.32,0.6832,0.638,0.54
"12275","217776",2008,142,84,58,52,13,39,46.43,0.4643,0.366,0.224
"12276","217819",2008,1949,1296,653,1070,318,752,58.02,0.5802,0.549,0.487
"12277","217882",2008,2866,1412,1454,1747,737,1010,71.53,0.7153,0.61,0.507
"12278","217998",2008,163,83,80,72,32,40,48.19,0.4819,0.442,0.4
"12279","218061",2008,676,452,224,104,34,70,15.49,0.1549,0.154,0.152
"12280","218229",2008,554,398,156,162,39,123,30.9,0.309,0.292,0.25
"12281","218238",2008,229,98,131,29,8,21,21.43,0.2143,0.127,0.061
"12282","218399",2008,292,162,130,37,6,31,19.14,0.1914,0.127,0.046
"12283","218414",2008,297,118,179,78,27,51,43.22,0.4322,0.263,0.151
"12284","218663",2008,3826,2133,1693,2129,812,1317,61.74,0.6174,0.556,0.48
"12285","218724",2008,1641,835,806,422,157,265,31.74,0.3174,0.257,0.195
"12286","218733",2008,923,484,439,138,38,100,20.66,0.2066,0.15,0.087
"12287","218742",2008,708,455,253,164,47,117,25.71,0.2571,0.232,0.186
"12288","218973",2008,415,203,212,296,140,156,76.85,0.7685,0.713,0.66
"12289","219000",2008,426,292,134,211,50,161,55.14,0.5514,0.495,0.373
"12290","219046",2008,545,345,200,64,17,47,13.62,0.1362,0.117,0.085
"12291","219082",2008,258,121,137,45,18,27,22.31,0.2231,0.174,0.131
"12292","219198",2008,136,88,48,66,20,46,52.27,0.5227,0.485,0.417
"12293","219259",2008,389,204,185,67,16,51,25,0.25,0.172,0.086
"12294","219356",2008,2008,987,1021,563,237,326,33.03,0.3303,0.28,0.232
"12295","219471",2008,1023,597,426,295,111,184,30.82,0.3082,0.288,0.261
"12296","219602",2008,1326,806,520,208,70,138,17.12,0.1712,0.157,0.135
"12297","219709",2008,928,519,409,520,217,303,58.38,0.5838,0.56,0.531
"12298","219718",2008,268,122,146,57,19,38,31.15,0.3115,0.213,0.13
"12299","219949",2008,194,82,112,43,20,23,28.05,0.2805,0.222,0.179
"12300","220075",2008,1932,1069,863,380,133,247,23.11,0.2311,0.197,0.154
"12301","220215",2008,405,220,185,154,61,93,42.27,0.4227,0.38,0.33
"12302","220613",2008,848,501,347,333,103,230,45.91,0.4591,0.393,0.297
"12303","220631",2008,256,169,87,31,10,21,12.43,0.1243,0.121,0.115
"12304","220710",2008,297,146,151,120,50,70,47.95,0.4795,0.404,0.331
"12305","221351",2008,475,276,199,353,143,210,76.09,0.7609,0.743,0.719
"12306","221519",2008,409,199,210,310,149,161,80.9,0.809,0.758,0.71
"12307","221731",2008,251,141,110,77,30,47,33.33,0.3333,0.307,0.273
"12308","221847",2008,1659,736,923,379,165,214,29.08,0.2908,0.228,0.179
"12309","221892",2008,218,125,93,86,31,55,44,0.44,0.394,0.333
"12310","222178",2008,971,518,453,434,167,267,51.54,0.5154,0.447,0.369
"12311","222983",2008,318,191,127,229,88,141,73.82,0.7382,0.72,0.693
"12312","223232",2008,3054,1801,1253,1669,594,1075,59.69,0.5969,0.546,0.474
"12313","224004",2008,229,129,100,44,16,28,21.71,0.2171,0.192,0.16
"12314","224323",2008,341,168,173,216,104,112,66.67,0.6667,0.633,0.601
"12315","225432",2008,699,400,299,20,9,11,2.75,0.0275,0.029,0.03
"12316","225548",2008,304,128,176,107,48,59,46.09,0.4609,0.352,0.273
"12317","225627",2008,880,553,327,157,39,118,21.34,0.2134,0.178,0.119
"12318","226231",2008,340,106,234,118,76,42,39.62,0.3962,0.347,0.325
"12319","226833",2008,706,405,301,119,44,75,18.52,0.1852,0.169,0.146
"12320","227216",2008,3442,1928,1514,891,271,620,32.16,0.3216,0.259,0.179
"12321","227331",2008,306,213,93,67,14,53,24.88,0.2488,0.219,0.151
"12322","227526",2008,1290,761,529,355,112,243,31.93,0.3193,0.275,0.212
"12323","227757",2008,777,386,391,636,307,329,85.23,0.8523,0.819,0.785
"12324","227845",2008,741,480,261,397,121,276,57.5,0.575,0.536,0.464
"12325","227863",2008,293,187,106,101,30,71,37.97,0.3797,0.345,0.283
"12326","228042",2008,266,145,121,84,34,50,34.48,0.3448,0.316,0.281
"12327","228149",2008,535,335,200,237,63,174,51.94,0.5194,0.443,0.315
"12328","228246",2008,1397,751,646,941,404,537,71.5,0.715,0.674,0.625
"12329","228343",2008,349,216,133,227,78,149,68.98,0.6898,0.65,0.586
"12330","228431",2008,2480,1545,935,590,131,459,29.71,0.2971,0.238,0.14
"12331","228459",2008,3444,2051,1393,916,289,627,30.57,0.3057,0.266,0.207
"12332","228501",2008,315,124,191,43,18,25,20.16,0.2016,0.137,0.094
"12333","228529",2008,1274,722,552,276,92,184,25.48,0.2548,0.217,0.167
"12334","228705",2008,737,310,427,124,70,54,17.42,0.1742,0.168,0.164
"12335","228723",2008,8038,3940,4098,3989,1575,2414,61.27,0.6127,0.496,0.384
"12336","228769",2008,2254,1106,1148,396,151,245,22.15,0.2215,0.176,0.132
"12337","228778",2008,6679,3679,3000,3487,1358,2129,57.87,0.5787,0.522,0.453
"12338","228787",2008,1090,434,656,553,280,273,62.9,0.629,0.507,0.427
"12339","228796",2008,2060,1006,1054,251,83,168,16.7,0.167,0.122,0.079
"12340","228875",2008,1628,996,632,954,309,645,64.76,0.6476,0.586,0.489
"12341","228981",2008,396,191,205,123,44,79,41.36,0.4136,0.311,0.215
"12342","229018",2008,332,176,156,65,19,46,26.14,0.2614,0.196,0.122
"12343","229027",2008,4758,2432,2326,512,198,314,12.91,0.1291,0.108,0.085
"12344","229115",2008,4338,2056,2282,1413,560,853,41.49,0.4149,0.326,0.245
"12345","229780",2008,197,88,109,23,9,14,15.91,0.1591,0.117,0.083
"12346","229814",2008,1149,599,550,259,83,176,29.38,0.2938,0.225,0.151
"12347","230603",2008,836,574,262,169,29,140,24.39,0.2439,0.202,0.111
"12348","230728",2008,2580,1646,934,484,83,401,24.36,0.2436,0.188,0.089
"12349","230764",2008,1908,1054,854,465,171,294,27.89,0.2789,0.244,0.2
"12350","230782",2008,1549,853,696,136,41,95,11.14,0.1114,0.088,0.059
"12351","231059",2008,543,277,266,396,180,216,77.98,0.7798,0.729,0.677
"12352","231174",2008,2453,1457,996,1611,617,994,68.22,0.6822,0.657,0.619
"12353","231420",2008,234,88,146,53,17,36,40.91,0.4091,0.226,0.116
"12354","231554",2008,80,47,33,29,8,21,44.68,0.4468,0.362,0.242
"12355","231624",2008,1381,780,601,1146,462,684,87.69,0.8769,0.83,0.769
"12356","231712",2008,1134,640,494,624,207,417,65.16,0.6516,0.55,0.419
"12357","232025",2008,241,123,118,87,31,56,45.53,0.4553,0.361,0.263
"12358","232043",2008,183,103,80,90,35,55,53.4,0.534,0.492,0.438
"12359","232089",2008,581,253,328,80,26,54,21.34,0.2134,0.138,0.079
"12360","232186",2008,2476,1328,1148,1099,406,693,52.18,0.5218,0.444,0.354
"12361","232265",2008,1190,792,398,489,120,369,46.59,0.4659,0.411,0.302
"12362","232423",2008,3956,2425,1531,2577,876,1701,70.14,0.7014,0.651,0.572
"12363","232557",2008,3063,1663,1400,857,314,543,32.65,0.3265,0.28,0.224
"12364","232566",2008,1043,700,343,467,104,363,51.86,0.5186,0.448,0.303
"12365","232609",2008,593,336,257,252,85,167,49.7,0.497,0.425,0.331
"12366","232681",2008,848,553,295,539,160,379,68.54,0.6854,0.636,0.542
"12367","232706",2008,404,294,110,141,25,116,39.46,0.3946,0.349,0.227
"12368","232937",2008,1143,657,486,182,53,129,19.63,0.1963,0.159,0.109
"12369","232982",2008,2757,1381,1376,652,233,419,30.34,0.3034,0.236,0.169
"12370","233277",2008,1871,1119,752,809,261,548,48.97,0.4897,0.432,0.347
"12371","233374",2008,737,412,325,591,255,336,81.55,0.8155,0.802,0.785
"12372","233426",2008,529,284,245,302,115,187,65.85,0.6585,0.571,0.469
"12373","233541",2008,399,200,199,145,52,93,46.5,0.465,0.363,0.261
"12374","233897",2008,427,194,233,98,42,56,28.87,0.2887,0.23,0.18
"12375","233921",2008,5449,2449,3000,3306,1509,1797,73.38,0.7338,0.607,0.503
"12376","234030",2008,3640,2128,1512,1227,429,798,37.5,0.375,0.337,0.284
"12377","234085",2008,391,33,358,210,192,18,54.55,0.5455,0.537,0.536
"12378","234155",2008,1323,832,491,302,64,238,28.61,0.2861,0.228,0.13
"12379","234164",2008,345,170,175,48,20,28,16.47,0.1647,0.139,0.114
"12380","235097",2008,1488,859,629,295,110,185,21.54,0.2154,0.198,0.175
"12381","235167",2008,658,321,337,302,146,156,48.6,0.486,0.459,0.433
"12382","236230",2008,712,444,268,372,115,257,57.88,0.5788,0.522,0.429
"12383","236328",2008,676,377,299,459,187,272,72.15,0.7215,0.679,0.625
"12384","236577",2008,712,492,220,431,122,309,62.8,0.628,0.605,0.555
"12385","236595",2008,881,557,324,530,170,360,64.63,0.6463,0.602,0.525
"12386","236896",2008,310,158,152,63,24,39,24.68,0.2468,0.203,0.158
"12387","236939",2008,3391,1744,1647,1408,536,872,50,0.5,0.415,0.325
"12388","236948",2008,5377,2896,2481,3296,1351,1945,67.16,0.6716,0.613,0.545
"12389","237011",2008,2667,1560,1107,1057,328,729,46.73,0.4673,0.396,0.296
"12390","237057",2008,401,230,171,328,130,198,86.09,0.8609,0.818,0.76
"12391","237066",2008,545,289,256,354,149,205,70.93,0.7093,0.65,0.582
"12392","237215",2008,270,156,114,33,15,18,11.54,0.1154,0.122,0.132
"12393","237330",2008,706,380,326,128,38,90,23.68,0.2368,0.181,0.117
"12394","237358",2008,129,68,61,35,19,16,23.53,0.2353,0.271,0.311
"12395","237367",2008,755,370,385,116,52,64,17.3,0.173,0.154,0.135
"12396","237792",2008,698,395,303,137,42,95,24.05,0.2405,0.196,0.139
"12397","237899",2008,302,147,155,16,5,11,7.48,0.0748,0.053,0.032
"12398","237932",2008,550,299,251,96,30,66,22.07,0.2207,0.175,0.12
"12399","237969",2008,382,208,174,168,63,105,50.48,0.5048,0.44,0.362
"12400","238032",2008,5083,2300,2783,1656,766,890,38.7,0.387,0.326,0.275
"12401","238333",2008,337,182,155,240,104,136,74.73,0.7473,0.712,0.671
"12402","238430",2008,258,177,81,39,14,25,14.12,0.1412,0.151,0.173
"12403","238458",2008,655,447,208,263,77,186,41.61,0.4161,0.402,0.37
"12404","238476",2008,753,359,394,405,192,213,59.33,0.5933,0.538,0.487
"12405","238616",2008,402,222,180,139,59,80,36.04,0.3604,0.346,0.328
"12406","238661",2008,298,219,79,108,29,79,36.07,0.3607,0.362,0.367
"12407","239080",2008,284,210,74,103,15,88,41.9,0.419,0.363,0.203
"12408","239105",2008,1950,1043,907,1153,481,672,64.43,0.6443,0.591,0.53
"12409","239628",2008,282,143,139,145,59,86,60.14,0.6014,0.514,0.424
"12410","239716",2008,531,293,238,335,131,204,69.62,0.6962,0.631,0.55
"12411","240107",2008,357,250,107,102,27,75,30,0.3,0.286,0.252
"12412","240189",2008,2132,1025,1107,575,276,299,29.17,0.2917,0.27,0.249
"12413","240277",2008,1000,614,386,236,67,169,27.52,0.2752,0.236,0.174
"12414","240329",2008,1779,1081,698,577,192,385,35.62,0.3562,0.324,0.275
"12415","240338",2008,223,128,95,110,43,67,52.34,0.5234,0.493,0.453
"12416","240365",2008,1807,1048,759,294,112,182,17.37,0.1737,0.163,0.148
"12417","240374",2008,833,420,413,70,36,34,8.1,0.081,0.084,0.087
"12418","240417",2008,1633,837,796,313,103,210,25.09,0.2509,0.192,0.129
"12419","240426",2008,303,168,135,59,15,44,26.19,0.2619,0.195,0.111
"12420","240444",2008,5759,3027,2732,3148,1333,1815,59.96,0.5996,0.547,0.488
"12421","240453",2008,4002,2100,1902,572,246,326,15.52,0.1552,0.143,0.129
"12422","240462",2008,1468,496,972,235,117,118,23.79,0.2379,0.16,0.12
"12423","240471",2008,1332,783,549,365,136,229,29.25,0.2925,0.274,0.248
"12424","240480",2008,1608,882,726,412,145,267,30.27,0.3027,0.256,0.2
"12425","240727",2008,1674,851,823,408,148,260,30.55,0.3055,0.244,0.18
"12426","243443",2008,750,435,315,43,9,34,7.82,0.0782,0.057,0.029
"12427","243780",2008,7058,3083,3975,3028,1409,1619,52.51,0.5251,0.429,0.354
"12428","100654",2009,1042,537,505,115,22,93,17.32,0.1732,0.11,0.044
"12429","100663",2009,1494,819,675,474,188,286,34.92,0.3492,0.317,0.279
"12430","100751",2009,5062,2746,2316,2093,772,1321,48.11,0.4811,0.413,0.333
"12431","100858",2009,3911,2007,1904,1733,617,1116,55.61,0.5561,0.443,0.324
"12432","101435",2009,237,99,138,58,30,28,28.28,0.2828,0.245,0.217
"12433","101480",2009,1220,695,525,137,30,107,15.4,0.154,0.112,0.057
"12434","101675",2009,392,179,213,21,4,17,9.5,0.095,0.054,0.019
"12435","101879",2009,1064,597,467,122,33,89,14.91,0.1491,0.115,0.071
"12436","102049",2009,730,486,244,430,132,298,61.32,0.6132,0.589,0.541
"12437","102094",2009,1753,927,826,244,83,161,17.37,0.1737,0.139,0.1
"12438","102234",2009,355,203,152,152,55,97,47.78,0.4778,0.428,0.362
"12439","102368",2009,1997,1192,805,265,78,187,15.69,0.1569,0.133,0.097
"12440","102377",2009,688,410,278,123,25,98,23.9,0.239,0.179,0.09
"12441","104151",2009,6747,3279,3468,3054,1335,1719,52.42,0.5242,0.453,0.385
"12442","104179",2009,6782,3697,3085,2922,1146,1776,48.04,0.4804,0.431,0.371
"12443","105330",2009,3377,1951,1426,1122,354,768,39.36,0.3936,0.332,0.248
"12444","106245",2009,674,387,287,74,27,47,12.14,0.1214,0.11,0.094
"12445","106342",2009,216,114,102,75,39,36,31.58,0.3158,0.347,0.382
"12446","106397",2009,2890,1448,1442,1129,466,663,45.79,0.4579,0.391,0.323
"12447","106412",2009,959,523,436,67,16,51,9.75,0.0975,0.07,0.037
"12448","106458",2009,1645,874,771,349,154,195,22.31,0.2231,0.212,0.2
"12449","106467",2009,1744,882,862,375,139,236,26.76,0.2676,0.215,0.161
"12450","106485",2009,740,373,367,63,16,47,12.6,0.126,0.085,0.044
"12451","106704",2009,1753,1023,730,403,136,267,26.1,0.261,0.23,0.186
"12452","107044",2009,950,530,420,430,143,287,54.15,0.5415,0.453,0.34
"12453","107080",2009,412,245,167,265,107,158,64.49,0.6449,0.643,0.641
"12454","107141",2009,305,170,135,167,62,105,61.76,0.6176,0.548,0.459
"12455","107512",2009,389,198,191,208,84,124,62.63,0.6263,0.535,0.44
"12456","107558",2009,152,72,80,39,12,27,37.5,0.375,0.257,0.15
"12457","110097",2009,775,508,267,402,131,271,53.35,0.5335,0.519,0.491
"12458","110404",2009,251,106,145,212,122,90,84.91,0.8491,0.845,0.841
"12459","110422",2009,3877,1803,2074,1557,593,964,53.47,0.5347,0.402,0.286
"12460","110486",2009,1061,652,409,139,39,100,15.34,0.1534,0.131,0.095
"12461","110495",2009,798,555,243,124,37,87,15.68,0.1568,0.155,0.152
"12462","110510",2009,1968,1275,693,265,75,190,14.9,0.149,0.135,0.108
"12463","110529",2009,2728,1192,1536,401,134,267,22.4,0.224,0.147,0.087
"12464","110538",2009,2468,1338,1130,561,159,402,30.04,0.3004,0.227,0.141
"12465","110547",2009,1069,703,366,66,13,53,7.54,0.0754,0.062,0.036
"12466","110556",2009,2619,1574,1045,407,123,284,18.04,0.1804,0.155,0.118
"12467","110565",2009,3842,2233,1609,666,180,486,21.76,0.2176,0.173,0.112
"12468","110574",2009,1436,884,552,184,54,130,14.71,0.1471,0.128,0.098
"12469","110583",2009,3473,2133,1340,551,172,379,17.77,0.1777,0.159,0.128
"12470","110592",2009,1877,1173,704,127,40,87,7.42,0.0742,0.068,0.057
"12471","110617",2009,2954,1712,1242,196,50,146,8.53,0.0853,0.066,0.04
"12472","113698",2009,289,207,82,152,25,127,61.35,0.6135,0.526,0.305
"12473","115755",2009,1345,745,600,214,57,157,21.07,0.2107,0.159,0.095
"12474","119173",2009,367,351,16,109,5,104,29.63,0.2963,0.297,0.312
"12475","120184",2009,116,78,38,33,10,23,29.49,0.2949,0.284,0.263
"12476","121309",2009,533,343,190,338,113,225,65.6,0.656,0.634,0.595
"12477","121345",2009,389,190,199,355,180,175,92.11,0.9211,0.913,0.905
"12478","122409",2009,3291,1881,1410,990,332,658,34.98,0.3498,0.301,0.235
"12479","122436",2009,1081,621,460,714,259,455,73.27,0.7327,0.66,0.563
"12480","122597",2009,3855,2497,1358,704,178,526,21.07,0.2107,0.183,0.131
"12481","122612",2009,1073,744,329,648,172,476,63.98,0.6398,0.604,0.523
"12482","122931",2009,1084,571,513,830,371,459,80.39,0.8039,0.766,0.723
"12483","123554",2009,567,354,213,320,101,219,61.86,0.6186,0.564,0.474
"12484","123572",2009,1465,953,512,413,94,319,33.47,0.3347,0.282,0.184
"12485","126562",2009,1037,556,481,172,64,108,19.42,0.1942,0.166,0.133
"12486","126580",2009,1035,543,492,247,98,149,27.44,0.2744,0.239,0.199
"12487","126614",2009,5515,2719,2796,2598,1102,1496,55.02,0.5502,0.471,0.394
"12488","126818",2009,4274,2360,1914,1732,593,1139,48.26,0.4826,0.405,0.31
"12489","127060",2009,1196,684,512,797,314,483,70.61,0.7061,0.666,0.613
"12490","127185",2009,766,344,422,138,64,74,21.51,0.2151,0.18,0.152
"12491","127565",2009,1959,985,974,115,46,69,7.01,0.0701,0.059,0.047
"12492","127741",2009,2275,1360,915,605,165,440,32.35,0.3235,0.266,0.18
"12493","128106",2009,1013,513,500,178,67,111,21.64,0.2164,0.176,0.134
"12494","128744",2009,429,260,169,108,37,71,27.31,0.2731,0.252,0.219
"12495","128771",2009,1277,621,656,321,128,193,31.08,0.3108,0.251,0.195
"12496","129020",2009,3206,1652,1554,2216,986,1230,74.46,0.7446,0.691,0.634
"12497","129242",2009,848,479,369,664,270,394,82.25,0.8225,0.783,0.732
"12498","129941",2009,1252,639,613,553,247,306,47.89,0.4789,0.442,0.403
"12499","130253",2009,907,542,365,526,180,346,63.84,0.6384,0.58,0.493
"12500","130314",2009,184,184,0,82,0,82,44.57,0.4457,0.446,NA
"12501","130493",2009,1237,792,445,280,65,215,27.15,0.2715,0.226,0.146
"12502","130590",2009,573,272,301,464,232,232,85.29,0.8529,0.81,0.771
"12503","130697",2009,744,389,355,681,322,359,92.29,0.9229,0.915,0.907
"12504","130776",2009,1008,549,459,255,99,156,28.42,0.2842,0.253,0.216
"12505","130794",2009,1305,651,654,1145,553,592,90.94,0.9094,0.877,0.846
"12506","130934",2009,739,463,276,165,42,123,26.57,0.2657,0.223,0.152
"12507","130943",2009,4211,2424,1787,2486,929,1557,64.23,0.6423,0.59,0.52
"12508","131159",2009,1527,917,610,1164,449,715,77.97,0.7797,0.762,0.736
"12509","131283",2009,813,456,357,501,184,317,69.52,0.6952,0.616,0.515
"12510","131450",2009,211,112,99,51,13,38,33.93,0.3393,0.242,0.131
"12511","131469",2009,2582,1435,1147,1940,825,1115,77.7,0.777,0.751,0.719
"12512","131496",2009,1550,861,689,1389,601,788,91.52,0.9152,0.896,0.872
"12513","131520",2009,1600,1097,503,633,144,489,44.58,0.4458,0.396,0.286
"12514","132471",2009,648,433,215,102,25,77,17.78,0.1778,0.157,0.116
"12515","132602",2009,917,551,366,233,76,157,28.49,0.2849,0.254,0.208
"12516","132903",2009,6251,3342,2909,2529,868,1661,49.7,0.497,0.405,0.298
"12517","133492",2009,504,300,204,301,122,179,59.67,0.5967,0.597,0.598
"12518","133553",2009,853,134,719,265,203,62,46.27,0.4627,0.311,0.282
"12519","133650",2009,2348,1421,927,267,88,179,12.6,0.126,0.114,0.095
"12520","133669",2009,2447,1314,1133,487,156,331,25.19,0.2519,0.199,0.138
"12521","133711",2009,564,337,227,281,94,187,55.49,0.5549,0.498,0.414
"12522","133881",2009,538,145,393,222,144,78,53.79,0.5379,0.413,0.366
"12523","133951",2009,2946,1615,1331,828,278,550,34.06,0.3406,0.281,0.209
"12524","134079",2009,557,319,238,257,91,166,52.04,0.5204,0.461,0.382
"12525","134097",2009,5925,3476,2449,3650,1245,2405,69.19,0.6919,0.616,0.508
"12526","134130",2009,6253,3728,2525,4149,1367,2782,74.62,0.7462,0.664,0.541
"12527","134945",2009,665,337,328,187,78,109,32.34,0.3234,0.281,0.238
"12528","135726",2009,1903,924,979,1297,599,698,75.54,0.7554,0.682,0.612
"12529","136172",2009,2025,1129,896,536,155,381,33.75,0.3375,0.265,0.173
"12530","136950",2009,464,287,177,299,103,196,68.29,0.6829,0.644,0.582
"12531","137546",2009,502,273,229,287,124,163,59.71,0.5971,0.572,0.541
"12532","138354",2009,1154,643,511,313,91,222,34.53,0.3453,0.271,0.178
"12533","138716",2009,745,468,277,66,15,51,10.9,0.109,0.089,0.054
"12534","138789",2009,1063,611,452,110,20,90,14.73,0.1473,0.103,0.044
"12535","139144",2009,569,402,167,315,85,230,57.21,0.5721,0.554,0.509
"12536","139366",2009,1231,734,497,138,43,95,12.94,0.1294,0.112,0.087
"12537","139393",2009,277,158,119,139,48,91,57.59,0.5759,0.502,0.403
"12538","139658",2009,1287,712,575,1067,448,619,86.94,0.8694,0.829,0.779
"12539","139719",2009,984,550,434,118,26,92,16.73,0.1673,0.12,0.06
"12540","139755",2009,2654,887,1767,1064,638,426,48.03,0.4803,0.401,0.361
"12541","139764",2009,435,251,184,49,16,33,13.15,0.1315,0.113,0.087
"12542","139861",2009,1206,741,465,476,138,338,45.61,0.4561,0.395,0.297
"12543","139931",2009,3490,1683,1807,854,292,562,33.39,0.3339,0.245,0.162
"12544","139940",2009,2937,1745,1192,702,233,469,26.88,0.2688,0.239,0.195
"12545","139959",2009,4675,2862,1813,2881,951,1930,67.44,0.6744,0.616,0.525
"12546","140447",2009,628,349,279,294,108,186,53.3,0.533,0.468,0.387
"12547","140960",2009,866,448,418,68,18,50,11.16,0.1116,0.079,0.043
"12548","140988",2009,333,175,158,105,32,73,41.71,0.4171,0.315,0.203
"12549","141185",2009,168,109,59,59,21,38,34.86,0.3486,0.351,0.356
"12550","141264",2009,2416,1421,995,365,85,280,19.7,0.197,0.151,0.085
"12551","141334",2009,1911,1095,816,298,81,217,19.82,0.1982,0.156,0.099
"12552","141486",2009,262,164,98,73,25,48,29.27,0.2927,0.279,0.255
"12553","141565",2009,460,269,191,54,17,37,13.75,0.1375,0.117,0.089
"12554","141574",2009,1847,984,863,392,155,237,24.09,0.2409,0.212,0.18
"12555","142276",2009,1189,599,590,122,47,75,12.52,0.1252,0.103,0.08
"12556","142285",2009,1754,841,913,512,180,332,39.48,0.3948,0.292,0.197
"12557","142461",2009,263,151,112,95,33,62,41.06,0.4106,0.361,0.295
"12558","143084",2009,616,342,274,434,168,266,77.78,0.7778,0.705,0.613
"12559","143288",2009,146,93,53,46,18,28,30.11,0.3011,0.315,0.34
"12560","144005",2009,589,428,161,13,6,7,1.64,0.0164,0.022,0.037
"12561","144281",2009,2089,1170,919,616,241,375,32.05,0.3205,0.295,0.262
"12562","144740",2009,2523,1494,1029,1425,538,887,59.37,0.5937,0.565,0.523
"12563","144892",2009,1637,997,640,520,178,342,34.3,0.343,0.318,0.278
"12564","144962",2009,584,341,243,317,106,211,61.88,0.6188,0.543,0.436
"12565","144971",2009,143,75,68,55,23,32,42.67,0.4267,0.385,0.338
"12566","145600",2009,3126,1680,1446,1056,411,645,38.39,0.3839,0.338,0.284
"12567","145619",2009,451,215,236,156,68,88,40.93,0.4093,0.346,0.288
"12568","145637",2009,6974,3332,3642,4938,2317,2621,78.66,0.7866,0.708,0.636
"12569","145691",2009,224,99,125,139,71,68,68.69,0.6869,0.621,0.568
"12570","145813",2009,3060,1816,1244,1462,500,962,52.97,0.5297,0.478,0.402
"12571","146481",2009,354,213,141,232,81,151,70.89,0.7089,0.655,0.574
"12572","146612",2009,653,360,293,288,114,174,48.33,0.4833,0.441,0.389
"12573","146719",2009,2076,1358,718,1323,434,889,65.46,0.6546,0.637,0.604
"12574","146825",2009,96,34,62,19,6,13,38.24,0.3824,0.198,0.097
"12575","147013",2009,305,148,157,102,44,58,39.19,0.3919,0.334,0.28
"12576","147244",2009,541,317,224,259,97,162,51.1,0.511,0.479,0.433
"12577","147341",2009,378,187,191,183,79,104,55.61,0.5561,0.484,0.414
"12578","147703",2009,2988,1573,1415,754,310,444,28.23,0.2823,0.252,0.219
"12579","147767",2009,2128,1076,1052,1754,826,928,86.25,0.8625,0.824,0.785
"12580","147776",2009,996,545,451,50,20,30,5.5,0.055,0.05,0.044
"12581","147828",2009,771,447,324,395,134,261,58.39,0.5839,0.512,0.414
"12582","148131",2009,248,127,121,81,31,50,39.37,0.3937,0.327,0.256
"12583","148496",2009,405,279,126,193,51,142,50.9,0.509,0.477,0.405
"12584","148584",2009,223,144,79,92,26,66,45.83,0.4583,0.413,0.329
"12585","148627",2009,438,282,156,131,34,97,34.4,0.344,0.299,0.218
"12586","149222",2009,2445,1131,1314,624,264,360,31.83,0.3183,0.255,0.201
"12587","149231",2009,1911,1068,843,503,198,305,28.56,0.2856,0.263,0.235
"12588","149772",2009,1633,817,816,515,226,289,35.37,0.3537,0.315,0.277
"12589","149781",2009,620,318,302,501,232,269,84.59,0.8459,0.808,0.768
"12590","150066",2009,547,313,234,238,83,155,49.52,0.4952,0.435,0.355
"12591","150136",2009,4131,2240,1891,1542,570,972,43.39,0.4339,0.373,0.301
"12592","150145",2009,295,175,120,165,60,105,60,0.6,0.559,0.5
"12593","150163",2009,944,571,373,501,166,335,58.67,0.5867,0.531,0.445
"12594","150400",2009,717,405,312,543,222,321,79.26,0.7926,0.757,0.712
"12595","150534",2009,701,433,268,403,152,251,57.97,0.5797,0.575,0.567
"12596","150668",2009,238,148,90,126,45,81,54.73,0.5473,0.529,0.5
"12597","150941",2009,250,138,112,142,64,78,56.52,0.5652,0.568,0.571
"12598","151102",2009,2040,1054,986,131,54,77,7.31,0.0731,0.064,0.055
"12599","151111",2009,2794,1670,1124,500,187,313,18.74,0.1874,0.179,0.166
"12600","151306",2009,2048,1199,849,420,100,320,26.69,0.2669,0.205,0.118
"12601","151324",2009,1969,954,1015,393,183,210,22.01,0.2201,0.2,0.18
"12602","151333",2009,406,232,174,51,14,37,15.95,0.1595,0.126,0.08
"12603","151342",2009,1045,611,434,60,21,39,6.38,0.0638,0.057,0.048
"12604","151351",2009,7301,3640,3661,4387,2001,2386,65.55,0.6555,0.601,0.547
"12605","151360",2009,773,483,290,70,22,48,9.94,0.0994,0.091,0.076
"12606","151379",2009,995,612,383,80,27,53,8.66,0.0866,0.08,0.07
"12607","151388",2009,358,217,141,51,11,40,18.43,0.1843,0.142,0.078
"12608","151777",2009,426,210,216,198,88,110,52.38,0.5238,0.465,0.407
"12609","151786",2009,312,166,146,103,39,64,38.55,0.3855,0.33,0.267
"12610","152080",2009,2055,930,1125,1867,1009,858,92.26,0.9226,0.909,0.897
"12611","152248",2009,1060,499,561,92,37,55,11.02,0.1102,0.087,0.066
"12612","152363",2009,240,108,132,102,41,61,56.48,0.5648,0.425,0.311
"12613","152530",2009,482,263,219,342,141,201,76.43,0.7643,0.71,0.644
"12614","152600",2009,671,330,341,371,157,214,64.85,0.6485,0.553,0.46
"12615","153001",2009,271,123,148,116,55,61,49.59,0.4959,0.428,0.372
"12616","153108",2009,442,213,229,264,117,147,69.01,0.6901,0.597,0.511
"12617","153269",2009,860,512,348,482,185,297,58.01,0.5801,0.56,0.532
"12618","153384",2009,377,202,175,299,124,175,86.63,0.8663,0.793,0.709
"12619","153603",2009,4320,1974,2346,1757,742,1015,51.42,0.5142,0.407,0.316
"12620","153834",2009,657,380,277,451,190,261,68.68,0.6868,0.686,0.686
"12621","154095",2009,1913,1194,719,721,220,501,41.96,0.4196,0.377,0.306
"12622","155089",2009,217,114,103,62,33,29,25.44,0.2544,0.286,0.32
"12623","155317",2009,3894,1984,1910,1459,599,860,43.35,0.4335,0.375,0.314
"12624","155335",2009,174,106,68,55,16,39,36.79,0.3679,0.316,0.235
"12625","155399",2009,3420,1686,1734,972,343,629,37.31,0.3731,0.284,0.198
"12626","155520",2009,198,110,88,83,29,54,49.09,0.4909,0.419,0.33
"12627","155627",2009,150,67,83,55,30,25,37.31,0.3731,0.367,0.361
"12628","155937",2009,182,82,100,49,24,25,30.49,0.3049,0.269,0.24
"12629","156213",2009,315,198,117,168,64,104,52.53,0.5253,0.533,0.547
"12630","156286",2009,600,383,217,303,98,205,53.52,0.5352,0.505,0.452
"12631","156295",2009,391,221,170,174,74,100,45.25,0.4525,0.445,0.435
"12632","156365",2009,515,260,255,127,44,83,31.92,0.3192,0.247,0.173
"12633","156541",2009,453,211,242,107,31,76,36.02,0.3602,0.236,0.128
"12634","156745",2009,378,211,167,186,63,123,58.29,0.5829,0.492,0.377
"12635","157058",2009,476,265,211,24,7,17,6.42,0.0642,0.05,0.033
"12636","157076",2009,227,118,109,79,30,49,41.53,0.4153,0.348,0.275
"12637","157085",2009,4105,2102,2003,1438,551,887,42.2,0.422,0.35,0.275
"12638","157289",2009,2441,1273,1168,622,270,352,27.65,0.2765,0.255,0.231
"12639","157386",2009,1240,708,532,231,74,157,22.18,0.2218,0.186,0.139
"12640","157401",2009,1374,837,537,330,101,229,27.36,0.2736,0.24,0.188
"12641","157447",2009,2187,1219,968,340,121,219,17.97,0.1797,0.155,0.125
"12642","157535",2009,185,62,123,38,20,18,29.03,0.2903,0.205,0.163
"12643","157951",2009,3288,1783,1505,700,249,451,25.29,0.2529,0.213,0.165
"12644","158477",2009,278,162,116,128,49,79,48.77,0.4877,0.46,0.422
"12645","159009",2009,910,548,362,177,65,112,20.44,0.2044,0.195,0.18
"12646","159391",2009,4776,2516,2260,1823,665,1158,46.03,0.4603,0.382,0.294
"12647","159647",2009,1448,622,826,438,209,229,36.82,0.3682,0.302,0.253
"12648","159717",2009,1221,728,493,256,83,173,23.76,0.2376,0.21,0.168
"12649","159966",2009,1212,707,505,200,67,133,18.81,0.1881,0.165,0.133
"12650","160038",2009,1235,781,454,231,64,167,21.38,0.2138,0.187,0.141
"12651","160612",2009,2508,1497,1011,359,118,241,16.1,0.161,0.143,0.117
"12652","160621",2009,992,539,453,96,31,65,12.06,0.1206,0.097,0.068
"12653","160658",2009,2553,1427,1126,373,126,247,17.31,0.1731,0.146,0.112
"12654","161004",2009,493,253,240,422,200,222,87.75,0.8775,0.856,0.833
"12655","161226",2009,487,312,175,210,64,146,46.79,0.4679,0.431,0.366
"12656","161235",2009,118,69,49,20,5,15,21.74,0.2174,0.169,0.102
"12657","161244",2009,101,67,34,16,4,12,17.91,0.1791,0.158,0.118
"12658","161253",2009,1654,756,898,550,288,262,34.66,0.3466,0.333,0.321
"12659","161554",2009,825,447,378,107,27,80,17.9,0.179,0.13,0.071
"12660","162007",2009,635,401,234,71,18,53,13.22,0.1322,0.112,0.077
"12661","162210",2009,144,83,61,21,7,14,16.87,0.1687,0.146,0.115
"12662","162283",2009,541,392,149,29,2,27,6.89,0.0689,0.054,0.013
"12663","162584",2009,1028,505,523,217,67,150,29.7,0.297,0.211,0.128
"12664","162654",2009,398,276,122,227,53,174,63.04,0.6304,0.57,0.434
"12665","162760",2009,251,168,83,136,46,90,53.57,0.5357,0.542,0.554
"12666","162928",2009,1427,663,764,1240,643,597,90.05,0.9005,0.869,0.842
"12667","163046",2009,968,592,376,740,275,465,78.55,0.7855,0.764,0.731
"12668","163268",2009,1522,656,866,574,257,317,48.32,0.4832,0.377,0.297
"12669","163286",2009,4199,1953,2246,2912,1448,1464,74.96,0.7496,0.693,0.645
"12670","163453",2009,1261,715,546,121,35,86,12.03,0.1203,0.096,0.064
"12671","163462",2009,464,268,196,298,126,172,64.18,0.6418,0.642,0.643
"12672","163851",2009,1273,738,535,577,169,408,55.28,0.5528,0.453,0.316
"12673","163912",2009,486,273,213,327,121,206,75.46,0.7546,0.673,0.568
"12674","164076",2009,2395,1564,831,1076,275,801,51.21,0.5121,0.449,0.331
"12675","164173",2009,522,346,176,220,62,158,45.66,0.4566,0.421,0.352
"12676","164216",2009,378,215,163,269,111,158,73.49,0.7349,0.712,0.681
"12677","164270",2009,420,195,225,266,124,142,72.82,0.7282,0.633,0.551
"12678","164447",2009,354,165,189,88,40,48,29.09,0.2909,0.249,0.212
"12679","164492",2009,373,172,201,95,46,49,28.49,0.2849,0.255,0.229
"12680","164562",2009,515,294,221,363,135,228,77.55,0.7755,0.705,0.611
"12681","165015",2009,775,434,341,621,255,366,84.33,0.8433,0.801,0.748
"12682","165024",2009,1453,866,587,420,162,258,29.79,0.2979,0.289,0.276
"12683","165334",2009,548,356,192,422,144,278,78.09,0.7809,0.77,0.75
"12684","165662",2009,764,486,278,593,215,378,77.78,0.7778,0.776,0.773
"12685","165671",2009,423,308,115,235,60,175,56.82,0.5682,0.556,0.522
"12686","165820",2009,781,410,371,217,89,128,31.22,0.3122,0.278,0.24
"12687","165866",2009,719,520,199,261,59,202,38.85,0.3885,0.363,0.296
"12688","165936",2009,381,237,144,233,71,162,68.35,0.6835,0.612,0.493
"12689","166027",2009,1662,837,825,1425,673,752,89.84,0.8984,0.857,0.816
"12690","166124",2009,746,379,367,666,320,346,91.29,0.9129,0.893,0.872
"12691","166513",2009,1499,548,951,465,243,222,40.51,0.4051,0.31,0.256
"12692","166629",2009,4215,2175,2040,2703,1192,1511,69.47,0.6947,0.641,0.584
"12693","166638",2009,934,545,389,154,53,101,18.53,0.1853,0.165,0.136
"12694","166683",2009,1066,477,589,874,462,412,86.37,0.8637,0.82,0.784
"12695","167288",2009,347,229,118,119,40,79,34.5,0.345,0.343,0.339
"12696","167987",2009,1780,822,958,494,212,282,34.31,0.3431,0.278,0.221
"12697","167996",2009,683,397,286,564,219,345,86.9,0.869,0.826,0.766
"12698","168005",2009,1257,736,521,510,182,328,44.57,0.4457,0.406,0.349
"12699","168148",2009,1302,669,633,1141,542,599,89.54,0.8954,0.876,0.856
"12700","168254",2009,683,257,426,322,187,135,52.53,0.5253,0.471,0.439
"12701","168281",2009,423,261,162,322,118,204,78.16,0.7816,0.761,0.728
"12702","168342",2009,545,293,252,481,216,265,90.44,0.9044,0.883,0.857
"12703","168546",2009,434,218,216,241,106,135,61.93,0.6193,0.555,0.491
"12704","168786",2009,402,271,131,158,46,112,41.33,0.4133,0.393,0.351
"12705","169080",2009,943,492,451,540,244,296,60.16,0.6016,0.573,0.541
"12706","169798",2009,2196,1308,888,288,84,204,15.6,0.156,0.131,0.095
"12707","169910",2009,1958,980,978,152,58,94,9.59,0.0959,0.078,0.059
"12708","170082",2009,3716,2278,1438,1363,461,902,39.6,0.396,0.367,0.321
"12709","170301",2009,803,486,317,515,186,329,67.7,0.677,0.641,0.587
"12710","170532",2009,389,219,170,299,121,178,81.28,0.8128,0.769,0.712
"12711","170639",2009,437,209,228,65,33,32,15.31,0.1531,0.149,0.145
"12712","170976",2009,6019,2983,3036,4503,2101,2402,80.52,0.8052,0.748,0.692
"12713","171100",2009,7249,3869,3380,3612,1445,2167,56.01,0.5601,0.498,0.428
"12714","171128",2009,1155,301,854,260,162,98,32.56,0.3256,0.225,0.19
"12715","171137",2009,886,418,468,146,60,86,20.57,0.2057,0.165,0.128
"12716","171146",2009,713,401,312,77,29,48,11.97,0.1197,0.108,0.093
"12717","171599",2009,258,141,117,68,26,42,29.79,0.2979,0.264,0.222
"12718","172051",2009,1728,1028,700,177,59,118,11.48,0.1148,0.102,0.084
"12719","172699",2009,3162,1591,1571,718,279,439,27.59,0.2759,0.227,0.178
"12720","173160",2009,683,387,296,430,169,261,67.44,0.6744,0.63,0.571
"12721","173258",2009,528,272,256,480,222,258,94.85,0.9485,0.909,0.867
"12722","173328",2009,183,82,101,56,22,34,41.46,0.4146,0.306,0.218
"12723","173647",2009,611,372,239,495,193,302,81.18,0.8118,0.81,0.808
"12724","173902",2009,564,329,235,481,196,285,86.63,0.8663,0.853,0.834
"12725","174066",2009,5381,2849,2532,3188,1380,1808,63.46,0.6346,0.592,0.545
"12726","174233",2009,2079,1028,1051,728,296,432,42.02,0.4202,0.35,0.282
"12727","174251",2009,404,235,169,206,74,132,56.17,0.5617,0.51,0.438
"12728","174491",2009,450,258,192,240,86,154,59.69,0.5969,0.533,0.448
"12729","174792",2009,461,0,461,303,303,0,NA,NA,0.657,0.657
"12730","174844",2009,778,445,333,652,267,385,86.52,0.8652,0.838,0.802
"12731","174899",2009,540,359,181,337,90,247,68.8,0.688,0.624,0.497
"12732","174914",2009,1350,586,764,812,439,373,63.65,0.6365,0.601,0.575
"12733","175342",2009,463,277,186,77,20,57,20.58,0.2058,0.166,0.108
"12734","175421",2009,208,116,92,67,18,49,42.24,0.4224,0.322,0.196
"12735","175616",2009,367,230,137,62,22,40,17.39,0.1739,0.169,0.161
"12736","175856",2009,841,507,334,157,47,110,21.7,0.217,0.187,0.141
"12737","175980",2009,281,116,165,166,80,86,74.14,0.7414,0.591,0.485
"12738","176017",2009,2547,1358,1189,996,360,636,46.83,0.4683,0.391,0.303
"12739","176035",2009,216,177,39,56,10,46,25.99,0.2599,0.259,0.256
"12740","176044",2009,413,222,191,43,13,30,13.51,0.1351,0.104,0.068
"12741","176080",2009,2447,1210,1237,755,282,473,39.09,0.3909,0.309,0.228
"12742","176406",2009,231,154,77,57,12,45,29.22,0.2922,0.247,0.156
"12743","176628",2009,118,79,39,36,9,27,34.18,0.3418,0.305,0.231
"12744","176947",2009,260,129,131,106,42,64,49.61,0.4961,0.408,0.321
"12745","176965",2009,1478,822,656,452,148,304,36.98,0.3698,0.306,0.226
"12746","177418",2009,173,104,69,65,19,46,44.23,0.4423,0.376,0.275
"12747","178059",2009,340,233,107,190,57,133,57.08,0.5708,0.559,0.533
"12748","178341",2009,811,395,416,119,53,66,16.71,0.1671,0.147,0.127
"12749","178387",2009,1004,572,432,127,35,92,16.08,0.1608,0.126,0.081
"12750","178396",2009,5492,2958,2534,2527,907,1620,54.77,0.5477,0.46,0.358
"12751","178402",2009,979,610,369,224,62,162,26.56,0.2656,0.229,0.168
"12752","178411",2009,1099,260,839,263,180,83,31.92,0.3192,0.239,0.215
"12753","178420",2009,494,295,199,109,34,75,25.42,0.2542,0.221,0.171
"12754","178615",2009,1337,776,561,739,263,476,61.34,0.6134,0.553,0.469
"12755","179043",2009,417,263,154,251,84,167,63.5,0.635,0.602,0.545
"12756","179159",2009,1714,966,748,1026,393,633,65.53,0.6553,0.599,0.525
"12757","179557",2009,1640,943,697,455,165,290,30.75,0.3075,0.277,0.237
"12758","179566",2009,2625,1542,1083,768,225,543,35.21,0.3521,0.293,0.208
"12759","179867",2009,1481,720,761,1280,622,658,91.39,0.9139,0.864,0.817
"12760","179894",2009,486,289,197,219,78,141,48.79,0.4879,0.451,0.396
"12761","179946",2009,311,152,159,149,61,88,57.89,0.5789,0.479,0.384
"12762","180179",2009,715,400,315,51,19,32,8,0.08,0.071,0.06
"12763","180461",2009,1795,728,1067,387,190,197,27.06,0.2706,0.216,0.178
"12764","180522",2009,233,71,162,21,13,8,11.27,0.1127,0.09,0.08
"12765","180984",2009,288,139,149,117,47,70,50.36,0.5036,0.406,0.315
"12766","181002",2009,1052,635,417,709,275,434,68.35,0.6835,0.674,0.659
"12767","181020",2009,309,167,142,175,65,110,65.87,0.6587,0.566,0.458
"12768","181127",2009,290,150,140,132,50,82,54.67,0.5467,0.455,0.357
"12769","181215",2009,974,548,426,231,81,150,27.37,0.2737,0.237,0.19
"12770","181394",2009,1747,932,815,278,93,185,19.85,0.1985,0.159,0.114
"12771","181446",2009,393,233,160,201,63,138,59.23,0.5923,0.511,0.394
"12772","181464",2009,3965,1870,2095,1308,552,756,40.43,0.4043,0.33,0.263
"12773","181534",2009,227,113,114,35,12,23,20.35,0.2035,0.154,0.105
"12774","181783",2009,663,361,302,158,56,102,28.25,0.2825,0.238,0.185
"12775","182281",2009,3083,1659,1424,397,146,251,15.13,0.1513,0.129,0.103
"12776","182290",2009,2124,1144,980,467,172,295,25.79,0.2579,0.22,0.176
"12777","182634",2009,432,313,119,190,45,145,46.33,0.4633,0.44,0.378
"12778","182795",2009,388,175,213,138,62,76,43.43,0.4343,0.356,0.291
"12779","183062",2009,1171,712,459,616,228,388,54.49,0.5449,0.526,0.497
"12780","183080",2009,971,450,521,430,196,234,52,0.52,0.443,0.376
"12781","183239",2009,528,285,243,372,154,218,76.49,0.7649,0.705,0.634
"12782","183822",2009,439,278,161,32,16,16,5.76,0.0576,0.073,0.099
"12783","183974",2009,270,165,105,156,50,106,64.24,0.6424,0.578,0.476
"12784","184348",2009,505,296,209,317,114,203,68.58,0.6858,0.628,0.545
"12785","184603",2009,641,361,280,175,57,118,32.69,0.3269,0.273,0.204
"12786","184612",2009,251,172,79,46,17,29,16.86,0.1686,0.183,0.215
"12787","184782",2009,1586,738,848,677,344,333,45.12,0.4512,0.427,0.406
"12788","185129",2009,634,358,276,32,12,20,5.59,0.0559,0.05,0.043
"12789","185572",2009,998,581,417,504,191,313,53.87,0.5387,0.505,0.458
"12790","185590",2009,2100,1284,816,757,219,538,41.9,0.419,0.36,0.268
"12791","185828",2009,899,169,730,212,151,61,36.09,0.3609,0.236,0.207
"12792","186131",2009,1297,643,654,1164,568,596,92.69,0.9269,0.897,0.869
"12793","186201",2009,933,575,358,559,165,394,68.52,0.6852,0.599,0.461
"12794","186283",2009,1027,611,416,557,216,341,55.81,0.5581,0.542,0.519
"12795","186584",2009,1124,659,465,570,232,338,51.29,0.5129,0.507,0.499
"12796","186876",2009,865,483,382,459,175,284,58.8,0.588,0.531,0.458
"12797","187134",2009,1283,718,565,918,366,552,76.88,0.7688,0.716,0.648
"12798","187444",2009,1435,703,732,284,129,155,22.05,0.2205,0.198,0.176
"12799","187985",2009,3344,1762,1582,516,193,323,18.33,0.1833,0.154,0.122
"12800","188030",2009,2446,1306,1140,328,116,212,16.23,0.1623,0.134,0.102
"12801","188429",2009,985,690,295,539,131,408,59.13,0.5913,0.547,0.444
"12802","188641",2009,465,234,231,204,85,119,50.85,0.5085,0.439,0.368
"12803","190044",2009,774,220,554,405,262,143,65,0.65,0.523,0.473
"12804","190099",2009,750,400,350,644,299,345,86.25,0.8625,0.859,0.854
"12805","190150",2009,1432,701,731,1260,629,631,90.01,0.9001,0.88,0.86
"12806","190248",2009,101,54,47,27,7,20,37.04,0.3704,0.267,0.149
"12807","190415",2009,3174,1597,1577,2742,1327,1415,88.6,0.886,0.864,0.841
"12808","190512",2009,1430,619,811,598,294,304,49.11,0.4911,0.418,0.363
"12809","190549",2009,952,541,411,223,94,129,23.84,0.2384,0.234,0.229
"12810","190558",2009,2407,1245,1162,127,52,75,6.02,0.0602,0.053,0.045
"12811","190567",2009,1753,909,844,195,75,120,13.2,0.132,0.111,0.089
"12812","190594",2009,1983,1241,742,487,115,372,29.98,0.2998,0.246,0.155
"12813","190637",2009,754,461,293,111,34,77,16.7,0.167,0.147,0.116
"12814","190664",2009,1684,944,740,473,153,320,33.9,0.339,0.281,0.207
"12815","190691",2009,1028,627,401,50,12,38,6.06,0.0606,0.049,0.03
"12816","190725",2009,400,306,94,103,29,74,24.18,0.2418,0.258,0.309
"12817","191241",2009,1811,926,885,1358,647,711,76.78,0.7678,0.75,0.731
"12818","191515",2009,466,241,225,407,180,227,94.19,0.9419,0.873,0.8
"12819","191533",2009,402,239,163,202,66,136,56.9,0.569,0.502,0.405
"12820","191630",2009,545,315,230,416,161,255,80.95,0.8095,0.763,0.7
"12821","191649",2009,1554,834,720,755,297,458,54.92,0.5492,0.486,0.412
"12822","191676",2009,282,199,83,186,53,133,66.83,0.6683,0.66,0.639
"12823","191931",2009,792,480,312,448,150,298,62.08,0.6208,0.566,0.481
"12824","191968",2009,2024,1144,880,1390,571,819,71.59,0.7159,0.687,0.649
"12825","192192",2009,254,175,79,57,24,33,18.86,0.1886,0.224,0.304
"12826","192323",2009,605,394,211,344,102,242,61.42,0.6142,0.569,0.483
"12827","192439",2009,1005,692,313,81,19,62,8.96,0.0896,0.081,0.061
"12828","192703",2009,693,343,350,412,183,229,66.76,0.6676,0.595,0.523
"12829","192749",2009,490,298,192,250,86,164,55.03,0.5503,0.51,0.448
"12830","192819",2009,1041,577,464,708,279,429,74.35,0.7435,0.68,0.601
"12831","192925",2009,402,257,145,104,35,69,26.85,0.2685,0.259,0.241
"12832","193016",2009,880,552,328,157,39,118,21.38,0.2138,0.178,0.119
"12833","193292",2009,414,307,107,189,42,147,47.88,0.4788,0.457,0.393
"12834","193353",2009,474,362,112,217,42,175,48.34,0.4834,0.458,0.375
"12835","193399",2009,390,275,115,131,30,101,36.73,0.3673,0.336,0.261
"12836","193584",2009,491,387,104,315,68,247,63.82,0.6382,0.642,0.654
"12837","193645",2009,530,465,65,86,8,78,16.77,0.1677,0.162,0.123
"12838","193654",2009,1136,836,300,533,113,420,50.24,0.5024,0.469,0.377
"12839","193900",2009,5367,3037,2330,3359,1449,1910,62.89,0.6289,0.626,0.622
"12840","193973",2009,671,404,267,378,141,237,58.66,0.5866,0.563,0.528
"12841","194161",2009,260,151,109,68,26,42,27.81,0.2781,0.262,0.239
"12842","194310",2009,1637,1036,601,603,194,409,39.48,0.3948,0.368,0.323
"12843","194824",2009,1337,360,977,840,599,241,66.94,0.6694,0.628,0.613
"12844","195003",2009,2582,798,1784,796,413,383,47.99,0.4799,0.308,0.232
"12845","195030",2009,1195,594,601,890,431,459,77.27,0.7727,0.745,0.717
"12846","195164",2009,465,249,216,252,106,146,58.63,0.5863,0.542,0.491
"12847","195173",2009,580,301,279,168,63,105,34.88,0.3488,0.29,0.226
"12848","195216",2009,579,307,272,476,219,257,83.71,0.8371,0.822,0.805
"12849","195234",2009,583,381,202,271,76,195,51.18,0.5118,0.465,0.376
"12850","195243",2009,293,156,137,105,56,49,31.41,0.3141,0.358,0.409
"12851","195304",2009,365,273,92,263,72,191,69.96,0.6996,0.721,0.783
"12852","195474",2009,783,417,366,563,239,324,77.7,0.777,0.719,0.653
"12853","195526",2009,663,414,249,549,194,355,85.75,0.8575,0.828,0.779
"12854","195544",2009,700,519,181,374,73,301,58,0.58,0.534,0.403
"12855","195809",2009,3101,1651,1450,1245,534,711,43.06,0.4306,0.401,0.368
"12856","196413",2009,3240,1868,1372,2215,854,1361,72.86,0.7286,0.684,0.622
"12857","196592",2009,867,555,312,58,7,51,9.19,0.0919,0.067,0.022
"12858","197045",2009,559,271,288,161,76,85,31.37,0.3137,0.288,0.264
"12859","197133",2009,658,392,266,568,217,351,89.54,0.8954,0.863,0.816
"12860","197869",2009,2732,1471,1261,1267,464,803,54.59,0.5459,0.464,0.368
"12861","197984",2009,396,224,172,138,50,88,39.29,0.3929,0.348,0.291
"12862","198385",2009,487,252,235,438,207,231,91.67,0.9167,0.899,0.881
"12863","198464",2009,3942,2273,1669,1397,445,952,41.88,0.4188,0.354,0.267
"12864","198507",2009,659,375,284,106,35,71,18.93,0.1893,0.161,0.123
"12865","198516",2009,1290,774,516,1025,374,651,84.11,0.8411,0.795,0.725
"12866","198835",2009,355,215,140,119,36,83,38.6,0.386,0.335,0.257
"12867","198969",2009,472,144,328,80,35,45,31.25,0.3125,0.169,0.107
"12868","199102",2009,1875,1028,847,383,116,267,25.97,0.2597,0.204,0.137
"12869","199111",2009,637,363,274,230,75,155,42.7,0.427,0.361,0.274
"12870","199120",2009,3955,2354,1601,3216,1225,1991,84.58,0.8458,0.813,0.765
"12871","199139",2009,3152,1571,1581,820,319,501,31.89,0.3189,0.26,0.202
"12872","199148",2009,2495,1733,762,804,180,624,36.01,0.3601,0.322,0.236
"12873","199157",2009,1345,858,487,215,49,166,19.35,0.1935,0.16,0.101
"12874","199193",2009,4716,2067,2649,2031,920,1111,53.75,0.5375,0.431,0.347
"12875","199218",2009,1943,1178,765,975,314,661,56.11,0.5611,0.502,0.41
"12876","199281",2009,1202,642,560,218,77,141,21.96,0.2196,0.181,0.138
"12877","199306",2009,225,100,125,71,34,37,37,0.37,0.316,0.272
"12878","199412",2009,311,232,79,144,31,113,48.71,0.4871,0.463,0.392
"12879","199582",2009,424,206,218,91,35,56,27.18,0.2718,0.215,0.161
"12880","199643",2009,581,334,247,74,24,50,14.97,0.1497,0.127,0.097
"12881","199847",2009,1193,628,565,983,445,538,85.67,0.8567,0.824,0.788
"12882","199962",2009,375,195,180,150,59,91,46.67,0.4667,0.4,0.328
"12883","199999",2009,794,540,254,135,39,96,17.78,0.1778,0.17,0.154
"12884","200004",2009,1547,848,699,568,211,357,42.1,0.421,0.367,0.302
"12885","200059",2009,307,177,130,43,13,30,16.95,0.1695,0.14,0.1
"12886","200156",2009,233,116,117,49,17,32,27.59,0.2759,0.21,0.145
"12887","200217",2009,311,192,119,122,32,90,46.88,0.4688,0.392,0.269
"12888","200226",2009,147,57,90,17,7,10,17.54,0.1754,0.116,0.078
"12889","200253",2009,418,238,180,68,21,47,19.75,0.1975,0.163,0.117
"12890","200280",2009,1970,940,1030,468,218,250,26.6,0.266,0.238,0.212
"12891","200332",2009,2435,1111,1324,655,299,356,32.04,0.3204,0.269,0.226
"12892","200572",2009,152,53,99,32,13,19,35.85,0.3585,0.211,0.131
"12893","201104",2009,614,338,276,281,94,187,55.33,0.5533,0.458,0.341
"12894","201371",2009,257,116,141,107,48,59,50.86,0.5086,0.416,0.34
"12895","201548",2009,608,323,285,336,150,186,57.59,0.5759,0.553,0.526
"12896","201645",2009,965,401,564,609,309,300,74.81,0.7481,0.631,0.548
"12897","201690",2009,702,363,339,42,14,28,7.71,0.0771,0.06,0.041
"12898","202134",2009,1127,601,526,181,70,111,18.47,0.1847,0.161,0.133
"12899","202480",2009,1692,834,858,1050,463,587,70.38,0.7038,0.621,0.54
"12900","202523",2009,649,362,287,500,205,295,81.49,0.8149,0.77,0.714
"12901","202763",2009,565,398,167,251,51,200,50.25,0.5025,0.444,0.305
"12902","203085",2009,375,168,207,118,48,70,41.67,0.4167,0.315,0.232
"12903","203128",2009,293,143,150,154,74,80,55.94,0.5594,0.526,0.493
"12904","203368",2009,660,335,325,373,163,210,62.69,0.6269,0.565,0.502
"12905","203517",2009,4003,2437,1566,1298,400,898,36.85,0.3685,0.324,0.255
"12906","203535",2009,468,248,220,393,176,217,87.5,0.875,0.84,0.8
"12907","203580",2009,263,127,136,95,44,51,40.16,0.4016,0.361,0.324
"12908","203775",2009,477,275,202,230,80,150,54.55,0.5455,0.482,0.396
"12909","203845",2009,386,178,208,218,109,109,61.24,0.6124,0.565,0.524
"12910","204024",2009,3219,1745,1474,2104,855,1249,71.58,0.7158,0.654,0.58
"12911","204185",2009,578,286,292,315,124,191,66.78,0.6678,0.545,0.425
"12912","204194",2009,300,190,110,172,61,111,58.42,0.5842,0.573,0.555
"12913","204617",2009,274,143,131,98,40,58,40.56,0.4056,0.358,0.305
"12914","204796",2009,6724,3237,3487,3935,1699,2236,69.08,0.6908,0.585,0.487
"12915","204857",2009,4052,2217,1835,1954,702,1252,56.47,0.5647,0.482,0.383
"12916","206330",2009,182,75,107,28,10,18,24,0.24,0.154,0.093
"12917","206589",2009,479,264,215,371,154,217,82.2,0.822,0.775,0.716
"12918","206604",2009,2463,1378,1085,515,196,319,23.15,0.2315,0.209,0.181
"12919","206622",2009,1178,637,541,779,352,427,67.03,0.6703,0.661,0.651
"12920","206695",2009,2564,1306,1258,240,111,129,9.88,0.0988,0.094,0.088
"12921","206914",2009,855,489,366,73,28,45,9.2,0.092,0.085,0.077
"12922","207209",2009,561,253,308,17,6,11,4.35,0.0435,0.03,0.019
"12923","207306",2009,402,199,203,32,8,24,12.06,0.1206,0.08,0.039
"12924","207324",2009,471,218,253,148,67,81,37.16,0.3716,0.314,0.265
"12925","207388",2009,2973,1544,1429,997,365,632,40.93,0.4093,0.335,0.255
"12926","207500",2009,3700,1917,1783,1411,555,856,44.65,0.4465,0.381,0.311
"12927","207722",2009,166,113,53,49,12,37,32.74,0.3274,0.295,0.226
"12928","207847",2009,639,313,326,84,38,46,14.7,0.147,0.131,0.117
"12929","207865",2009,900,481,419,105,30,75,15.59,0.1559,0.117,0.072
"12930","208822",2009,411,239,172,249,102,147,61.51,0.6151,0.606,0.593
"12931","209056",2009,494,298,196,327,122,205,68.79,0.6879,0.662,0.622
"12932","209065",2009,420,252,168,226,76,150,59.52,0.5952,0.538,0.452
"12933","209542",2009,3314,1620,1694,1072,400,672,41.48,0.4148,0.323,0.236
"12934","209551",2009,3788,2027,1761,1900,778,1122,55.35,0.5535,0.502,0.442
"12935","209612",2009,333,204,129,213,82,131,64.22,0.6422,0.64,0.636
"12936","209807",2009,1551,800,751,296,109,187,23.38,0.2338,0.191,0.145
"12937","209922",2009,367,192,175,253,122,131,68.23,0.6823,0.689,0.697
"12938","210146",2009,652,378,274,131,37,94,24.87,0.2487,0.201,0.135
"12939","210401",2009,541,294,247,384,165,219,74.49,0.7449,0.71,0.668
"12940","210429",2009,933,553,380,192,39,153,27.67,0.2767,0.206,0.103
"12941","210571",2009,541,317,224,268,83,185,58.36,0.5836,0.495,0.371
"12942","210669",2009,580,299,281,395,177,218,72.91,0.7291,0.681,0.63
"12943","210775",2009,328,188,140,124,53,71,37.77,0.3777,0.378,0.379
"12944","211088",2009,529,381,148,257,70,187,49.08,0.4908,0.486,0.473
"12945","211158",2009,2031,1221,810,772,252,520,42.59,0.4259,0.38,0.311
"12946","211291",2009,920,466,454,780,371,409,87.77,0.8777,0.848,0.817
"12947","211352",2009,357,237,120,178,57,121,51.05,0.5105,0.499,0.475
"12948","211361",2009,1373,679,694,323,156,167,24.59,0.2459,0.235,0.225
"12949","211431",2009,250,245,5,100,1,99,40.41,0.4041,0.4,0.2
"12950","211440",2009,1423,611,812,1026,558,468,76.6,0.766,0.721,0.687
"12951","211468",2009,195,194,1,84,0,84,43.3,0.433,0.431,0
"12952","211556",2009,131,131,0,66,0,66,50.38,0.5038,0.504,NA
"12953","211583",2009,273,164,109,101,27,74,45.12,0.4512,0.37,0.248
"12954","211608",2009,372,199,173,22,7,15,7.54,0.0754,0.059,0.04
"12955","211644",2009,1384,805,579,395,122,273,33.91,0.3391,0.285,0.211
"12956","211981",2009,452,252,200,227,74,153,60.71,0.6071,0.502,0.37
"12957","212009",2009,581,340,241,472,191,281,82.65,0.8265,0.812,0.793
"12958","212054",2009,2268,898,1370,516,209,307,34.19,0.3419,0.228,0.153
"12959","212106",2009,1425,814,611,787,296,491,60.32,0.6032,0.552,0.484
"12960","212115",2009,1342,737,605,466,167,299,40.57,0.4057,0.347,0.276
"12961","212133",2009,489,318,171,213,61,152,47.8,0.478,0.436,0.357
"12962","212160",2009,1407,803,604,266,82,184,22.91,0.2291,0.189,0.136
"12963","212197",2009,544,340,204,391,133,258,75.88,0.7588,0.719,0.652
"12964","212577",2009,629,334,295,511,229,282,84.43,0.8443,0.812,0.776
"12965","212601",2009,648,382,266,310,106,204,53.4,0.534,0.478,0.398
"12966","212832",2009,313,214,99,47,18,29,13.55,0.1355,0.15,0.182
"12967","212911",2009,323,186,137,275,121,154,82.8,0.828,0.851,0.883
"12968","213020",2009,2993,1774,1219,1068,329,739,41.66,0.4166,0.357,0.27
"12969","213251",2009,366,207,159,246,98,148,71.5,0.715,0.672,0.616
"12970","213321",2009,499,233,266,303,142,161,69.1,0.691,0.607,0.534
"12971","213349",2009,1985,1132,853,689,221,468,41.34,0.4134,0.347,0.259
"12972","213358",2009,190,121,69,46,15,31,25.62,0.2562,0.242,0.217
"12973","213367",2009,1005,580,425,522,209,313,53.97,0.5397,0.519,0.492
"12974","213385",2009,616,298,318,533,263,270,90.6,0.906,0.865,0.827
"12975","213507",2009,378,205,173,258,92,166,80.98,0.8098,0.683,0.532
"12976","213543",2009,1189,489,700,878,469,409,83.64,0.8364,0.738,0.67
"12977","213613",2009,1185,702,483,336,117,219,31.2,0.312,0.284,0.242
"12978","213668",2009,383,194,189,220,89,131,67.53,0.6753,0.574,0.471
"12979","213783",2009,704,397,307,189,71,118,29.72,0.2972,0.268,0.231
"12980","213826",2009,411,287,124,231,54,177,61.67,0.6167,0.562,0.435
"12981","213996",2009,697,440,257,497,173,324,73.64,0.7364,0.713,0.673
"12982","214041",2009,1317,726,591,472,179,293,40.36,0.4036,0.358,0.303
"12983","214069",2009,371,236,135,237,78,159,67.37,0.6737,0.639,0.578
"12984","214157",2009,379,223,156,248,97,151,67.71,0.6771,0.654,0.622
"12985","214175",2009,576,337,239,475,187,288,85.46,0.8546,0.825,0.782
"12986","214272",2009,519,323,196,189,57,132,40.87,0.4087,0.364,0.291
"12987","214777",2009,6574,3217,3357,4226,1910,2316,71.99,0.7199,0.643,0.569
"12988","215062",2009,2402,1232,1170,2091,976,1115,90.5,0.905,0.871,0.834
"12989","215743",2009,349,207,142,15,3,12,5.8,0.058,0.043,0.021
"12990","215798",2009,446,197,249,267,125,142,72.08,0.7208,0.599,0.502
"12991","215929",2009,1027,578,449,747,296,451,78.03,0.7803,0.727,0.659
"12992","216010",2009,1673,873,800,669,273,396,45.36,0.4536,0.4,0.341
"12993","216038",2009,1534,915,619,795,258,537,58.69,0.5869,0.518,0.417
"12994","216287",2009,394,204,190,343,159,184,90.2,0.902,0.871,0.837
"12995","216339",2009,4183,2320,1863,1808,687,1121,48.32,0.4832,0.432,0.369
"12996","216524",2009,509,260,249,379,178,201,77.31,0.7731,0.745,0.715
"12997","216694",2009,380,221,159,211,77,134,60.63,0.6063,0.555,0.484
"12998","216764",2009,2241,1353,888,954,277,677,50.04,0.5004,0.426,0.312
"12999","216807",2009,451,277,174,313,117,196,70.76,0.7076,0.694,0.672
"13000","216852",2009,710,372,338,304,127,177,47.58,0.4758,0.428,0.376
"13001","216931",2009,527,243,284,250,121,129,53.09,0.5309,0.474,0.426
"13002","217059",2009,1092,595,497,431,144,287,48.24,0.4824,0.395,0.29
"13003","217156",2009,1490,770,720,1238,598,640,83.12,0.8312,0.831,0.831
"13004","217402",2009,952,549,403,772,324,448,81.6,0.816,0.811,0.804
"13005","217536",2009,501,346,155,343,98,245,70.81,0.7081,0.685,0.632
"13006","217776",2009,168,100,68,67,26,41,41,0.41,0.399,0.382
"13007","217819",2009,2136,1497,639,1203,320,883,58.98,0.5898,0.563,0.501
"13008","217882",2009,3336,1564,1772,1926,853,1073,68.61,0.6861,0.577,0.481
"13009","217998",2009,182,99,83,102,45,57,57.58,0.5758,0.56,0.542
"13010","218061",2009,791,533,258,142,44,98,18.39,0.1839,0.18,0.171
"13011","218229",2009,581,405,176,160,46,114,28.15,0.2815,0.275,0.261
"13012","218238",2009,288,133,155,63,22,41,30.83,0.3083,0.219,0.142
"13013","218399",2009,300,166,134,37,9,28,16.87,0.1687,0.123,0.067
"13014","218414",2009,342,133,209,84,32,52,39.1,0.391,0.246,0.153
"13015","218663",2009,3881,2089,1792,2132,825,1307,62.57,0.6257,0.549,0.46
"13016","218724",2009,1766,950,816,465,142,323,34,0.34,0.263,0.174
"13017","218733",2009,713,358,355,106,37,69,19.27,0.1927,0.149,0.104
"13018","218742",2009,837,540,297,219,63,156,28.89,0.2889,0.262,0.212
"13019","218973",2009,391,203,188,302,138,164,80.79,0.8079,0.772,0.734
"13020","219000",2009,431,261,170,245,80,165,63.22,0.6322,0.568,0.471
"13021","219046",2009,540,308,232,85,23,62,20.13,0.2013,0.157,0.099
"13022","219082",2009,284,116,168,54,28,26,22.41,0.2241,0.19,0.167
"13023","219198",2009,109,66,43,47,16,31,46.97,0.4697,0.431,0.372
"13024","219259",2009,317,197,120,65,16,49,24.87,0.2487,0.205,0.133
"13025","219356",2009,2043,1032,1011,602,247,355,34.4,0.344,0.295,0.244
"13026","219471",2009,971,559,412,286,91,195,34.88,0.3488,0.295,0.221
"13027","219602",2009,1465,897,568,214,74,140,15.61,0.1561,0.146,0.13
"13028","219709",2009,986,558,428,561,222,339,60.75,0.6075,0.569,0.519
"13029","219718",2009,351,151,200,90,36,54,35.76,0.3576,0.256,0.18
"13030","219949",2009,200,101,99,62,25,37,36.63,0.3663,0.31,0.253
"13031","220075",2009,2063,1144,919,415,146,269,23.51,0.2351,0.201,0.159
"13032","220215",2009,405,240,165,177,72,105,43.75,0.4375,0.437,0.436
"13033","220613",2009,829,507,322,288,80,208,41.03,0.4103,0.347,0.248
"13034","220631",2009,314,218,96,61,15,46,21.1,0.211,0.194,0.156
"13035","220710",2009,304,154,150,56,46,10,6.49,0.0649,0.184,0.307
"13036","221351",2009,427,236,191,320,133,187,79.24,0.7924,0.749,0.696
"13037","221519",2009,401,203,198,296,140,156,76.85,0.7685,0.738,0.707
"13038","221731",2009,246,163,83,75,22,53,32.52,0.3252,0.305,0.265
"13039","221847",2009,1879,884,995,476,181,295,33.37,0.3337,0.253,0.182
"13040","221892",2009,240,145,95,96,35,61,42.07,0.4207,0.4,0.368
"13041","222178",2009,979,520,459,406,136,270,51.92,0.5192,0.415,0.296
"13042","222983",2009,413,213,200,295,129,166,77.93,0.7793,0.714,0.645
"13043","223232",2009,3097,1825,1272,1672,592,1080,59.18,0.5918,0.54,0.465
"13044","224004",2009,225,122,103,58,22,36,29.51,0.2951,0.258,0.214
"13045","224323",2009,319,169,150,212,96,116,68.64,0.6864,0.665,0.64
"13046","225432",2009,722,378,344,10,6,4,1.06,0.0106,0.014,0.017
"13047","225548",2009,209,84,125,74,31,43,51.19,0.5119,0.354,0.248
"13048","225627",2009,717,469,248,178,49,129,27.51,0.2751,0.248,0.198
"13049","226231",2009,341,109,232,123,83,40,36.7,0.367,0.361,0.358
"13050","226833",2009,701,386,315,139,40,99,25.65,0.2565,0.198,0.127
"13051","227216",2009,3255,1832,1423,881,271,610,33.3,0.333,0.271,0.19
"13052","227331",2009,246,170,76,54,14,40,23.53,0.2353,0.22,0.184
"13053","227526",2009,1638,957,681,180,42,138,14.42,0.1442,0.11,0.062
"13054","227757",2009,887,427,460,710,342,368,86.18,0.8618,0.8,0.743
"13055","227845",2009,755,470,285,383,123,260,55.32,0.5532,0.507,0.432
"13056","227863",2009,284,181,103,106,34,72,39.78,0.3978,0.373,0.33
"13057","228042",2009,289,155,134,98,44,54,34.84,0.3484,0.339,0.328
"13058","228149",2009,530,335,195,270,76,194,57.91,0.5791,0.509,0.39
"13059","228246",2009,1325,702,623,886,374,512,72.93,0.7293,0.669,0.6
"13060","228343",2009,375,231,144,257,88,169,73.16,0.7316,0.685,0.611
"13061","228431",2009,2553,1613,940,576,135,441,27.34,0.2734,0.226,0.144
"13062","228459",2009,3804,2260,1544,985,271,714,31.59,0.3159,0.259,0.176
"13063","228501",2009,374,135,239,36,15,21,15.56,0.1556,0.096,0.063
"13064","228529",2009,1207,668,539,293,96,197,29.49,0.2949,0.243,0.178
"13065","228705",2009,971,414,557,165,75,90,21.74,0.2174,0.17,0.135
"13066","228723",2009,7933,3908,4025,4017,1602,2415,61.8,0.618,0.506,0.398
"13067","228769",2009,2435,1261,1174,502,206,296,23.47,0.2347,0.206,0.175
"13068","228778",2009,7198,3853,3345,3746,1514,2232,57.93,0.5793,0.52,0.453
"13069","228787",2009,1293,560,733,615,304,311,55.54,0.5554,0.476,0.415
"13070","228796",2009,2281,1153,1128,274,95,179,15.52,0.1552,0.12,0.084
"13071","228875",2009,1818,1142,676,1068,348,720,63.05,0.6305,0.587,0.515
"13072","228981",2009,345,171,174,104,43,61,35.67,0.3567,0.301,0.247
"13073","229018",2009,326,176,150,72,29,43,24.43,0.2443,0.221,0.193
"13074","229027",2009,4559,2281,2278,507,180,327,14.34,0.1434,0.111,0.079
"13075","229115",2009,4514,2185,2329,1582,641,941,43.07,0.4307,0.35,0.275
"13076","229780",2009,214,103,111,38,11,27,26.21,0.2621,0.178,0.099
"13077","229814",2009,1193,603,590,260,78,182,30.18,0.3018,0.218,0.132
"13078","230603",2009,1101,742,359,193,42,151,20.35,0.2035,0.175,0.117
"13079","230728",2009,2664,1663,1001,508,100,408,24.53,0.2453,0.191,0.1
"13080","230764",2009,2102,1177,925,597,205,392,33.31,0.3331,0.284,0.222
"13081","230782",2009,1845,1011,834,140,43,97,9.59,0.0959,0.076,0.052
"13082","231059",2009,470,230,240,322,146,176,76.52,0.7652,0.685,0.608
"13083","231174",2009,2607,1482,1125,1733,691,1042,70.31,0.7031,0.665,0.614
"13084","231420",2009,222,78,144,52,27,25,32.05,0.3205,0.234,0.188
"13085","231554",2009,115,64,51,36,11,25,39.06,0.3906,0.313,0.216
"13086","231624",2009,1384,728,656,1133,503,630,86.54,0.8654,0.819,0.767
"13087","231712",2009,1212,719,493,689,235,454,63.14,0.6314,0.568,0.477
"13088","232025",2009,283,115,168,108,52,56,48.7,0.487,0.382,0.31
"13089","232043",2009,218,135,83,110,40,70,51.85,0.5185,0.505,0.482
"13090","232089",2009,531,262,269,106,45,61,23.28,0.2328,0.2,0.167
"13091","232186",2009,2627,1367,1260,1198,446,752,55.01,0.5501,0.456,0.354
"13092","232265",2009,1017,632,385,135,135,0,0,0,0.133,0.351
"13093","232423",2009,3948,2488,1460,2625,823,1802,72.43,0.7243,0.665,0.564
"13094","232557",2009,3871,2113,1758,1154,439,715,33.84,0.3384,0.298,0.25
"13095","232566",2009,934,631,303,414,96,318,50.4,0.504,0.443,0.317
"13096","232609",2009,592,348,244,278,91,187,53.74,0.5374,0.47,0.373
"13097","232681",2009,925,600,325,543,156,387,64.5,0.645,0.587,0.48
"13098","232706",2009,383,274,109,131,31,100,36.5,0.365,0.342,0.284
"13099","232937",2009,1160,654,506,183,63,120,18.35,0.1835,0.158,0.125
"13100","232982",2009,2691,1346,1345,698,263,435,32.32,0.3232,0.259,0.196
"13101","233277",2009,1444,838,606,637,217,420,50.12,0.5012,0.441,0.358
"13102","233374",2009,918,546,372,758,293,465,85.16,0.8516,0.826,0.788
"13103","233426",2009,560,325,235,327,123,204,62.77,0.6277,0.584,0.523
"13104","233541",2009,443,235,208,155,46,109,46.38,0.4638,0.35,0.221
"13105","233897",2009,397,172,225,87,40,47,27.33,0.2733,0.219,0.178
"13106","233921",2009,5036,2266,2770,3075,1446,1629,71.89,0.7189,0.611,0.522
"13107","234030",2009,3588,2094,1494,1318,475,843,40.26,0.4026,0.367,0.318
"13108","234085",2009,429,42,387,261,237,24,57.14,0.5714,0.608,0.612
"13109","234155",2009,1225,806,419,353,93,260,32.26,0.3226,0.288,0.222
"13110","234164",2009,554,303,251,99,34,65,21.45,0.2145,0.179,0.135
"13111","235097",2009,1459,848,611,298,98,200,23.58,0.2358,0.204,0.16
"13112","235167",2009,576,284,292,234,112,122,42.96,0.4296,0.406,0.384
"13113","236230",2009,712,436,276,373,123,250,57.34,0.5734,0.524,0.446
"13114","236328",2009,719,419,300,517,198,319,76.13,0.7613,0.719,0.66
"13115","236577",2009,682,489,193,361,93,268,54.81,0.5481,0.529,0.482
"13116","236595",2009,730,459,271,468,156,312,67.97,0.6797,0.641,0.576
"13117","236896",2009,316,157,159,59,20,39,24.84,0.2484,0.187,0.126
"13118","236939",2009,3627,1888,1739,1366,549,817,43.27,0.4327,0.377,0.316
"13119","236948",2009,5119,2795,2324,3227,1338,1889,67.58,0.6758,0.63,0.576
"13120","237011",2009,2670,1521,1149,1062,369,693,45.56,0.4556,0.398,0.321
"13121","237057",2009,395,238,157,314,117,197,82.77,0.8277,0.795,0.745
"13122","237066",2009,555,324,231,354,145,209,64.51,0.6451,0.638,0.628
"13123","237215",2009,304,177,127,28,18,10,5.65,0.0565,0.092,0.142
"13124","237330",2009,607,348,259,121,44,77,22.13,0.2213,0.199,0.17
"13125","237358",2009,234,139,95,60,23,37,26.62,0.2662,0.256,0.242
"13126","237367",2009,795,412,383,118,58,60,14.56,0.1456,0.148,0.151
"13127","237792",2009,786,437,349,169,63,106,24.26,0.2426,0.215,0.181
"13128","237899",2009,246,120,126,28,9,19,15.83,0.1583,0.114,0.071
"13129","237932",2009,569,340,229,130,33,97,28.53,0.2853,0.228,0.144
"13130","237969",2009,399,197,202,151,61,90,45.69,0.4569,0.378,0.302
"13131","238032",2009,4555,2098,2457,1501,661,840,40.04,0.4004,0.33,0.269
"13132","238333",2009,332,199,133,233,90,143,71.86,0.7186,0.702,0.677
"13133","238430",2009,209,119,90,19,4,15,12.61,0.1261,0.091,0.044
"13134","238458",2009,738,482,256,311,102,209,43.36,0.4336,0.421,0.398
"13135","238476",2009,721,351,370,359,158,201,57.26,0.5726,0.498,0.427
"13136","238616",2009,468,266,202,171,63,108,40.6,0.406,0.365,0.312
"13137","238661",2009,285,213,72,110,27,83,38.97,0.3897,0.386,0.375
"13138","239080",2009,316,228,88,88,19,69,30.26,0.3026,0.278,0.216
"13139","239105",2009,1945,1005,940,1135,505,630,62.69,0.6269,0.584,0.537
"13140","239628",2009,248,123,125,148,68,80,65.04,0.6504,0.597,0.544
"13141","239716",2009,543,308,235,359,135,224,72.73,0.7273,0.661,0.574
"13142","240107",2009,405,287,118,119,24,95,33.1,0.331,0.294,0.203
"13143","240189",2009,1941,941,1000,542,250,292,31.03,0.3103,0.279,0.25
"13144","240277",2009,1037,647,390,248,58,190,29.37,0.2937,0.239,0.149
"13145","240329",2009,1826,1128,698,660,193,467,41.4,0.414,0.361,0.277
"13146","240338",2009,202,104,98,89,33,56,53.85,0.5385,0.441,0.337
"13147","240365",2009,1874,1061,813,274,95,179,16.87,0.1687,0.146,0.117
"13148","240374",2009,788,427,361,88,31,57,13.35,0.1335,0.112,0.086
"13149","240417",2009,1517,788,729,350,111,239,30.33,0.3033,0.231,0.152
"13150","240426",2009,364,194,170,58,22,36,18.56,0.1856,0.159,0.129
"13151","240444",2009,5673,3033,2640,3179,1277,1902,62.71,0.6271,0.56,0.484
"13152","240453",2009,4051,2020,2031,578,250,328,16.24,0.1624,0.143,0.123
"13153","240462",2009,1531,512,1019,304,166,138,26.95,0.2695,0.199,0.163
"13154","240471",2009,1325,836,489,382,108,274,32.78,0.3278,0.288,0.221
"13155","240480",2009,1632,835,797,422,156,266,31.86,0.3186,0.259,0.196
"13156","240727",2009,1568,799,769,405,136,269,33.67,0.3367,0.258,0.177
"13157","243443",2009,726,461,265,43,12,31,6.72,0.0672,0.059,0.045
"13158","243780",2009,6308,2660,3648,2868,1412,1456,54.74,0.5474,0.455,0.387
"13159","100654",2010,1073,549,524,69,18,51,9.29,0.0929,0.064,0.034
"13160","100663",2010,1537,851,686,463,176,287,33.73,0.3373,0.301,0.257
"13161","100751",2010,5443,3006,2437,2387,856,1531,50.93,0.5093,0.439,0.351
"13162","100858",2010,4193,2204,1989,1963,730,1233,55.94,0.5594,0.468,0.367
"13163","101435",2010,271,113,158,71,30,41,36.28,0.3628,0.262,0.19
"13164","101480",2010,1246,685,561,180,55,125,18.25,0.1825,0.144,0.098
"13165","101675",2010,343,141,202,44,18,26,18.44,0.1844,0.128,0.089
"13166","101879",2010,961,562,399,152,43,109,19.4,0.194,0.158,0.108
"13167","102049",2010,711,455,256,417,132,285,62.64,0.6264,0.586,0.516
"13168","102094",2010,1707,950,757,262,83,179,18.84,0.1884,0.153,0.11
"13169","102234",2010,392,252,140,180,56,124,49.21,0.4921,0.459,0.4
"13170","102368",2010,1810,1083,727,295,97,198,18.28,0.1828,0.163,0.133
"13171","102377",2010,701,393,308,228,99,129,32.82,0.3282,0.325,0.321
"13172","104151",2010,6210,2997,3213,3071,1409,1662,55.46,0.5546,0.495,0.439
"13173","104179",2010,6797,3629,3168,2847,1137,1710,47.12,0.4712,0.419,0.359
"13174","105330",2010,3739,2209,1530,1354,442,912,41.29,0.4129,0.362,0.289
"13175","106245",2010,683,376,307,80,40,40,10.64,0.1064,0.117,0.13
"13176","106342",2010,198,107,91,70,29,41,38.32,0.3832,0.354,0.319
"13177","106397",2010,3774,1929,1845,1596,634,962,49.87,0.4987,0.423,0.344
"13178","106412",2010,780,393,387,51,13,38,9.67,0.0967,0.065,0.034
"13179","106458",2010,1659,897,762,438,167,271,30.21,0.3021,0.264,0.219
"13180","106467",2010,1681,823,858,259,105,154,18.71,0.1871,0.154,0.122
"13181","106485",2010,689,338,351,69,30,39,11.54,0.1154,0.1,0.085
"13182","106704",2010,1828,1070,758,445,155,290,27.1,0.271,0.243,0.204
"13183","107044",2010,988,506,482,426,177,249,49.21,0.4921,0.431,0.367
"13184","107080",2010,403,237,166,259,96,163,68.78,0.6878,0.643,0.578
"13185","107141",2010,322,175,147,180,82,98,56,0.56,0.559,0.558
"13186","107512",2010,450,243,207,264,102,162,66.67,0.6667,0.587,0.493
"13187","107558",2010,204,114,90,61,28,33,28.95,0.2895,0.299,0.311
"13188","110097",2010,877,560,317,471,159,312,55.71,0.5571,0.537,0.502
"13189","110404",2010,220,87,133,179,105,74,85.06,0.8506,0.814,0.789
"13190","110422",2010,3459,1642,1817,1634,636,998,60.78,0.6078,0.472,0.35
"13191","110486",2010,1013,613,400,148,50,98,15.99,0.1599,0.146,0.125
"13192","110495",2010,998,670,328,156,41,115,17.16,0.1716,0.156,0.125
"13193","110510",2010,1747,1114,633,251,73,178,15.98,0.1598,0.144,0.115
"13194","110529",2010,1923,835,1088,352,150,202,24.19,0.2419,0.183,0.138
"13195","110538",2010,1880,1048,832,484,160,324,30.92,0.3092,0.257,0.192
"13196","110547",2010,982,633,349,50,17,33,5.21,0.0521,0.051,0.049
"13197","110556",2010,2582,1551,1031,420,116,304,19.6,0.196,0.163,0.113
"13198","110565",2010,3749,2160,1589,660,173,487,22.55,0.2255,0.176,0.109
"13199","110574",2010,1192,751,441,168,47,121,16.11,0.1611,0.141,0.107
"13200","110583",2010,3913,2310,1603,585,189,396,17.14,0.1714,0.15,0.118
"13201","110592",2010,2013,1222,791,127,48,79,6.46,0.0646,0.063,0.061
"13202","110617",2010,2625,1548,1077,238,69,169,10.92,0.1092,0.091,0.064
"13203","113698",2010,338,255,83,192,45,147,57.65,0.5765,0.568,0.542
"13204","115755",2010,1282,701,581,188,65,123,17.55,0.1755,0.147,0.112
"13205","119173",2010,525,507,18,140,3,137,27.02,0.2702,0.267,0.167
"13206","120184",2010,145,94,51,50,15,35,37.23,0.3723,0.345,0.294
"13207","121309",2010,588,360,228,367,130,237,65.83,0.6583,0.624,0.57
"13208","121345",2010,401,217,184,369,169,200,92.17,0.9217,0.92,0.918
"13209","122409",2010,3031,1802,1229,1017,352,665,36.9,0.369,0.336,0.286
"13210","122436",2010,1148,662,486,752,280,472,71.3,0.713,0.655,0.576
"13211","122597",2010,3609,2179,1430,648,210,438,20.1,0.201,0.18,0.147
"13212","122612",2010,1171,750,421,721,233,488,65.07,0.6507,0.616,0.553
"13213","122931",2010,1295,644,651,1056,498,558,86.65,0.8665,0.815,0.765
"13214","123554",2010,694,421,273,387,139,248,58.91,0.5891,0.558,0.509
"13215","123572",2010,1547,925,622,430,106,324,35.03,0.3503,0.278,0.17
"13216","126562",2010,1020,551,469,210,76,134,24.32,0.2432,0.206,0.162
"13217","126580",2010,1123,568,555,284,112,172,30.28,0.3028,0.253,0.202
"13218","126614",2010,5138,2403,2735,2438,1094,1344,55.93,0.5593,0.475,0.4
"13219","126818",2010,4321,2414,1907,1820,656,1164,48.22,0.4822,0.421,0.344
"13220","127060",2010,1215,663,552,806,320,486,73.3,0.733,0.663,0.58
"13221","127185",2010,830,393,437,203,74,129,32.82,0.3282,0.245,0.169
"13222","127565",2010,1876,916,960,112,43,69,7.53,0.0753,0.06,0.045
"13223","127741",2010,2221,1420,801,653,183,470,33.1,0.331,0.294,0.228
"13224","128106",2010,977,467,510,182,80,102,21.84,0.2184,0.186,0.157
"13225","128744",2010,594,397,197,122,41,81,20.4,0.204,0.205,0.208
"13226","128771",2010,1340,592,748,279,125,154,26.01,0.2601,0.208,0.167
"13227","129020",2010,3317,1629,1688,2300,1076,1224,75.14,0.7514,0.693,0.637
"13228","129242",2010,921,576,345,722,250,472,81.94,0.8194,0.784,0.725
"13229","129941",2010,1005,534,471,452,198,254,47.57,0.4757,0.45,0.42
"13230","130253",2010,974,610,364,529,167,362,59.34,0.5934,0.543,0.459
"13231","130314",2010,229,229,0,137,0,137,59.83,0.5983,0.598,NA
"13232","130493",2010,1248,792,456,299,58,241,30.43,0.3043,0.24,0.127
"13233","130590",2010,591,300,291,473,223,250,83.33,0.8333,0.8,0.766
"13234","130697",2010,748,411,337,652,292,360,87.59,0.8759,0.872,0.866
"13235","130776",2010,975,524,451,209,85,124,23.66,0.2366,0.214,0.188
"13236","130794",2010,1343,696,647,1161,547,614,88.22,0.8822,0.864,0.845
"13237","130934",2010,887,556,331,220,58,162,29.14,0.2914,0.248,0.175
"13238","130943",2010,3719,2116,1603,2399,913,1486,70.23,0.7023,0.645,0.57
"13239","131159",2010,1498,911,587,1145,438,707,77.61,0.7761,0.764,0.746
"13240","131283",2010,991,576,415,613,240,373,64.76,0.6476,0.619,0.578
"13241","131450",2010,198,107,91,39,10,29,27.1,0.271,0.197,0.11
"13242","131469",2010,2376,1316,1060,1805,761,1044,79.33,0.7933,0.76,0.718
"13243","131496",2010,1569,859,710,1414,623,791,92.08,0.9208,0.901,0.877
"13244","131520",2010,1464,1034,430,571,122,449,43.42,0.4342,0.39,0.284
"13245","132471",2010,625,403,222,98,32,66,16.38,0.1638,0.157,0.144
"13246","132602",2010,924,579,345,132,32,100,17.27,0.1727,0.143,0.093
"13247","132903",2010,6028,3179,2849,2407,859,1548,48.69,0.4869,0.399,0.302
"13248","133492",2010,496,300,196,304,117,187,62.33,0.6233,0.613,0.597
"13249","133553",2010,949,120,829,283,239,44,36.67,0.3667,0.298,0.288
"13250","133650",2010,2701,1636,1065,331,94,237,14.49,0.1449,0.123,0.088
"13251","133669",2010,2616,1359,1257,501,169,332,24.43,0.2443,0.192,0.134
"13252","133711",2010,612,347,265,281,98,183,52.74,0.5274,0.459,0.37
"13253","133881",2010,489,138,351,220,142,78,56.52,0.5652,0.45,0.405
"13254","133951",2010,3752,2079,1673,931,280,651,31.31,0.3131,0.248,0.167
"13255","134079",2010,602,357,245,314,119,195,54.62,0.5462,0.522,0.486
"13256","134097",2010,5957,3515,2442,3620,1249,2371,67.45,0.6745,0.608,0.511
"13257","134130",2010,6345,3661,2684,4275,1469,2806,76.65,0.7665,0.674,0.547
"13258","134945",2010,624,313,311,197,87,110,35.14,0.3514,0.316,0.28
"13259","135726",2010,2105,1072,1033,1465,646,819,76.4,0.764,0.696,0.625
"13260","136172",2010,1926,1078,848,504,137,367,34.04,0.3404,0.262,0.162
"13261","136950",2010,465,286,179,298,100,198,69.23,0.6923,0.641,0.559
"13262","137546",2010,545,331,214,305,109,196,59.21,0.5921,0.56,0.509
"13263","138354",2010,1211,661,550,325,118,207,31.32,0.3132,0.268,0.215
"13264","138716",2010,883,542,341,47,13,34,6.27,0.0627,0.053,0.038
"13265","138789",2010,1161,685,476,141,41,100,14.6,0.146,0.121,0.086
"13266","139144",2010,653,431,222,386,126,260,60.32,0.6032,0.591,0.568
"13267","139366",2010,1154,718,436,130,43,87,12.12,0.1212,0.113,0.099
"13268","139393",2010,269,131,138,160,66,94,71.76,0.7176,0.595,0.478
"13269","139658",2010,1321,748,573,1125,462,663,88.64,0.8864,0.852,0.806
"13270","139719",2010,840,487,353,69,26,43,8.83,0.0883,0.082,0.074
"13271","139755",2010,2706,976,1730,1111,648,463,47.44,0.4744,0.411,0.375
"13272","139764",2010,473,284,189,64,13,51,17.96,0.1796,0.135,0.069
"13273","139861",2010,1202,767,435,505,138,367,47.85,0.4785,0.42,0.317
"13274","139931",2010,3597,1785,1812,950,305,645,36.13,0.3613,0.264,0.168
"13275","139940",2010,2853,1540,1313,669,240,429,27.86,0.2786,0.234,0.183
"13276","139959",2010,4667,2886,1781,2903,961,1942,67.29,0.6729,0.622,0.54
"13277","140447",2010,596,301,295,293,116,177,58.8,0.588,0.492,0.393
"13278","140960",2010,953,504,449,81,19,62,12.3,0.123,0.085,0.042
"13279","140988",2010,446,216,230,121,48,73,33.8,0.338,0.271,0.209
"13280","141185",2010,153,78,75,54,16,38,48.72,0.4872,0.353,0.213
"13281","141264",2010,2528,1554,974,401,100,301,19.37,0.1937,0.159,0.103
"13282","141334",2010,1844,1124,720,309,79,230,20.46,0.2046,0.168,0.11
"13283","141486",2010,287,203,84,101,29,72,35.47,0.3547,0.352,0.345
"13284","141565",2010,392,230,162,43,13,30,13.04,0.1304,0.11,0.08
"13285","141574",2010,1776,984,792,439,164,275,27.95,0.2795,0.247,0.207
"13286","142276",2010,1432,749,683,121,34,87,11.62,0.1162,0.084,0.05
"13287","142285",2010,1709,799,910,511,226,285,35.67,0.3567,0.299,0.248
"13288","142461",2010,253,151,102,78,30,48,31.79,0.3179,0.308,0.294
"13289","143084",2010,753,432,321,532,206,326,75.46,0.7546,0.707,0.642
"13290","143288",2010,150,105,45,46,9,37,35.24,0.3524,0.307,0.2
"13291","144005",2010,523,354,169,14,2,12,3.39,0.0339,0.027,0.012
"13292","144281",2010,2209,1252,957,665,258,407,32.51,0.3251,0.301,0.27
"13293","144740",2010,2235,1307,928,1313,501,812,62.13,0.6213,0.587,0.54
"13294","144892",2010,1446,892,554,492,157,335,37.56,0.3756,0.34,0.283
"13295","144962",2010,537,330,207,301,99,202,61.21,0.6121,0.561,0.478
"13296","144971",2010,174,92,82,70,30,40,43.48,0.4348,0.402,0.366
"13297","145600",2010,3185,1731,1454,984,387,597,34.49,0.3449,0.309,0.266
"13298","145619",2010,548,311,237,197,63,134,43.09,0.4309,0.359,0.266
"13299","145637",2010,6921,3054,3867,4823,2414,2409,78.88,0.7888,0.697,0.624
"13300","145691",2010,225,113,112,134,58,76,67.26,0.6726,0.596,0.518
"13301","145813",2010,3179,1914,1265,1512,499,1013,52.93,0.5293,0.476,0.394
"13302","146481",2010,402,238,164,258,98,160,67.23,0.6723,0.642,0.598
"13303","146612",2010,632,319,313,257,126,131,41.07,0.4107,0.407,0.403
"13304","146719",2010,2063,1315,748,1342,444,898,68.29,0.6829,0.651,0.594
"13305","146825",2010,90,39,51,10,4,6,15.38,0.1538,0.111,0.078
"13306","147013",2010,335,154,181,121,54,67,43.51,0.4351,0.361,0.298
"13307","147244",2010,498,258,240,244,101,143,55.43,0.5543,0.49,0.421
"13308","147341",2010,355,187,168,168,73,95,50.8,0.508,0.473,0.435
"13309","147703",2010,2663,1338,1325,625,278,347,25.93,0.2593,0.235,0.21
"13310","147767",2010,2126,1125,1001,1785,790,995,88.44,0.8844,0.84,0.789
"13311","147776",2010,976,551,425,37,11,26,4.72,0.0472,0.038,0.026
"13312","147828",2010,740,417,323,344,128,216,51.8,0.518,0.465,0.396
"13313","148131",2010,272,136,136,94,44,50,36.76,0.3676,0.346,0.324
"13314","148496",2010,427,287,140,212,60,152,52.96,0.5296,0.496,0.429
"13315","148584",2010,210,131,79,93,29,64,48.85,0.4885,0.443,0.367
"13316","148627",2010,488,308,180,153,41,112,36.36,0.3636,0.314,0.228
"13317","149222",2010,2314,1104,1210,602,283,319,28.89,0.2889,0.26,0.234
"13318","149231",2010,2022,1104,918,520,196,324,29.35,0.2935,0.257,0.214
"13319","149772",2010,1741,886,855,534,265,269,30.36,0.3036,0.307,0.31
"13320","149781",2010,602,312,290,495,226,269,86.22,0.8622,0.822,0.779
"13321","150066",2010,469,264,205,230,79,151,57.2,0.572,0.49,0.385
"13322","150136",2010,3849,2123,1726,1588,560,1028,48.42,0.4842,0.413,0.324
"13323","150145",2010,269,169,100,144,51,93,55.03,0.5503,0.535,0.51
"13324","150163",2010,1049,616,433,600,211,389,63.15,0.6315,0.572,0.487
"13325","150400",2010,608,345,263,474,202,272,78.84,0.7884,0.78,0.768
"13326","150534",2010,683,403,280,398,136,262,65.01,0.6501,0.583,0.486
"13327","150668",2010,179,106,73,100,39,61,57.55,0.5755,0.559,0.534
"13328","150941",2010,263,146,117,144,62,82,56.16,0.5616,0.548,0.53
"13329","151102",2010,2117,1078,1039,134,47,87,8.07,0.0807,0.063,0.045
"13330","151111",2010,2679,1607,1072,478,176,302,18.79,0.1879,0.178,0.164
"13331","151306",2010,2041,1179,862,378,115,263,22.31,0.2231,0.185,0.133
"13332","151324",2010,2687,1352,1335,497,199,298,22.04,0.2204,0.185,0.149
"13333","151333",2010,345,217,128,59,23,36,16.59,0.1659,0.171,0.18
"13334","151342",2010,895,503,392,61,25,36,7.16,0.0716,0.068,0.064
"13335","151351",2010,6977,3659,3318,4165,1805,2360,64.5,0.645,0.597,0.544
"13336","151360",2010,784,495,289,47,13,34,6.87,0.0687,0.06,0.045
"13337","151379",2010,945,581,364,111,29,82,14.11,0.1411,0.117,0.08
"13338","151388",2010,378,224,154,54,15,39,17.41,0.1741,0.143,0.097
"13339","151777",2010,405,217,188,200,81,119,54.84,0.5484,0.494,0.431
"13340","151786",2010,317,166,151,124,49,75,45.18,0.4518,0.391,0.325
"13341","152080",2010,2056,966,1090,1846,966,880,91.1,0.911,0.898,0.886
"13342","152248",2010,965,484,481,101,48,53,10.95,0.1095,0.105,0.1
"13343","152363",2010,257,120,137,111,43,68,56.67,0.5667,0.432,0.314
"13344","152530",2010,467,270,197,308,112,196,72.59,0.7259,0.66,0.569
"13345","152600",2010,691,360,331,376,148,228,63.33,0.6333,0.544,0.447
"13346","153001",2010,265,139,126,117,43,74,53.24,0.5324,0.442,0.341
"13347","153108",2010,402,212,190,235,99,136,64.15,0.6415,0.585,0.521
"13348","153269",2010,864,474,390,513,218,295,62.24,0.6224,0.594,0.559
"13349","153384",2010,415,231,184,336,140,196,84.85,0.8485,0.81,0.761
"13350","153603",2010,4518,2077,2441,2006,847,1159,55.8,0.558,0.444,0.347
"13351","153834",2010,611,342,269,438,177,261,76.32,0.7632,0.717,0.658
"13352","154095",2010,1934,1214,720,759,229,530,43.66,0.4366,0.392,0.318
"13353","155089",2010,199,90,109,42,17,25,27.78,0.2778,0.211,0.156
"13354","155317",2010,3489,1743,1746,1435,603,832,47.73,0.4773,0.411,0.345
"13355","155335",2010,196,118,78,69,23,46,38.98,0.3898,0.352,0.295
"13356","155399",2010,3465,1753,1712,1068,416,652,37.19,0.3719,0.308,0.243
"13357","155520",2010,232,120,112,100,36,64,53.33,0.5333,0.431,0.321
"13358","155627",2010,156,66,90,37,12,25,37.88,0.3788,0.237,0.133
"13359","155937",2010,149,70,79,50,21,29,41.43,0.4143,0.336,0.266
"13360","156213",2010,285,187,98,149,51,98,52.41,0.5241,0.523,0.52
"13361","156286",2010,573,362,211,301,107,194,53.59,0.5359,0.525,0.507
"13362","156295",2010,429,230,199,204,72,132,57.39,0.5739,0.476,0.362
"13363","156365",2010,502,247,255,122,46,76,30.77,0.3077,0.243,0.18
"13364","156541",2010,446,202,244,144,66,78,38.61,0.3861,0.323,0.27
"13365","156745",2010,336,191,145,172,57,115,60.21,0.6021,0.512,0.393
"13366","157058",2010,569,316,253,25,8,17,5.38,0.0538,0.044,0.032
"13367","157076",2010,202,96,106,64,26,38,39.58,0.3958,0.317,0.245
"13368","157085",2010,4270,2203,2067,1625,615,1010,45.85,0.4585,0.381,0.298
"13369","157289",2010,2507,1266,1241,696,308,388,30.65,0.3065,0.278,0.248
"13370","157386",2010,1175,662,513,294,118,176,26.59,0.2659,0.25,0.23
"13371","157401",2010,1363,830,533,344,104,240,28.92,0.2892,0.252,0.195
"13372","157447",2010,2230,1238,992,321,116,205,16.56,0.1656,0.144,0.117
"13373","157535",2010,393,154,239,56,22,34,22.08,0.2208,0.142,0.092
"13374","157951",2010,3279,1865,1414,747,228,519,27.83,0.2783,0.228,0.161
"13375","158477",2010,192,104,88,81,29,52,50,0.5,0.422,0.33
"13376","159009",2010,706,384,322,183,63,120,31.25,0.3125,0.259,0.196
"13377","159391",2010,5477,2904,2573,2145,777,1368,47.11,0.4711,0.392,0.302
"13378","159647",2010,1530,679,851,504,220,284,41.83,0.4183,0.329,0.259
"13379","159717",2010,1259,756,503,261,84,177,23.41,0.2341,0.207,0.167
"13380","159966",2010,1048,652,396,201,63,138,21.17,0.2117,0.192,0.159
"13381","160038",2010,1056,678,378,213,60,153,22.57,0.2257,0.202,0.159
"13382","160612",2010,2414,1408,1006,408,133,275,19.53,0.1953,0.169,0.132
"13383","160621",2010,852,488,364,60,18,42,8.61,0.0861,0.07,0.049
"13384","160658",2010,2914,1629,1285,465,141,324,19.89,0.1989,0.16,0.11
"13385","161004",2010,507,249,258,453,230,223,89.56,0.8956,0.893,0.891
"13386","161226",2010,555,352,203,242,68,174,49.43,0.4943,0.436,0.335
"13387","161235",2010,153,94,59,27,6,21,22.34,0.2234,0.176,0.102
"13388","161244",2010,105,61,44,18,6,12,19.67,0.1967,0.171,0.136
"13389","161253",2010,1713,828,885,622,283,339,40.94,0.4094,0.363,0.32
"13390","161554",2010,763,394,369,104,43,61,15.48,0.1548,0.136,0.117
"13391","162007",2010,608,353,255,73,17,56,15.86,0.1586,0.12,0.067
"13392","162210",2010,123,83,40,21,2,19,22.89,0.2289,0.171,0.05
"13393","162283",2010,511,357,154,29,7,22,6.16,0.0616,0.057,0.045
"13394","162584",2010,1028,472,556,223,93,130,27.54,0.2754,0.217,0.167
"13395","162654",2010,388,259,129,185,50,135,52.12,0.5212,0.477,0.388
"13396","162760",2010,327,210,117,165,52,113,53.81,0.5381,0.505,0.444
"13397","162928",2010,1322,646,676,1150,577,573,88.7,0.887,0.87,0.854
"13398","163046",2010,1019,630,389,818,311,507,80.48,0.8048,0.803,0.799
"13399","163268",2010,1484,599,885,558,275,283,47.25,0.4725,0.376,0.311
"13400","163286",2010,3930,1856,2074,2700,1314,1386,74.68,0.7468,0.687,0.634
"13401","163453",2010,1208,663,545,115,32,83,12.52,0.1252,0.095,0.059
"13402","163462",2010,424,241,183,275,101,174,72.2,0.722,0.649,0.552
"13403","163851",2010,1248,770,478,595,176,419,54.42,0.5442,0.477,0.368
"13404","163912",2010,443,277,166,289,96,193,69.68,0.6968,0.652,0.578
"13405","164076",2010,2427,1593,834,1125,310,815,51.16,0.5116,0.464,0.372
"13406","164173",2010,877,535,342,331,98,233,43.55,0.4355,0.377,0.287
"13407","164216",2010,421,238,183,293,109,184,77.31,0.7731,0.696,0.596
"13408","164270",2010,408,213,195,250,93,157,73.71,0.7371,0.613,0.477
"13409","164447",2010,367,168,199,107,47,60,35.71,0.3571,0.292,0.236
"13410","164492",2010,287,140,147,95,43,52,37.14,0.3714,0.331,0.293
"13411","164562",2010,590,369,221,423,141,282,76.42,0.7642,0.717,0.638
"13412","165015",2010,686,370,316,569,247,322,87.03,0.8703,0.829,0.782
"13413","165024",2010,1431,812,619,458,174,284,34.98,0.3498,0.32,0.281
"13414","165334",2010,575,328,247,411,172,239,72.87,0.7287,0.715,0.696
"13415","165662",2010,824,529,295,634,219,415,78.45,0.7845,0.769,0.742
"13416","165671",2010,528,386,142,318,81,237,61.4,0.614,0.602,0.57
"13417","165820",2010,721,413,308,246,86,160,38.74,0.3874,0.341,0.279
"13418","165866",2010,719,481,238,245,59,186,38.67,0.3867,0.341,0.248
"13419","165936",2010,348,212,136,212,80,132,62.26,0.6226,0.609,0.588
"13420","166027",2010,1663,827,836,1434,708,726,87.79,0.8779,0.862,0.847
"13421","166124",2010,727,379,348,645,298,347,91.56,0.9156,0.887,0.856
"13422","166513",2010,1601,575,1026,514,272,242,42.09,0.4209,0.321,0.265
"13423","166629",2010,4543,2296,2247,2986,1336,1650,71.86,0.7186,0.657,0.595
"13424","166638",2010,1067,595,472,194,55,139,23.36,0.2336,0.182,0.117
"13425","166683",2010,1063,479,584,898,478,420,87.68,0.8768,0.845,0.818
"13426","167288",2010,351,225,126,133,41,92,40.89,0.4089,0.379,0.325
"13427","167987",2010,1667,765,902,471,208,263,34.38,0.3438,0.283,0.231
"13428","167996",2010,727,469,258,556,180,376,80.17,0.8017,0.765,0.698
"13429","168005",2010,1307,739,568,582,221,361,48.85,0.4885,0.445,0.389
"13430","168148",2010,1313,649,664,1138,560,578,89.06,0.8906,0.867,0.843
"13431","168254",2010,736,303,433,373,213,160,52.81,0.5281,0.507,0.492
"13432","168281",2010,450,306,144,342,103,239,78.1,0.781,0.76,0.715
"13433","168342",2010,548,288,260,471,215,256,88.89,0.8889,0.859,0.827
"13434","168546",2010,383,196,187,235,102,133,67.86,0.6786,0.614,0.545
"13435","168786",2010,428,255,173,140,53,87,34.12,0.3412,0.327,0.306
"13436","169080",2010,929,469,460,573,250,323,68.87,0.6887,0.617,0.543
"13437","169798",2010,1955,1152,803,254,75,179,15.54,0.1554,0.13,0.093
"13438","169910",2010,1960,976,984,143,59,84,8.61,0.0861,0.073,0.06
"13439","170082",2010,3414,2084,1330,1165,413,752,36.08,0.3608,0.341,0.311
"13440","170301",2010,765,455,310,524,185,339,74.51,0.7451,0.685,0.597
"13441","170532",2010,341,192,149,250,106,144,75,0.75,0.733,0.711
"13442","170639",2010,501,229,272,91,54,37,16.16,0.1616,0.182,0.199
"13443","170976",2010,6443,3217,3226,4929,2317,2612,81.19,0.8119,0.765,0.718
"13444","171100",2010,7221,3821,3400,3685,1516,2169,56.77,0.5677,0.51,0.446
"13445","171128",2010,1110,273,837,308,202,106,38.83,0.3883,0.277,0.241
"13446","171137",2010,883,429,454,149,51,98,22.84,0.2284,0.169,0.112
"13447","171146",2010,724,398,326,94,34,60,15.08,0.1508,0.13,0.104
"13448","171599",2010,229,93,136,80,35,45,48.39,0.4839,0.349,0.257
"13449","172051",2010,1729,1013,716,196,51,145,14.31,0.1431,0.113,0.071
"13450","172699",2010,3346,1734,1612,721,259,462,26.64,0.2664,0.215,0.161
"13451","173160",2010,604,366,238,408,146,262,71.58,0.7158,0.675,0.613
"13452","173258",2010,511,268,243,451,209,242,90.3,0.903,0.883,0.86
"13453","173328",2010,217,126,91,81,19,62,49.21,0.4921,0.373,0.209
"13454","173647",2010,585,314,271,454,208,246,78.34,0.7834,0.776,0.768
"13455","173902",2010,515,314,201,434,158,276,87.9,0.879,0.843,0.786
"13456","174066",2010,5310,2810,2500,3251,1428,1823,64.88,0.6488,0.612,0.571
"13457","174233",2010,2316,1112,1204,819,356,463,41.64,0.4164,0.354,0.296
"13458","174251",2010,418,242,176,211,81,130,53.72,0.5372,0.505,0.46
"13459","174491",2010,451,247,204,219,89,130,52.63,0.5263,0.486,0.436
"13460","174792",2010,503,0,503,360,360,0,NA,NA,0.716,0.716
"13461","174844",2010,844,434,410,719,332,387,89.17,0.8917,0.852,0.81
"13462","174899",2010,575,358,217,328,100,228,63.69,0.6369,0.57,0.461
"13463","174914",2010,1518,762,756,941,396,545,71.52,0.7152,0.62,0.524
"13464","175342",2010,588,341,247,94,25,69,20.23,0.2023,0.16,0.101
"13465","175421",2010,234,126,108,65,17,48,38.1,0.381,0.278,0.157
"13466","175616",2010,370,208,162,61,25,36,17.31,0.1731,0.165,0.154
"13467","175856",2010,879,489,390,169,52,117,23.93,0.2393,0.192,0.133
"13468","175980",2010,211,106,105,145,69,76,71.7,0.717,0.687,0.657
"13469","176017",2010,3065,1580,1485,1135,440,695,43.99,0.4399,0.37,0.296
"13470","176035",2010,199,154,45,50,7,43,27.92,0.2792,0.251,0.156
"13471","176044",2010,382,192,190,68,25,43,22.4,0.224,0.178,0.132
"13472","176080",2010,2688,1308,1380,847,348,499,38.15,0.3815,0.315,0.252
"13473","176406",2010,198,126,72,50,10,40,31.75,0.3175,0.253,0.139
"13474","176628",2010,166,94,72,46,11,35,37.23,0.3723,0.277,0.153
"13475","176947",2010,314,147,167,109,33,76,51.7,0.517,0.347,0.198
"13476","176965",2010,1546,862,684,496,176,320,37.12,0.3712,0.321,0.257
"13477","177418",2010,151,77,74,53,21,32,41.56,0.4156,0.351,0.284
"13478","178059",2010,338,242,96,192,49,143,59.09,0.5909,0.568,0.51
"13479","178341",2010,844,439,405,88,35,53,12.07,0.1207,0.104,0.086
"13480","178387",2010,1083,559,524,145,55,90,16.1,0.161,0.134,0.105
"13481","178396",2010,5996,3175,2821,2641,963,1678,52.85,0.5285,0.44,0.341
"13482","178402",2010,1109,673,436,246,92,154,22.88,0.2288,0.222,0.211
"13483","178411",2010,1138,250,888,246,166,80,32,0.32,0.216,0.187
"13484","178420",2010,479,282,197,141,51,90,31.91,0.3191,0.294,0.259
"13485","178615",2010,1416,881,535,800,260,540,61.29,0.6129,0.565,0.486
"13486","179043",2010,370,232,138,228,79,149,64.22,0.6422,0.616,0.572
"13487","179159",2010,1724,1004,720,1063,381,682,67.93,0.6793,0.617,0.529
"13488","179557",2010,1813,1097,716,526,165,361,32.91,0.3291,0.29,0.23
"13489","179566",2010,2645,1574,1071,796,266,530,33.67,0.3367,0.301,0.248
"13490","179867",2010,1619,776,843,1430,716,714,92.01,0.9201,0.883,0.849
"13491","179894",2010,413,238,175,187,67,120,50.42,0.5042,0.453,0.383
"13492","179946",2010,315,139,176,175,75,100,71.94,0.7194,0.556,0.426
"13493","180179",2010,829,434,395,44,11,33,7.6,0.076,0.053,0.028
"13494","180461",2010,2115,877,1238,502,219,283,32.27,0.3227,0.237,0.177
"13495","180522",2010,226,78,148,16,10,6,7.69,0.0769,0.071,0.068
"13496","180984",2010,276,139,137,138,57,81,58.27,0.5827,0.5,0.416
"13497","181002",2010,1010,606,404,676,248,428,70.63,0.7063,0.669,0.614
"13498","181020",2010,327,179,148,163,52,111,62.01,0.6201,0.498,0.351
"13499","181127",2010,312,150,162,144,66,78,52,0.52,0.462,0.407
"13500","181215",2010,1124,656,468,305,96,209,31.86,0.3186,0.271,0.205
"13501","181394",2010,1703,925,778,14,8,6,0.65,0.0065,0.008,0.01
"13502","181446",2010,427,237,190,256,106,150,63.29,0.6329,0.6,0.558
"13503","181464",2010,4039,1889,2150,1461,647,814,43.09,0.4309,0.362,0.301
"13504","181534",2010,243,117,126,32,6,26,22.22,0.2222,0.132,0.048
"13505","181783",2010,677,366,311,172,58,114,31.15,0.3115,0.254,0.186
"13506","182281",2010,2923,1621,1302,341,117,224,13.82,0.1382,0.117,0.09
"13507","182290",2010,2693,1430,1263,610,233,377,26.36,0.2636,0.227,0.184
"13508","182634",2010,393,266,127,185,51,134,50.38,0.5038,0.471,0.402
"13509","182795",2010,399,179,220,142,50,92,51.4,0.514,0.356,0.227
"13510","183062",2010,1201,718,483,643,252,391,54.46,0.5446,0.535,0.522
"13511","183080",2010,1056,520,536,456,186,270,51.92,0.5192,0.432,0.347
"13512","183239",2010,535,295,240,369,142,227,76.95,0.7695,0.69,0.592
"13513","183822",2010,379,225,154,44,22,22,9.78,0.0978,0.116,0.143
"13514","183974",2010,252,144,108,115,35,80,55.56,0.5556,0.456,0.324
"13515","184348",2010,494,311,183,280,96,184,59.16,0.5916,0.567,0.525
"13516","184603",2010,694,400,294,133,48,85,21.25,0.2125,0.192,0.163
"13517","184612",2010,324,236,88,66,21,45,19.07,0.1907,0.204,0.239
"13518","184782",2010,1485,715,770,713,320,393,54.97,0.5497,0.48,0.416
"13519","185129",2010,681,380,301,45,21,24,6.32,0.0632,0.066,0.07
"13520","185572",2010,962,579,383,532,196,336,58.03,0.5803,0.553,0.512
"13521","185590",2010,2169,1248,921,850,304,546,43.75,0.4375,0.392,0.33
"13522","185828",2010,828,187,641,209,141,68,36.36,0.3636,0.252,0.22
"13523","186131",2010,1311,649,662,1169,572,597,91.99,0.9199,0.892,0.864
"13524","186201",2010,893,522,371,547,188,359,68.77,0.6877,0.613,0.507
"13525","186283",2010,1007,601,406,585,227,358,59.57,0.5957,0.581,0.559
"13526","186584",2010,1302,728,574,708,288,420,57.69,0.5769,0.544,0.502
"13527","186876",2010,858,518,340,433,137,296,57.14,0.5714,0.505,0.403
"13528","187134",2010,1421,800,621,1065,443,622,77.75,0.7775,0.749,0.713
"13529","187444",2010,1509,774,735,443,160,283,36.56,0.3656,0.294,0.218
"13530","187985",2010,3488,1951,1537,574,204,370,18.96,0.1896,0.165,0.133
"13531","188030",2010,2255,1181,1074,381,151,230,19.48,0.1948,0.169,0.141
"13532","188429",2010,909,634,275,521,133,388,61.2,0.612,0.573,0.484
"13533","188641",2010,526,240,286,225,91,134,55.83,0.5583,0.428,0.318
"13534","190044",2010,712,182,530,399,279,120,65.93,0.6593,0.56,0.526
"13535","190099",2010,849,466,383,721,312,409,87.77,0.8777,0.849,0.815
"13536","190150",2010,1392,676,716,1188,595,593,87.72,0.8772,0.853,0.831
"13537","190248",2010,138,76,62,62,22,40,52.63,0.5263,0.449,0.355
"13538","190415",2010,3172,1579,1593,2763,1325,1438,91.07,0.9107,0.871,0.832
"13539","190512",2010,1255,527,728,483,242,241,45.73,0.4573,0.385,0.332
"13540","190549",2010,1143,661,482,284,95,189,28.59,0.2859,0.248,0.197
"13541","190558",2010,2237,1184,1053,146,52,94,7.94,0.0794,0.065,0.049
"13542","190567",2010,1368,685,683,171,58,113,16.5,0.165,0.125,0.085
"13543","190594",2010,1740,1141,599,413,100,313,27.43,0.2743,0.237,0.167
"13544","190637",2010,619,386,233,116,33,83,21.5,0.215,0.187,0.142
"13545","190664",2010,1471,821,650,452,133,319,38.86,0.3886,0.307,0.205
"13546","190691",2010,1085,652,433,71,16,55,8.44,0.0844,0.065,0.037
"13547","190725",2010,441,325,116,148,36,112,34.46,0.3446,0.336,0.31
"13548","191241",2010,1865,1021,844,1388,607,781,76.49,0.7649,0.744,0.719
"13549","191515",2010,467,252,215,414,185,229,90.87,0.9087,0.887,0.86
"13550","191533",2010,487,270,217,241,104,137,50.74,0.5074,0.495,0.479
"13551","191630",2010,618,339,279,448,182,266,78.47,0.7847,0.725,0.652
"13552","191649",2010,1435,819,616,764,289,475,58,0.58,0.532,0.469
"13553","191676",2010,253,178,75,154,46,108,60.67,0.6067,0.609,0.613
"13554","191931",2010,871,504,367,525,202,323,64.09,0.6409,0.603,0.55
"13555","191968",2010,1614,869,745,1071,442,629,72.38,0.7238,0.664,0.593
"13556","192192",2010,270,196,74,141,32,109,55.61,0.5561,0.522,0.432
"13557","192323",2010,615,372,243,355,130,225,60.48,0.6048,0.577,0.535
"13558","192439",2010,883,618,265,58,13,45,7.28,0.0728,0.066,0.049
"13559","192703",2010,658,300,358,375,190,185,61.67,0.6167,0.57,0.531
"13560","192749",2010,428,274,154,181,57,124,45.26,0.4526,0.423,0.37
"13561","192819",2010,1088,612,476,814,331,483,78.92,0.7892,0.748,0.695
"13562","192925",2010,377,234,143,112,46,66,28.21,0.2821,0.297,0.322
"13563","193016",2010,1086,708,378,212,45,167,23.59,0.2359,0.195,0.119
"13564","193292",2010,387,257,130,180,59,121,47.08,0.4708,0.465,0.454
"13565","193353",2010,443,301,142,187,60,127,42.19,0.4219,0.422,0.423
"13566","193399",2010,377,249,128,147,41,106,42.57,0.4257,0.39,0.32
"13567","193584",2010,467,353,114,273,60,213,60.34,0.6034,0.585,0.526
"13568","193645",2010,635,566,69,140,10,130,22.97,0.2297,0.22,0.145
"13569","193654",2010,1166,859,307,603,139,464,54.02,0.5402,0.517,0.453
"13570","193900",2010,5434,3100,2334,3417,1477,1940,62.58,0.6258,0.629,0.633
"13571","193973",2010,668,377,291,397,163,234,62.07,0.6207,0.594,0.56
"13572","194161",2010,314,181,133,67,28,39,21.55,0.2155,0.213,0.211
"13573","194310",2010,1766,1089,677,696,240,456,41.87,0.4187,0.394,0.355
"13574","194824",2010,1152,322,830,703,494,209,64.91,0.6491,0.61,0.595
"13575","195003",2010,2583,820,1763,699,346,353,43.05,0.4305,0.271,0.196
"13576","195030",2010,1305,641,664,120,69,51,7.96,0.0796,0.092,0.104
"13577","195164",2010,494,242,252,257,116,141,58.26,0.5826,0.52,0.46
"13578","195173",2010,559,289,270,151,65,86,29.76,0.2976,0.27,0.241
"13579","195216",2010,609,316,293,492,227,265,83.86,0.8386,0.808,0.775
"13580","195234",2010,639,432,207,313,83,230,53.24,0.5324,0.49,0.401
"13581","195243",2010,290,173,117,123,40,83,47.98,0.4798,0.424,0.342
"13582","195304",2010,338,238,100,249,68,181,76.05,0.7605,0.737,0.68
"13583","195474",2010,768,410,358,539,228,311,75.85,0.7585,0.702,0.637
"13584","195526",2010,768,485,283,653,225,428,88.25,0.8825,0.85,0.795
"13585","195544",2010,697,498,199,403,102,301,60.44,0.6044,0.578,0.513
"13586","195809",2010,3105,1626,1479,1117,500,617,37.95,0.3795,0.36,0.338
"13587","196413",2010,3452,1929,1523,2379,962,1417,73.46,0.7346,0.689,0.632
"13588","196592",2010,1030,668,362,152,21,131,19.61,0.1961,0.148,0.058
"13589","197045",2010,564,281,283,190,83,107,38.08,0.3808,0.337,0.293
"13590","197133",2010,665,382,283,576,242,334,87.43,0.8743,0.866,0.855
"13591","197869",2010,2816,1538,1278,1387,500,887,57.67,0.5767,0.493,0.391
"13592","197984",2010,307,139,168,103,53,50,35.97,0.3597,0.336,0.315
"13593","198385",2010,499,246,253,452,223,229,93.09,0.9309,0.906,0.881
"13594","198464",2010,4196,2446,1750,1417,448,969,39.62,0.3962,0.338,0.256
"13595","198507",2010,573,319,254,94,31,63,19.75,0.1975,0.164,0.122
"13596","198516",2010,1359,794,565,1041,386,655,82.49,0.8249,0.766,0.683
"13597","198835",2010,423,229,194,149,53,96,41.92,0.4192,0.352,0.273
"13598","198969",2010,531,190,341,104,46,58,30.53,0.3053,0.196,0.135
"13599","199102",2010,2040,1065,975,374,108,266,24.98,0.2498,0.183,0.111
"13600","199111",2010,590,335,255,231,87,144,42.99,0.4299,0.392,0.341
"13601","199120",2010,3944,2371,1573,3299,1235,2064,87.05,0.8705,0.836,0.785
"13602","199139",2010,2947,1513,1434,840,312,528,34.9,0.349,0.285,0.218
"13603","199148",2010,2505,1722,783,762,162,600,34.84,0.3484,0.304,0.207
"13604","199157",2010,1218,809,409,238,56,182,22.5,0.225,0.195,0.137
"13605","199193",2010,4685,2098,2587,2187,962,1225,58.39,0.5839,0.467,0.372
"13606","199218",2010,1985,1236,749,1044,320,724,58.58,0.5858,0.526,0.427
"13607","199281",2010,1036,582,454,209,74,135,23.2,0.232,0.202,0.163
"13608","199306",2010,199,88,111,67,31,36,40.91,0.4091,0.337,0.279
"13609","199412",2010,349,252,97,162,38,124,49.21,0.4921,0.464,0.392
"13610","199582",2010,440,196,244,78,25,53,27.04,0.2704,0.177,0.102
"13611","199643",2010,679,360,319,54,23,31,8.61,0.0861,0.08,0.072
"13612","199847",2010,1217,639,578,1019,462,557,87.17,0.8717,0.837,0.799
"13613","199962",2010,605,336,269,267,95,172,51.19,0.5119,0.441,0.353
"13614","199999",2010,690,465,225,139,25,114,24.52,0.2452,0.201,0.111
"13615","200004",2010,1415,746,669,520,196,324,43.43,0.4343,0.367,0.293
"13616","200059",2010,307,146,161,33,14,19,13.01,0.1301,0.107,0.087
"13617","200156",2010,202,98,104,72,27,45,45.92,0.4592,0.356,0.26
"13618","200217",2010,362,203,159,138,38,100,49.26,0.4926,0.381,0.239
"13619","200226",2010,130,54,76,17,10,7,12.96,0.1296,0.131,0.132
"13620","200253",2010,461,298,163,83,10,73,24.5,0.245,0.18,0.061
"13621","200280",2010,2073,978,1095,527,237,290,29.65,0.2965,0.254,0.216
"13622","200332",2010,2373,1074,1299,635,297,338,31.47,0.3147,0.268,0.229
"13623","200572",2010,217,95,122,45,22,23,24.21,0.2421,0.207,0.18
"13624","201104",2010,688,407,281,345,115,230,56.51,0.5651,0.501,0.409
"13625","201371",2010,219,91,128,96,45,51,56.04,0.5604,0.438,0.352
"13626","201548",2010,715,409,306,381,167,214,52.32,0.5232,0.533,0.546
"13627","201645",2010,1019,415,604,655,356,299,72.05,0.7205,0.643,0.589
"13628","201690",2010,503,231,272,49,18,31,13.42,0.1342,0.097,0.066
"13629","202134",2010,1148,615,533,237,105,132,21.46,0.2146,0.206,0.197
"13630","202480",2010,2029,995,1034,1187,506,681,68.44,0.6844,0.585,0.489
"13631","202523",2010,623,349,274,482,199,283,81.09,0.8109,0.774,0.726
"13632","202763",2010,659,461,198,338,95,243,52.71,0.5271,0.513,0.48
"13633","203085",2010,334,158,176,137,57,80,50.63,0.5063,0.41,0.324
"13634","203128",2010,295,157,138,160,65,95,60.51,0.6051,0.542,0.471
"13635","203368",2010,703,380,323,460,189,271,71.32,0.7132,0.654,0.585
"13636","203517",2010,3887,2325,1562,1243,396,847,36.43,0.3643,0.32,0.254
"13637","203535",2010,483,265,218,429,191,238,89.81,0.8981,0.888,0.876
"13638","203580",2010,256,123,133,78,28,50,40.65,0.4065,0.305,0.211
"13639","203775",2010,375,196,179,167,68,99,50.51,0.5051,0.445,0.38
"13640","203845",2010,387,191,196,199,85,114,59.69,0.5969,0.514,0.434
"13641","204024",2010,3574,1944,1630,2368,969,1399,71.97,0.7197,0.663,0.594
"13642","204185",2010,630,261,369,333,151,182,69.73,0.6973,0.529,0.409
"13643","204194",2010,388,240,148,217,83,134,55.83,0.5583,0.559,0.561
"13644","204617",2010,272,146,126,78,30,48,32.88,0.3288,0.287,0.238
"13645","204796",2010,6651,3319,3332,3907,1657,2250,67.79,0.6779,0.587,0.497
"13646","204857",2010,3949,2129,1820,1799,689,1110,52.14,0.5214,0.456,0.379
"13647","206330",2010,145,68,77,36,17,19,27.94,0.2794,0.248,0.221
"13648","206589",2010,617,332,285,436,180,256,77.11,0.7711,0.707,0.632
"13649","206604",2010,2739,1586,1153,527,197,330,20.81,0.2081,0.192,0.171
"13650","206622",2010,1042,554,488,641,298,343,61.91,0.6191,0.615,0.611
"13651","206695",2010,2633,1330,1303,250,122,128,9.62,0.0962,0.095,0.094
"13652","206914",2010,892,520,372,43,21,22,4.23,0.0423,0.048,0.056
"13653","207209",2010,469,226,243,11,2,9,3.98,0.0398,0.023,0.008
"13654","207306",2010,382,182,200,51,16,35,19.23,0.1923,0.134,0.08
"13655","207324",2010,497,247,250,166,77,89,36.03,0.3603,0.334,0.308
"13656","207388",2010,3403,1761,1642,1320,497,823,46.73,0.4673,0.388,0.303
"13657","207500",2010,3669,1945,1724,1455,549,906,46.58,0.4658,0.397,0.318
"13658","207722",2010,199,129,70,54,13,41,31.78,0.3178,0.271,0.186
"13659","207847",2010,651,344,307,55,20,35,10.17,0.1017,0.084,0.065
"13660","207865",2010,977,529,448,123,44,79,14.93,0.1493,0.126,0.098
"13661","208822",2010,488,287,201,275,119,156,54.36,0.5436,0.564,0.592
"13662","209056",2010,491,306,185,364,125,239,78.1,0.781,0.741,0.676
"13663","209065",2010,528,310,218,302,117,185,59.68,0.5968,0.572,0.537
"13664","209542",2010,3480,1677,1803,1145,447,698,41.62,0.4162,0.329,0.248
"13665","209551",2010,3911,2065,1846,1953,790,1163,56.32,0.5632,0.499,0.428
"13666","209612",2010,474,231,243,229,109,120,51.95,0.5195,0.483,0.449
"13667","209807",2010,1366,733,633,288,123,165,22.51,0.2251,0.211,0.194
"13668","209922",2010,373,212,161,247,105,142,66.98,0.6698,0.662,0.652
"13669","210146",2010,735,435,300,176,55,121,27.82,0.2782,0.239,0.183
"13670","210401",2010,427,235,192,301,119,182,77.45,0.7745,0.705,0.62
"13671","210429",2010,1039,636,403,204,45,159,25,0.25,0.196,0.112
"13672","210571",2010,485,255,230,230,90,140,54.9,0.549,0.474,0.391
"13673","210669",2010,594,332,262,415,173,242,72.89,0.7289,0.699,0.66
"13674","210775",2010,388,268,120,142,39,103,38.43,0.3843,0.366,0.325
"13675","211088",2010,552,397,155,317,75,242,60.96,0.6096,0.574,0.484
"13676","211158",2010,2136,1263,873,808,251,557,44.1,0.441,0.378,0.288
"13677","211291",2010,929,491,438,782,355,427,86.97,0.8697,0.842,0.811
"13678","211352",2010,339,222,117,174,47,127,57.21,0.5721,0.513,0.402
"13679","211361",2010,1351,711,640,332,136,196,27.57,0.2757,0.246,0.212
"13680","211431",2010,189,181,8,76,1,75,41.44,0.4144,0.402,0.125
"13681","211440",2010,1484,619,865,1119,630,489,79,0.79,0.754,0.728
"13682","211468",2010,91,90,1,36,0,36,40,0.4,0.396,0
"13683","211556",2010,150,150,0,72,0,72,48,0.48,0.48,NA
"13684","211583",2010,219,125,94,82,31,51,40.8,0.408,0.374,0.33
"13685","211608",2010,471,258,213,25,5,20,7.75,0.0775,0.053,0.023
"13686","211644",2010,1309,811,498,430,127,303,37.36,0.3736,0.328,0.255
"13687","211981",2010,490,297,193,238,66,172,57.91,0.5791,0.486,0.342
"13688","212009",2010,657,355,302,535,240,295,83.1,0.831,0.814,0.795
"13689","212054",2010,2696,1200,1496,735,275,460,38.33,0.3833,0.273,0.184
"13690","212106",2010,1411,821,590,834,318,516,62.85,0.6285,0.591,0.539
"13691","212115",2010,1144,658,486,422,137,285,43.31,0.4331,0.369,0.282
"13692","212133",2010,449,302,147,195,67,128,42.38,0.4238,0.434,0.456
"13693","212160",2010,1551,927,624,340,103,237,25.57,0.2557,0.219,0.165
"13694","212197",2010,491,303,188,339,104,235,77.56,0.7756,0.69,0.553
"13695","212577",2010,629,345,284,525,227,298,86.38,0.8638,0.835,0.799
"13696","212601",2010,617,362,255,276,100,176,48.62,0.4862,0.447,0.392
"13697","212832",2010,284,190,94,38,13,25,13.16,0.1316,0.134,0.138
"13698","212911",2010,325,166,159,281,138,143,86.14,0.8614,0.865,0.868
"13699","213020",2010,2984,1751,1233,1087,333,754,43.06,0.4306,0.364,0.27
"13700","213251",2010,421,227,194,303,130,173,76.21,0.7621,0.72,0.67
"13701","213321",2010,528,240,288,310,150,160,66.67,0.6667,0.587,0.521
"13702","213349",2010,2009,1175,834,677,217,460,39.15,0.3915,0.337,0.26
"13703","213358",2010,269,151,118,93,48,45,29.8,0.298,0.346,0.407
"13704","213367",2010,982,605,377,524,182,342,56.53,0.5653,0.534,0.483
"13705","213385",2010,648,294,354,553,279,274,93.2,0.932,0.853,0.788
"13706","213507",2010,460,245,215,331,152,179,73.06,0.7306,0.72,0.707
"13707","213543",2010,1208,516,692,932,495,437,84.69,0.8469,0.772,0.715
"13708","213613",2010,1185,630,555,361,158,203,32.22,0.3222,0.305,0.285
"13709","213668",2010,346,211,135,205,67,138,65.4,0.654,0.592,0.496
"13710","213783",2010,631,346,285,162,70,92,26.59,0.2659,0.257,0.246
"13711","213826",2010,452,338,114,241,44,197,58.28,0.5828,0.533,0.386
"13712","213996",2010,721,433,288,523,210,313,72.29,0.7229,0.725,0.729
"13713","214041",2010,1315,728,587,494,193,301,41.35,0.4135,0.376,0.329
"13714","214069",2010,375,265,110,255,62,193,72.83,0.7283,0.68,0.564
"13715","214157",2010,373,216,157,245,96,149,68.98,0.6898,0.657,0.611
"13716","214175",2010,603,341,262,485,199,286,83.87,0.8387,0.804,0.76
"13717","214272",2010,547,350,197,166,48,118,33.71,0.3371,0.303,0.244
"13718","214777",2010,7321,3542,3779,4942,2239,2703,76.31,0.7631,0.675,0.592
"13719","215062",2010,2363,1213,1150,1999,917,1082,89.2,0.892,0.846,0.797
"13720","215743",2010,429,258,171,243,82,161,62.4,0.624,0.566,0.48
"13721","215798",2010,422,202,220,261,113,148,73.27,0.7327,0.618,0.514
"13722","215929",2010,950,508,442,688,291,397,78.15,0.7815,0.724,0.658
"13723","216010",2010,1706,888,818,693,275,418,47.07,0.4707,0.406,0.336
"13724","216038",2010,1562,969,593,808,265,543,56.04,0.5604,0.517,0.447
"13725","216287",2010,387,195,192,339,169,170,87.18,0.8718,0.876,0.88
"13726","216339",2010,4305,2273,2032,1920,783,1137,50.02,0.5002,0.446,0.385
"13727","216524",2010,441,236,205,323,144,179,75.85,0.7585,0.732,0.702
"13728","216694",2010,401,229,172,213,77,136,59.39,0.5939,0.531,0.448
"13729","216764",2010,2060,1295,765,946,263,683,52.74,0.5274,0.459,0.344
"13730","216807",2010,402,248,154,274,99,175,70.56,0.7056,0.682,0.643
"13731","216852",2010,718,371,347,298,116,182,49.06,0.4906,0.415,0.334
"13732","216931",2010,499,249,250,240,106,134,53.82,0.5382,0.481,0.424
"13733","217059",2010,1231,657,574,481,182,299,45.51,0.4551,0.391,0.317
"13734","217156",2010,1495,784,711,1251,599,652,83.16,0.8316,0.837,0.842
"13735","217402",2010,1102,633,469,888,383,505,79.78,0.7978,0.806,0.817
"13736","217536",2010,592,423,169,380,96,284,67.14,0.6714,0.642,0.568
"13737","217776",2010,153,80,73,77,40,37,46.25,0.4625,0.503,0.548
"13738","217819",2010,2001,1329,672,1162,325,837,62.98,0.6298,0.581,0.484
"13739","217882",2010,2977,1498,1479,1755,707,1048,69.96,0.6996,0.59,0.478
"13740","217998",2010,144,81,63,85,34,51,62.96,0.6296,0.59,0.54
"13741","218061",2010,737,479,258,130,40,90,18.79,0.1879,0.176,0.155
"13742","218229",2010,685,476,209,195,44,151,31.72,0.3172,0.285,0.211
"13743","218238",2010,275,129,146,52,19,33,25.58,0.2558,0.189,0.13
"13744","218399",2010,319,173,146,19,6,13,7.51,0.0751,0.06,0.041
"13745","218414",2010,288,110,178,82,41,41,37.27,0.3727,0.285,0.23
"13746","218663",2010,4421,2431,1990,2400,911,1489,61.25,0.6125,0.543,0.458
"13747","218724",2010,1996,1087,909,530,181,349,32.11,0.3211,0.266,0.199
"13748","218733",2010,816,414,402,156,58,98,23.67,0.2367,0.191,0.144
"13749","218742",2010,838,559,279,200,54,146,26.12,0.2612,0.239,0.194
"13750","218973",2010,429,202,227,334,173,161,79.7,0.797,0.779,0.762
"13751","219000",2010,418,276,142,226,55,171,61.96,0.6196,0.541,0.387
"13752","219046",2010,648,386,262,105,30,75,19.43,0.1943,0.162,0.115
"13753","219082",2010,314,113,201,62,43,19,16.81,0.1681,0.197,0.214
"13754","219198",2010,120,64,56,48,17,31,48.44,0.4844,0.4,0.304
"13755","219259",2010,380,208,172,84,25,59,28.37,0.2837,0.221,0.145
"13756","219356",2010,2157,1051,1106,613,270,343,32.64,0.3264,0.284,0.244
"13757","219471",2010,1034,622,412,313,114,199,31.99,0.3199,0.303,0.277
"13758","219602",2010,1478,903,575,252,88,164,18.16,0.1816,0.171,0.153
"13759","219709",2010,1013,581,432,597,247,350,60.24,0.6024,0.589,0.572
"13760","219718",2010,377,133,244,51,27,24,18.05,0.1805,0.135,0.111
"13761","219949",2010,163,67,96,56,29,27,40.3,0.403,0.344,0.302
"13762","220075",2010,2052,1165,887,406,147,259,22.23,0.2223,0.198,0.166
"13763","220215",2010,370,214,156,164,62,102,47.66,0.4766,0.443,0.397
"13764","220613",2010,851,494,357,288,93,195,39.47,0.3947,0.338,0.261
"13765","220631",2010,352,232,120,115,46,69,29.74,0.2974,0.327,0.383
"13766","220710",2010,277,126,151,129,53,76,60.32,0.6032,0.466,0.351
"13767","221351",2010,500,307,193,382,139,243,79.15,0.7915,0.764,0.72
"13768","221519",2010,401,216,185,317,138,179,82.87,0.8287,0.791,0.746
"13769","221731",2010,218,142,76,70,20,50,35.21,0.3521,0.321,0.263
"13770","221847",2010,1898,846,1052,468,177,291,34.4,0.344,0.247,0.168
"13771","221892",2010,234,142,92,92,33,59,41.55,0.4155,0.393,0.359
"13772","222178",2010,977,526,451,465,194,271,51.52,0.5152,0.476,0.43
"13773","222983",2010,318,173,145,220,90,130,75.14,0.7514,0.692,0.621
"13774","223232",2010,3254,1913,1341,1897,668,1229,64.24,0.6424,0.583,0.498
"13775","224004",2010,235,157,78,54,11,43,27.39,0.2739,0.23,0.141
"13776","224323",2010,375,207,168,223,89,134,64.73,0.6473,0.595,0.53
"13777","225432",2010,824,453,371,11,3,8,1.77,0.0177,0.013,0.008
"13778","225548",2010,318,149,169,88,32,56,37.58,0.3758,0.277,0.189
"13779","225627",2010,871,571,300,257,70,187,32.75,0.3275,0.295,0.233
"13780","226231",2010,425,169,256,152,85,67,39.64,0.3964,0.358,0.332
"13781","226833",2010,742,380,362,141,39,102,26.84,0.2684,0.19,0.108
"13782","227216",2010,3534,1908,1626,1009,345,664,34.8,0.348,0.286,0.212
"13783","227331",2010,299,219,80,77,18,59,26.94,0.2694,0.258,0.225
"13784","227526",2010,1731,1046,685,154,43,111,10.61,0.1061,0.089,0.063
"13785","227757",2010,944,453,491,783,376,407,89.85,0.8985,0.829,0.766
"13786","227845",2010,770,505,265,403,122,281,55.64,0.5564,0.523,0.46
"13787","227863",2010,191,127,64,63,14,49,38.58,0.3858,0.33,0.219
"13788","228042",2010,253,150,103,106,40,66,44,0.44,0.419,0.388
"13789","228149",2010,585,358,227,249,85,164,45.81,0.4581,0.426,0.374
"13790","228246",2010,1476,786,690,1008,429,579,73.66,0.7366,0.683,0.622
"13791","228343",2010,383,224,159,252,98,154,68.75,0.6875,0.658,0.616
"13792","228431",2010,2280,1473,807,556,128,428,29.06,0.2906,0.244,0.159
"13793","228459",2010,4033,2403,1630,1091,306,785,32.67,0.3267,0.271,0.188
"13794","228501",2010,322,146,176,42,17,25,17.12,0.1712,0.13,0.097
"13795","228529",2010,1435,858,577,339,98,241,28.09,0.2809,0.236,0.17
"13796","228705",2010,1287,539,748,196,70,126,23.38,0.2338,0.152,0.094
"13797","228723",2010,8033,3862,4171,4175,1709,2466,63.85,0.6385,0.52,0.41
"13798","228769",2010,2585,1319,1266,549,228,321,24.34,0.2434,0.212,0.18
"13799","228778",2010,7232,3869,3363,3986,1608,2378,61.46,0.6146,0.551,0.478
"13800","228787",2010,1346,544,802,680,362,318,58.46,0.5846,0.505,0.451
"13801","228796",2010,2450,1262,1188,363,134,229,18.15,0.1815,0.148,0.113
"13802","228875",2010,1824,1104,720,1141,397,744,67.39,0.6739,0.626,0.551
"13803","228981",2010,338,159,179,102,39,63,39.62,0.3962,0.302,0.218
"13804","229018",2010,341,180,161,71,29,42,23.33,0.2333,0.208,0.18
"13805","229027",2010,4811,2243,2568,610,248,362,16.14,0.1614,0.127,0.097
"13806","229115",2010,4759,2290,2469,1623,645,978,42.71,0.4271,0.341,0.261
"13807","229780",2010,242,112,130,25,10,15,13.39,0.1339,0.103,0.077
"13808","229814",2010,1227,637,590,336,102,234,36.73,0.3673,0.274,0.173
"13809","230603",2010,1103,768,335,232,43,189,24.61,0.2461,0.21,0.128
"13810","230728",2010,2941,1882,1059,548,113,435,23.11,0.2311,0.186,0.107
"13811","230764",2010,2269,1217,1052,663,237,426,35,0.35,0.292,0.225
"13812","230782",2010,2041,1193,848,196,64,132,11.06,0.1106,0.096,0.075
"13813","231059",2010,546,294,252,401,168,233,79.25,0.7925,0.734,0.667
"13814","231174",2010,2452,1425,1027,1523,576,947,66.46,0.6646,0.621,0.561
"13815","231420",2010,264,98,166,89,36,53,54.08,0.5408,0.337,0.217
"13816","231554",2010,112,58,54,28,8,20,34.48,0.3448,0.25,0.148
"13817","231624",2010,1396,791,605,1180,483,697,88.12,0.8812,0.845,0.798
"13818","231712",2010,1150,673,477,723,250,473,70.28,0.7028,0.629,0.524
"13819","232025",2010,248,124,124,84,34,50,40.32,0.4032,0.339,0.274
"13820","232043",2010,206,122,84,96,32,64,52.46,0.5246,0.466,0.381
"13821","232089",2010,565,243,322,106,49,57,23.46,0.2346,0.188,0.152
"13822","232186",2010,2577,1324,1253,1198,462,736,55.59,0.5559,0.465,0.369
"13823","232265",2010,978,605,373,351,87,264,43.64,0.4364,0.359,0.233
"13824","232423",2010,3995,2482,1513,2599,838,1761,70.95,0.7095,0.651,0.554
"13825","232557",2010,3438,1874,1564,1005,410,595,31.75,0.3175,0.292,0.262
"13826","232566",2010,970,667,303,454,93,361,54.12,0.5412,0.468,0.307
"13827","232609",2010,571,328,243,275,89,186,56.71,0.5671,0.482,0.366
"13828","232681",2010,950,612,338,586,179,407,66.5,0.665,0.617,0.53
"13829","232706",2010,415,295,120,151,36,115,38.98,0.3898,0.364,0.3
"13830","232937",2010,902,528,374,185,67,118,22.35,0.2235,0.205,0.179
"13831","232982",2010,2579,1280,1299,666,252,414,32.34,0.3234,0.258,0.194
"13832","233277",2010,1836,1068,768,783,259,524,49.06,0.4906,0.426,0.337
"13833","233374",2010,816,452,364,685,286,399,88.27,0.8827,0.839,0.786
"13834","233426",2010,564,323,241,321,115,206,63.78,0.6378,0.569,0.477
"13835","233541",2010,414,228,186,164,57,107,46.93,0.4693,0.396,0.306
"13836","233897",2010,399,197,202,92,33,59,29.95,0.2995,0.231,0.163
"13837","233921",2010,5193,2158,3035,3130,1587,1543,71.5,0.715,0.603,0.523
"13838","234030",2010,3533,2086,1447,1256,445,811,38.88,0.3888,0.356,0.308
"13839","234085",2010,440,51,389,64,27,37,72.55,0.7255,0.145,0.069
"13840","234155",2010,1282,802,480,307,64,243,30.3,0.303,0.239,0.133
"13841","234164",2010,460,260,200,76,26,50,19.23,0.1923,0.165,0.13
"13842","235097",2010,1524,887,637,324,109,215,24.24,0.2424,0.213,0.171
"13843","235167",2010,612,332,280,265,118,147,44.28,0.4428,0.433,0.421
"13844","236230",2010,687,415,272,398,141,257,61.93,0.6193,0.579,0.518
"13845","236328",2010,625,355,270,436,168,268,75.49,0.7549,0.698,0.622
"13846","236577",2010,726,501,225,405,120,285,56.89,0.5689,0.558,0.533
"13847","236595",2010,1037,660,377,667,232,435,65.91,0.6591,0.643,0.615
"13848","236896",2010,305,151,154,72,35,37,24.5,0.245,0.236,0.227
"13849","236939",2010,3241,1634,1607,1327,525,802,49.08,0.4908,0.409,0.327
"13850","236948",2010,5460,2917,2543,3525,1504,2021,69.28,0.6928,0.646,0.591
"13851","237011",2010,2722,1614,1108,1077,345,732,45.35,0.4535,0.396,0.311
"13852","237057",2010,415,237,178,345,141,204,86.08,0.8608,0.831,0.792
"13853","237066",2010,683,403,280,430,161,269,66.75,0.6675,0.63,0.575
"13854","237215",2010,289,181,108,22,13,9,4.97,0.0497,0.076,0.12
"13855","237330",2010,568,288,280,105,37,68,23.61,0.2361,0.185,0.132
"13856","237358",2010,253,149,104,64,29,35,23.49,0.2349,0.253,0.279
"13857","237367",2010,766,393,373,103,49,54,13.74,0.1374,0.134,0.131
"13858","237792",2010,759,436,323,191,59,132,30.28,0.3028,0.252,0.183
"13859","237899",2010,270,128,142,26,9,17,13.28,0.1328,0.096,0.063
"13860","237932",2010,526,285,241,103,31,72,25.26,0.2526,0.196,0.129
"13861","237969",2010,371,196,175,141,43,98,50,0.5,0.38,0.246
"13862","238032",2010,5006,2290,2716,1619,755,864,37.73,0.3773,0.323,0.278
"13863","238333",2010,333,191,142,212,89,123,64.4,0.644,0.637,0.627
"13864","238430",2010,213,128,85,37,14,23,17.97,0.1797,0.174,0.165
"13865","238458",2010,751,502,249,386,115,271,53.98,0.5398,0.514,0.462
"13866","238476",2010,730,384,346,398,164,234,60.94,0.6094,0.545,0.474
"13867","238616",2010,537,317,220,198,71,127,40.06,0.4006,0.369,0.323
"13868","238661",2010,324,243,81,130,36,94,38.68,0.3868,0.401,0.444
"13869","239080",2010,309,219,90,92,12,80,36.53,0.3653,0.298,0.133
"13870","239105",2010,1929,1015,914,1161,504,657,64.73,0.6473,0.602,0.551
"13871","239628",2010,289,162,127,167,66,101,62.35,0.6235,0.578,0.52
"13872","239716",2010,603,367,236,408,144,264,71.93,0.7193,0.677,0.61
"13873","240107",2010,340,242,98,103,21,82,33.88,0.3388,0.303,0.214
"13874","240189",2010,2033,973,1060,590,267,323,33.2,0.332,0.29,0.252
"13875","240277",2010,894,572,322,214,46,168,29.37,0.2937,0.239,0.143
"13876","240329",2010,1836,1093,743,660,209,451,41.26,0.4126,0.359,0.281
"13877","240338",2010,246,136,110,108,32,76,55.88,0.5588,0.439,0.291
"13878","240365",2010,1817,1039,778,328,116,212,20.4,0.204,0.181,0.149
"13879","240374",2010,711,355,356,40,14,26,7.32,0.0732,0.056,0.039
"13880","240417",2010,1571,756,815,324,124,200,26.46,0.2646,0.206,0.152
"13881","240426",2010,369,197,172,80,27,53,26.9,0.269,0.217,0.157
"13882","240444",2010,5920,3108,2812,3337,1328,2009,64.64,0.6464,0.564,0.472
"13883","240453",2010,3731,1876,1855,506,225,281,14.98,0.1498,0.136,0.121
"13884","240462",2010,1534,508,1026,297,170,127,25,0.25,0.194,0.166
"13885","240471",2010,1230,758,472,360,112,248,32.72,0.3272,0.293,0.237
"13886","240480",2010,1644,881,763,499,213,286,32.46,0.3246,0.304,0.279
"13887","240727",2010,1451,711,740,386,144,242,34.04,0.3404,0.266,0.195
"13888","243443",2010,933,541,392,63,19,44,8.13,0.0813,0.068,0.048
"13889","243780",2010,6454,2706,3748,3133,1579,1554,57.43,0.5743,0.485,0.421
